Avatar,12/10/2009,237000000,"","",""
The Lone Ranger,7/3/2013,255000000,89289910,-165710090,-709387.5323207589
The Alamo,4/7/2004,145000000,25819961,-119180039,-633936.3776595745
Mars Needs Moms,3/9/2011,150000000,38992758,-111007242,-496750.0436306031
Valerian and the City of a Thousand Planets,7/20/2017,197471676,90024292,-107447384,-437633.6821182882
The 13th Warrior,8/27/1999,160000000,61698899,-98301101,-585474.0976771888
The Adventures of Pluto Nash,8/15/2002,100000000,7103973,-92896027,-514089.80077476485
Metropolis,1/10/1927,92620000,650422,-91969578,-5255404.457142857
Cutthroat Island,12/22/1995,98000000,10017322,-87982678,-569835.9974093264
Live by Night,12/25/2016,108000000,22678555,-85321445,-351349.8449590058
Flushed Away,10/22/2006,149000000,64459316,-84540684,-419556.74441687344
Australia,11/18/2008,130000000,49554002,-80445998,-382660.72074129037
Town & Country,4/27/2001,90000000,10372291,-79627709,-448101.907709623
Supernova,1/14/2000,90000000,14828081,-75171919,-445331.2736966824
A Sound of Thunder,5/15/2005,80000000,5989640,-74010360,-380711.72839506174
The Nutcracker: The Untold Story,11/24/2010,90000000,16178959,-73821041,-336807.08918281406
Awake,11/28/2007,86000000,14373825,-71626175,-341018.56348435505
How Do You Know,12/17/2010,120000000,48668907,-71331093,-323903.92011733557
The Great Raid,8/12/2005,80000000,10166502,-69833498,-355567.7087576375
Monkeybone,2/23/2001,75000000,5409517,-69590483,-394951.6628830874
R.I.P.D.,7/18/2013,130000000,61648500,-68351500,-292254.0480680015
The Invasion,8/17/2007,80000000,15071514,-64928486,-311422.5430476282
Foodfight!,6/15/2012,65000000,73706,-64926294,-282930.3636949947
K-19: The Widowmaker,7/19/2002,100000000,35168966,-64831034,-358777.1665744328
The Postman,12/25/1997,80000000,17626234,-62373766,-385976.27475247526
Sphere,2/13/1998,75000000,13100000,-61900000,-382334.7745521927
Osmosis Jones,8/7/2001,75000000,13596911,-61403089,-345932.8957746479
Virus,1/14/1999,75000000,14010690,-60989310,-371206.99939135724
Lolita,9/27/1997,62000000,1060056,-60939944,-377103.61386138614
Monster Trucks,12/21/2016,125000000,64493915,-60506085,-249161.31675719304
Soldier,10/23/1998,75000000,14567883,-60432117,-368488.51829268294
Chill Factor,9/1/1999,70000000,11263966,-58736034,-349827.48064324004
Stealth,7/28/2005,135000000,76932943,-58067057,-295657.1130346232
The Astronaut's Wife,8/26/1999,75000000,19598588,-55401412,-329966.71828469326
Blackhat,1/13/2015,70000000,17752940,-52247060,-223557.9593251379
Upside Down,9/27/2012,60000000,8106475,-51893525,-224339.43462866975
Final Fantasy: The Spirits Within,7/2/2001,137000000,85131830,-51868170,-292215.04225352115
Legends of Oz: Dorothy's Return,6/13/2013,70000000,18662027,-51337973,-219859.07307797726
Rock Dog,7/8/2016,60000000,9420546,-50579454,-210197.70766494342
Hard Rain,1/16/1998,70000000,19870567,-50129433,-309632.0753551575
Ballistic: Ecks vs. Sever,9/20/2002,70000000,19924033,-50075967,-276205.0027578599
D-Tox,1/4/2002,55000000,6416302,-48583698,-274329.1812535291
Hudson Hawk,5/23/1991,65000000,17218080,-47781920,-351337.64705882355
The Iron Giant,8/6/1999,70000000,23159305,-46840695,-280315.3500897666
Gigli,8/1/2003,54000000,7266209,-46733791,-253162.4647887324
Child 44,3/15/2015,50000000,3324330,-46675670,-197678.58579783922
Alfie,10/22/2004,60000000,13395939,-46604061,-244000.31937172776
Red Planet,11/10/2000,80000000,33463969,-46536031,-267294.83630097646
The Out-of-Towners,4/2/1999,75000000,29000000,-46000000,-276774.9699157642
All the King's Men,9/10/2006,55000000,9450897,-45549103,-224490.40413997043
Bullet to the Head,1/31/2013,55000000,9489829,-45510171,-196024.27142647933
Thirteen Days,12/24/2000,80000000,34566746,-45433254,-259470.32552826958
The Last Castle,10/19/2001,72000000,27642707,-44357293,-250041.11048478016
Get Carter,10/6/2000,63600000,19412993,-44187007,-253948.316091954
Fire Down Below,9/5/1997,60000000,16000000,-44000000,-272952.8535980149
Turbulence,1/9/1997,55000000,11466088,-43533912,-273626.0967944689
Mr. Nobody,9/11/2009,47000000,3547209,-43452791,-201199.2045154629
3000 Miles to Graceland,2/23/2001,62000000,18720175,-43279825,-245628.9727582293
The Big Bounce,1/30/2004,50000000,6808550,-43191450,-231962.67454350163
Gods and Generals,2/21/2003,56000000,12923936,-43076064,-233854.85342019546
Outlander,4/24/2008,50000000,7033683,-42966317,-198337.8125115403
Shadow Conspiracy,1/31/1997,45000000,2154540,-42845460,-268455.2631578947
The Wild,3/6/2006,80000000,37384046,-42615954,-213293.06306306305
Flyboys,9/22/2006,60000000,17800000,-42200000,-209117.93855302277
The Last Legion,4/19/2007,67000000,25303038,-41696962,-200515.32827760652
Stay,9/24/2005,50000000,8342132,-41657868,-209125.843373494
Conan the Barbarian,8/17/2011,90000000,48795021,-41204979,-181608.53545125588
The Adventures of Rocky & Bullwinkle,6/30/2000,76000000,35134820,-40865180,-236488.31018518517
Ishtar,5/15/1987,55000000,14375181,-40624819,-359193.8019451813
Goya's Ghosts,11/8/2006,50000000,9448082,-40551918,-201250.21339950373
The Legend of Bagger Vance,11/2/2000,80000000,39459427,-40540573,-232857.97242963815
Heaven's Gate,11/19/1980,44000000,3484331,-40515669,-469474.7276940904
Love in the Time of Cholera,10/4/2007,45000000,4607608,-40392392,-193324.23325803116
Jade,10/13/1995,50000000,9851610,-40148390,-261212.6870527001
Rock Star,9/4/2001,57000000,16991902,-40008098,-224386.41615255186
1492: Conquest of Paradise,10/9/1992,47000000,7191399,-39808601,-280737.6657263751
The Ottoman Lieutenant,3/10/2017,40000000,240978,-39759022,-163079.81509509805
The Scarlet Letter,10/13/1995,50000000,10382407,-39617593,-257759.22576447626
Mad City,11/7/1997,50000000,10541523,-39458477,-244324.93498452014
Driven,4/27/2001,94000000,54744738,-39255262,-220907.4957794035
The Adventures of Baron Munchausen,12/7/1988,46630000,8083123,-38546877,-319891.09543568466
Fair Game,11/3/1995,50000000,11534477,-38465523,-250426.58203125
Pirates,5/8/1986,40000000,1641825,-38358175,-352233.01193755737
Titan A.E.,6/16/2000,75000000,36754634,-38245366,-221327.34953703702
Mystery Men,8/6/1999,68000000,29762011,-38237989,-228832.9682824656
Wyatt Earp,6/24/1994,63000000,25052000,-37948000,-255714.2857142857
Around the World in 80 Days,6/16/2004,110000000,72178895,-37821105,-199689.04435058078
Hart's War,2/15/2002,70000000,32287044,-37712956,-212108.8638920135
Windtalkers,6/14/2002,115000000,77628265,-37371735,-207736.15897720956
Ride with the Devil,11/24/1999,38000000,635096,-37364904,-222013.68983957218
Street Fighter: The Legend of Chun-Li,2/27/2009,50000000,12764201,-37235799,-175055.11755496947
Solomon Kane,9/16/2009,45000000,7810000,-37190000,-172034.95283957128
City of Ember,10/7/2008,55000000,17869048,-37130952,-171447.742793423
The Mod Squad,3/26/1999,50000000,13260050,-36739950,-221058.6642599278
Jonah Hex,6/18/2010,47000000,10539000,-36461000,-167243.85466788374
I Spy,10/31/2002,70000000,33561137,-36438863,-200986.5581908439
The Fan,8/15/1996,55000000,18626419,-36373581,-231237.00572155116
Broken City,1/18/2013,56000000,19701164,-36298836,-156348.62985966937
Timeline,11/26/2003,80000000,43935763,-36064237,-195682.24091155722
Miracle at St. Anna,9/15/2008,45000000,9323833,-35676167,-163066.44940420418
The Majestic,12/21/2001,72000000,37317558,-34682442,-195835.358554489
At Play in the Fields of the Lord,12/6/1991,36000000,1345903,-34654097,-251298.74546773022
Mary Reilly,2/23/1996,47000000,12379402,-34620598,-222354.51509312782
Man on the Moon,12/22/1999,82000000,47434430,-34565570,-204772.33412322274
Black Gold,12/21/2011,40000000,5446000,-34554000,-152445.23856793065
Black Gold,12/21/2011,40000000,5446000,-34554000,-152445.23856793065
Universal Soldier: The Return,8/5/1999,45000000,10667893,-34332107,-205458.4500299222
Anna Karenina,4/4/1997,35000000,791830,-34208170,-213534.1448189763
Strange Days,10/13/1995,42000000,7959291,-34040709,-221475.0097592713
Deep Rising,1/30/1998,45000000,11203026,-33796974,-208752.1556516368
Sinbad: Legend of the Seven Seas,7/2/2003,60000000,26288320,-33711680,-183315.2800435019
The Big Year,10/13/2011,41000000,7448385,-33551615,-148182.43449150035
Terminal Velocity,9/23/1994,50000000,16478900,-33521100,-224221.40468227424
Baby's Day Out,7/1/1994,50000000,16671505,-33328495,-224585.54582210243
Event Horizon,8/15/1997,60000000,26673242,-33326758,-207255.95771144278
Isn't She Great,1/28/2000,36000000,3003296,-32996704,-194326.87868080093
Stolen,5/17/2012,35000000,2106557,-32893443,-143340.28970097352
Lady in the Water,7/21/2006,75000000,42285169,-32714831,-160445.4683668465
Virgin Territory,12/17/2007,38000000,5410749,-32589251,-154392.8889520561
Against the Ropes,2/20/2004,39000000,6614280,-32385720,-172816.00853788687
The Cotton Club,12/14/1984,58000000,25928721,-32071279,-304570.5508072175
Valmont,11/17/1989,33000000,1132112,-31867888,-252719.17525773196
Christopher Columbus: The Discovery,8/21/1992,40000000,8251071,-31748929,-224691.64189667374
The Interview,12/25/2014,44000000,12342632,-31657368,-135457.50876096994
Nothing but Trouble,2/14/1991,40000000,8479793,-31520207,-233829.42878338278
Big Trouble,4/5/2002,40000000,8493890,-31506110,-175228.6429365962
Basic Instinct 2,3/29/2006,70000000,38629478,-31370522,-155684.97270471463
Land of the Lost,6/5/2009,100000000,68688831,-31311169,-145165.43884131612
The Bonfire of the Vanities,12/21/1990,47000000,15691192,-31308808,-232606.30014858843
Agora,5/17/2009,70000000,39041505,-30958495,-143530.36491680305
The Warrior's Way,12/2/2010,42000000,11087569,-30912431,-141037.37584348864
Havana,12/11/1990,40000000,9243140,-30756860,-229871.89835575485
Switchback,10/31/1997,37000000,6482195,-30517805,-188964.73684210525
Treasure Planet,11/26/2002,140000000,109578115,-30421885,-168169.62410171365
Radio Flyer,2/21/1992,35000000,4651977,-30348023,-217860.89734386216
Nixon,12/22/1995,44000000,13681765,-30318235,-196361.62564766838
The Express,10/10/2008,40000000,9793496,-30206504,-139474.9299312472
Surviving Christmas,9/21/2004,45000000,14793624,-30206376,-158231.40911471975
Little Buddha,12/1/1993,35000000,4858139,-30141861,-206734.30041152262
辛亥革命,7/3/2011,30000000,108348,-29891652,-132309.61128176982
Dominion: Prequel to the Exorcist,5/20/2005,30000000,251495,-29748505,-152948.6118251928
The Insider,10/28/1999,90000000,60289912,-29710088,-176530.52881758762
Mr. Saturday Night,9/23/1992,43000000,13300000,-29700000,-209449.92947813822
Mortdecai,1/21/2015,60000000,30418560,-29581440,-126027.55600241988
Idiocracy,9/1/2006,30000000,495303,-29504697,-145414.96796451454
Winter's Tale,2/13/2014,60000000,30800231,-29199769,-124370.23864793147
Mission to Mars,3/10/2000,90000000,60874615,-29125385,-170124.91238317758
Extreme Ops,11/27/2002,40000000,10959475,-29040525,-160533.58208955222
TEKKEN,3/20/2010,30000000,967000,-29033000,-133173.40109811982
Thunderbirds,7/23/2004,57000000,28283637,-28716363,-151537.53562005277
The Adventures of Ford Fairlane,7/11/1990,49000000,20423389,-28576611,-219145.78987730062
Cats Don't Dance,3/26/1997,32000000,3566637,-28433363,-177486.66042446942
Practical Magic,10/16/1998,75000000,46683377,-28316623,-172662.33536585365
The Soloist,4/24/2009,60000000,31720158,-28279842,-132237.77682178663
Rebound,7/1/2005,45000000,16809014,-28190986,-144273.21392016378
My Favorite Martian,2/11/1999,65000000,36850101,-28149899,-171124.00607902734
The Finest Hours,1/25/2016,80000000,52099090,-27900910,-117670.24726815711
Whiteout,9/9/2009,40000000,12206028,-27793972,-128694.26630673847
White Squall,2/2/1996,38000000,10300000,-27700000,-178825.0484183344
The Phantom,6/6/1996,45000000,17300889,-27699111,-176765.22654754308
Enemy Mine,12/12/1985,40000000,12303411,-27696589,-253399.71637694418
Ballerina,12/14/2016,30000000,2351359,-27648641,-114519.37191424501
Revolution,12/25/1985,28000000,358574,-27641426,-252202.79197080294
Machine Gun Preacher,9/23/2011,30000000,2527904,-27472096,-121331.92592559877
The Chamber,10/11/1996,50000000,22540359,-27459641,-173465.83070120023
Super Mario Bros.,5/28/1993,48000000,20915465,-27084535,-187566.03185595566
Domino,9/22/2005,50000000,22944502,-27055498,-135820.7730923695
Silent Fall,10/28/1994,30000000,3180674,-26819326,-179153.8142952572
Trespass,10/13/2011,36000000,9612469,-26387531,-116541.88878240093
The Gunman,2/16/2015,40000000,13644292,-26355708,-111620.44562275802
Santa Claus: The Movie,10/29/1985,50000000,23717291,-26282709,-241125.77064220182
Third Person,9/9/2013,28000000,1749201,-26250799,-112111.51446301286
Nine,12/3/2009,80000000,53825515,-26174485,-121206.78956605494
The Good German,12/8/2006,32000000,5914908,-26085092,-129262.1010901883
Speed Racer,5/9/2008,120000000,93945766,-26054234,-120269.55389785442
The Relic,1/10/1997,60000000,33956608,-26043392,-163691.96731615337
A Hologram for the King,4/22/2016,30000000,4212494,-25787506,-107345.51615333701
Memoirs of an Invisible Man,2/28/1992,40000000,14358033,-25641967,-184077.2936109117
Sin City: A Dame to Kill For,8/20/2014,65000000,39407616,-25592384,-107517.02089223672
The Swan Princess,11/18/1994,35000000,9771658,-25228342,-168525.99866399466
Oldboy,11/14/2013,30000000,4861022,-25138978,-107860.66787088802
The Good Shepherd,12/11/2006,85000000,59908565,-25091435,-124338.1318136769
I Still Know What You Did Last Summer,11/13/1998,65000000,40002112,-24997888,-152426.1463414634
The Adventurer: The Curse of the Midas Box,12/5/2013,25000000,6399,-24993601,-107246.11991469604
Free State of Jones,6/24/2016,50000000,25035950,-24964050,-103745.40784946058
Spanglish,12/17/2004,80000000,55041367,-24958633,-130879.04037755638
"\"一個人的武�?\"\"A martial arts instructor working at a police academy gets imprisoned after killing a man by accident. But when a vicious killer starts targeting martial arts masters\"",10/31/2014,25000000,129115,-24870885,-105317.72044158187
Twisted,2/27/2004,50000000,25195000,-24805000,-132363.92742796158
Lay the Favorite,6/22/2012,26350000,1576687,-24773313,-108131.2984496124
Under Suspicion,9/24/2000,25000000,260562,-24739438,-142180.67816091955
Showgirls,9/22/1995,45000000,20350754,-24649246,-160372.4528301887
Money Train,11/21/1995,60000000,35431113,-24568887,-160057.89576547232
Dark Tide,3/28/2012,25000000,432274,-24567726,-106776.73903122758
Bandidas,1/18/2006,35000000,10496317,-24503683,-123319.99496728738
Without Limits,9/11/1998,25000000,777423,-24222577,-148059.76161369192
Flags of Our Fathers,10/18/2006,90000000,65900249,-24099751,-119601.74193548386
47 Ronin,12/6/2013,175000000,150962475,-24037525,-103143.65219331556
The Pebble and the Penguin,4/11/1995,28000000,3983912,-24016088,-158104.5951283739
Flight of the Phoenix,12/17/2004,45000000,21009180,-23990820,-125803.98531725224
Crossing Over,2/27/2009,25000000,1037335,-23962665,-112654.68315868158
Hollywood Homicide,6/9/2003,75000000,51142659,-23857341,-129871.2084921067
Blood Work,8/4/2002,50000000,26199517,-23800483,-131712.68954067517
Your Highness,4/8/2011,49900000,26121638,-23778362,-105725.77876979715
Intersection,1/21/1994,45000000,21355893,-23644107,-161173.1901840491
Jane Got a Gun,1/1/2016,25000000,1397284,-23602716,-99624.82905333536
The Flintstones in Viva Rock Vegas,4/28/2000,83000000,59468275,-23531725,-137211.22448979592
The Young and Prodigious T.S. Spivet,10/16/2013,33000000,9494789,-23505211,-100850.86819782983
Wind,9/11/1992,29000000,5519569,-23480431,-166174.3170559094
Gattaca,9/7/1997,36000000,12532777,-23467223,-145578.3064516129
The Order,9/5/2003,35000000,11560806,-23439194,-126561.52267818575
Solarbabies,11/26/1986,25000000,1579260,-23420740,-211952.39819004523
Space Truckers,3/1/1996,25000000,1614266,-23385734,-150197.39242132308
Angel Eyes,5/15/2001,53000000,29700000,-23300000,-131119.86494091165
Life or Something Like It,4/26/2002,40000000,16872671,-23127329,-128628.0812013348
Blood Ties,8/22/2013,25500000,2415472,-23084528,-98589.05227013568
Trapped,9/20/2002,30000000,6916869,-23083131,-127320.08273579701
Honky Tonk Freeway,8/21/1981,24000000,939423,-23060577,-247431.0836909871
Metro,1/16/1997,55000000,31987563,-23012437,-144188.20175438598
Freedomland,2/17/2006,37665000,14655628,-23009372,-115162.02202202202
Junior,11/22/1994,60000000,37000000,-23000000,-153640.61456245827
Passengers,9/26/2008,25000000,2000000,-23000000,-106199.75712577283
Chasing Liberty,1/9/2004,23000000,12,-22999988,-124190.00000000001
Man of Tai Chi,7/4/2013,25000000,2054941,-22945059,-98225.39341427079
A Troll in Central Park,10/7/1994,23000000,71368,-22928632,-153368.77591973243
The Sheltering Sky,10/24/1990,25000000,2075084,-22924916,-171337.18983557547
Psycho,12/4/1998,60000000,37141130,-22858870,-139468.39536302624
Me and Orson Welles,11/25/2009,25000000,2336172,-22663828,-104949.90946936545
Battlefield Earth,5/10/2000,44000000,21400000,-22600000,-131778.42565597667
BloodRayne,10/22/2005,25000000,2405420,-22594580,-114345.04048582996
Son of the Pink Panther,1/1/1993,25000000,2438031,-22561969,-158218.57643758768
Zoom,8/11/2006,35000000,12506188,-22493812,-110317.86169691024
Kundun,12/25/1997,28000000,5684789,-22315211,-138089.176980198
Silence,12/22/2016,46000000,23737523,-22262477,-91675.8716680599
Waterloo,10/26/1970,25000000,3052000,-21948000,-554242.4242424242
特務迷城,1/18/2001,25697387,3849941,-21847446,-124274.43686006825
The Frozen Ground,7/18/2013,27220000,5496951,-21723049,-92882.36551691701
Pan,9/24/2015,150000000,128388320,-21611680,-90867.22895416208
The Death and Life of Bobby Z,7/23/2007,22000000,413454,-21586546,-103822.90048432788
Barney's Version,10/26/2010,30000000,8454301,-21545699,-98470.76594013794
We Are Marshall,12/12/2006,65000000,43545364,-21454636,-106316.33300297323
The Lost City of Z,10/15/2016,30000000,8574339,-21425661,-88635.04585713753
One Night Stand,11/14/1997,24000000,2642983,-21357017,-132241.59133126936
American Outlaws,8/17/2001,35000000,13678913,-21321087,-119579.84856982612
Paranoia,8/14/2013,35000000,13785015,-21214985,-90710.00996250166
Stuck on You,12/10/2003,55000000,33828318,-21171682,-114876.19099294627
Shelter,3/27/2010,22000000,851517,-21148483,-97007.38501621493
Rules Don't Apply,11/23/2016,25000000,3885342,-21114658,-87455.92133602838
FearDotCom,8/9/2002,40000000,18902015,-21097985,-116756.97288323188
Drive Angry,2/24/2011,50000000,28931401,-21068599,-94280.58281535975
The Rum Diary,10/13/2011,45000000,24000000,-21000000,-92747.58083393326
Our Brand Is Crisis,9/11/2015,28000000,7002261,-20997739,-88246.18714408792
The Spirit,12/25/2008,60000000,39031337,-20968663,-99310.24471566663
Tank Girl,3/31/1995,25000000,4064495,-20935505,-137824.2593811718
Astro Boy,10/15/2009,65000000,44091067,-20908933,-96721.35796130024
Babe: Pig in the City,11/25/1998,90000000,69131860,-20868140,-127322.39170225748
Idle Hands,4/30/1999,25000000,4152230,-20847770,-125437.8459687124
The Hunted,3/11/2003,55000000,34234008,-20765992,-112736.11292073833
Domestic Disturbance,10/30/2001,75000000,54249294,-20750706,-116971.28523111611
Amelia,10/22/2009,40000000,19258519,-20741481,-95878.89335737067
Supergirl,11/19/1984,35000000,14296438,-20703562,-196615.0237416904
Duplex,9/26/2003,40000000,19322135,-20677865,-111772.24324324324
Extreme Measures,9/27/1996,38000000,17380126,-20619874,-130258.20593809221
Beyond a Reasonable Doubt,2/5/2009,25000000,4388563,-20611437,-97135.32962915835
Their Finest,4/6/2017,32745300,12173470,-20571830,-84130.10583828173
Unfinished Business,3/5/2015,35000000,14431253,-20568747,-87111.78261808664
DOA: Dead or Alive,9/7/2006,21000000,480314,-20519686,-101132.01577131591
London Boulevard,11/10/2010,25000000,4644108,-20355892,-93032.96572716096
Color of Night,8/19/1994,40000000,19726050,-20273950,-135702.4765729585
Red Dawn,11/21/2012,65000000,44806783,-20193217,-87949.16833985914
The Love Guru,6/20/2008,62000000,41819064,-20180936,-91746.5403429652
Very Bad Things,9/11/1998,30000000,9898412,-20101588,-122870.34229828851
The Beaver,2/11/2011,21000000,970816,-20029184,-90503.25111043834
Le Hussard sur le toit,9/20/1995,35000000,15000000,-20000000,-130123.61743656475
Chaos,1/17/2005,20000000,10289,-19989711,-104221.64233576642
5 Days of War,4/14/2011,20000000,17479,-19982521,-88848.32329951179
Momentum,8/1/2015,20000000,133332,-19866668,-83362.71169371759
Samba,10/15/2014,20000000,151530,-19848470,-83596.08815960713
Dungeons & Dragons,12/8/2000,35000000,15185241,-19814759,-113877.92528735632
Dark Places,3/31/2015,20000000,208588,-19791412,-83649.60122401195
Last Man Standing,9/20/1996,67000000,47267001,-19732999,-124655.71067593177
Assassins,10/6/1995,50000000,30303072,-19696928,-128151.77618737803
The Fountain,9/6/2006,35000000,15304890,-19695110,-97068.06308526367
Rapa Nui,9/9/1994,20000000,305070,-19694930,-131826.8406961178
A Simple Wish,7/11/1997,28000000,8345056,-19654944,-122460.71028037384
The Contract,4/5/2006,25000000,5549200,-19450800,-96530.02481389578
The Fifth Estate,10/11/2013,28000000,8555008,-19444992,-83259.7946443099
Bitter Harvest,2/23/2017,20000000,557241,-19442759,-79748.47929253777
Meet the Deedles,3/27/1998,24000000,4562146,-19437854,-119617.56307692308
Not Fade Away,12/21/2012,20000000,610792,-19389208,-84198.4019454577
Ali,12/11/2001,107000000,87713825,-19286175,-109146.43463497455
Sheena,8/17/1984,25000000,5778353,-19221647,-183063.30476190476
Micmacs à tire-larigot,10/28/2009,33000000,14000000,-19000000,-87828.78010447002
Horsemen,2/6/2009,20000000,1017401,-18982599,-89459.11976361142
For Love or Money,10/1/1993,30000000,11146270,-18853730,-129401.02951269734
Steal Big Steal Little,9/29/1995,25000000,6278139,-18721861,-121807.81392322708
The Road to El Dorado,3/31/2000,95000000,76432727,-18567273,-108390.38528896672
Белка и Стрелка. Звёздные собаки,3/18/2010,25000000,6500000,-18500000,-84858.8819727626
Beowulf,4/1/1999,20000000,1531251,-18468749,-111123.64019253911
What Just Happened,10/17/2008,25000000,6673422,-18326578,-86273.1693538896
Marci X,8/22/2003,20000000,1675706,-18324294,-98943.27213822895
Femme Fatale,11/6/2002,35000000,16838910,-18161090,-100171.48372862658
Duplicity,3/19/2009,78146652,60000000,-18146652,-85099.66235227912
The Iceman,9/1/2012,20000000,1969193,-18030807,-77918.15718625624
The Chase,3/4/1994,26000000,8009329,-17990671,-122219.23233695653
Sunshine,4/5/2007,50000000,32017803,-17982197,-87002.49170238913
Der rote Baron,3/29/2008,18000000,40239,-17959761,-83602.59841823268
A Thousand Words,3/7/2012,40000000,22044277,-17955723,-78275.27987026575
Catwoman,7/22/2004,100000000,82102379,-17897621,-94446.54881266491
Shark Night,9/2/2011,28000000,10126458,-17873542,-78776.5911965763
Lord of War,9/16/2005,42000000,24127895,-17872105,-89719.40261044177
Setup,11/4/2011,20000000,2128186,-17871814,-78998.42638023251
Under the Rainbow,7/31/1981,20000000,2297493,-17702507,-191793.14192849403
The Informers,11/5/2008,18000000,382174,-17617826,-82936.68824290925
City By The Sea,9/6/2002,40000000,22433915,-17566085,-97050.19337016574
Sabotage,3/28/2014,35000000,17508518,-17491482,-73781.30694472566
Salton Sea,1/1/2002,18000000,676698,-17323302,-97816.4991530209
Stanley & Iris,2/9/1990,23000000,5820015,-17179985,-134218.6328125
十月圍城,12/18/2009,23000000,5837674,-17162326,-79203.30245930766
Carlos,5/19/2010,18000000,871279,-17128721,-78584.73149358842
Wicker Park,9/3/2004,30000000,13001257,-16998743,-89514.18114797262
Solaris,11/27/2002,47000000,30002758,-16997242,-93959.32559425097
Reign of Fire,7/12/2002,60000000,43061982,-16938018,-94047.85119378123
The Nutcracker,11/24/1993,19000000,2119994,-16880006,-115775.07544581618
Rosewood,2/21/1997,30000000,13130349,-16869651,-105435.31875
Seraphim Falls,9/13/2006,18000000,1196307,-16803693,-82817.609659931
For the Boys,11/22/1991,40000000,23202444,-16797556,-121809.68817984046
Criminal,4/14/2016,31500000,14708696,-16791304,-70179.86215889761
Glitter,9/21/2001,22000000,5271666,-16728334,-94138.06415306697
Body of Evidence,1/15/1993,30000000,13273595,-16726405,-117295.96774193548
Leatherheads,3/24/2008,58000000,41299492,-16700508,-77740.78194606722
Collide,8/4/2016,21500000,4811525,-16688475,-69290.19842307836
Walk Hard: The Dewey Cox Story,12/21/2007,35000000,18317151,-16682849,-79035.668940686
Thumbelina,3/30/1994,28000000,11373501,-16626499,-112798.50067842605
Southland Tales,5/15/2006,17000000,374743,-16625257,-82100.03456790124
बॉम्बे वेलवेट,5/15/2015,18000000,1500000,-16500000,-69384.57980277958
Term Life,4/29/2016,16500000,21256,-16478744,-68595.98133447669
Hoodwinked Too! Hood VS. Evil,4/29/2011,30000000,13521829,-16478171,-72923.87725478395
Josh and S.A.M.,11/24/1993,18000000,1528163,-16471837,-112975.56241426611
디워,2/8/2007,70000000,53587404,-16412596,-80651.97371977258
The Bounty,5/4/1984,25000000,8613462,-16386538,-158477.1566731141
Geronimo: An American Legend,12/10/1993,35000000,18635620,-16364380,-112238.54595336076
La Cité des Enfants Perdus,5/16/1995,18000000,1738611,-16261389,-106632.05901639344
When Time Ran Out...,3/28/1980,20000000,3763988,-16236012,-200444.59259259258
Он - дракон,12/4/2015,18000000,1776333,-16223667,-68591.76408413486
On the Road,5/22/2012,25000000,8784318,-16215682,-70663.34027662782
Renaissance,3/16/2006,18000000,1831348,-16168652,-80241.44913151365
Stormbreaker,7/21/2006,40000000,23937870,-16062130,-78774.54634624816
Lookin' to Get Out,10/8/1982,17000000,946461,-16053539,-163477.99389002036
Playing by Heart,12/30/1998,20000000,3970078,-16029922,-97564.95435179549
Welcome to Mooseport,2/24/2004,30000000,14000000,-16000000,-85378.86872998932
The Cookout,9/3/2004,16000000,12,-15999988,-84254.80779357556
I'm Not There.,10/1/2007,20000000,4001121,-15998879,-76573.10851169736
The Weight of Water,9/25/2000,16000000,109130,-15890870,-91326.83908045977
Cool World,7/10/1992,30000000,14110589,-15889411,-113091.89323843416
Extraordinary Measures,1/21/2010,31000000,15134293,-15865707,-73201.2263484989
Species II,4/10/1998,35000000,19165560,-15834440,-97442.7076923077
Stateside,5/23/2004,16000000,174318,-15825682,-83424.78650500791
The Neverending Story II: The Next Chapter,10/24/1990,32000000,16283667,-15716333,-117461.38266068758
Cursed,2/25/2005,35000000,19294901,-15705099,-81247.2788411795
The People vs. Larry Flynt,10/12/1996,36000000,20300385,-15699615,-99176.34238787112
Adore,4/3/2013,16000000,318982,-15681018,-67436.2472100494
Renaissance Man,6/3/1994,40000000,24332324,-15667676,-105862.67567567568
Le peuple migrateur,12/12/2001,35866397,20217080,-15649317,-88564.32937181664
Rock of Ages,6/13/2012,75000000,59418613,-15581387,-67899.2626744176
Play It to the Bone,12/25/1999,24000000,8434146,-15565854,-92214.77488151658
Harley Davidson and the Marlboro Man,8/23/1991,23000000,7434726,-15565274,-113449.51895043733
Winnie the Pooh,4/13/2011,30000000,14460000,-15540000,-69095.53324500013
Valiant,3/25/2005,35000000,19478106,-15521894,-79763.07297019528
Veronica Guerin,7/11/2003,17000000,1569918,-15430082,-83904.74170744969
Dylan Dog: Dead of Night,3/16/2011,20000000,4634062,-15365938,-68321.60102442798
Paradise,9/18/1991,34000000,18634643,-15365357,-111829.38136826783
Fire with Fire,8/31/2012,20000000,4636169,-15363831,-66393.11256789985
The Assassination of Jesse James by the Coward Robert Ford,9/2/2007,30000000,14711793,-15288207,-73328.25075543192
Big Miracle,2/2/2012,40000000,24719215,-15280785,-67120.19520080119
The Space Between Us,1/26/2017,30000000,14793385,-15206615,-62423.759149107354
The Life Aquatic with Steve Zissou,12/10/2004,50000000,34808403,-15191597,-79829.72674724119
Explorers,7/12/1985,25000000,9873044,-15126956,-140324.26716141
The Legend of the Lone Ranger,8/20/1981,18000000,2945600,-15054400,-161527.89699570814
Blitz,5/20/2011,15774948,741875,-15033073,-66599.94595121432
Roar,11/12/1981,17000000,2000000,-15000000,-160085.37886872998
Love Story 2050,7/4/2008,20000000,5000000,-15000000,-68192.97703260534
Xue di zi,12/20/2012,15000000,5290,-14994710,-65115.12072259858
The Cave,8/25/2005,30000000,15007991,-14992009,-75412.52012072434
The Guardian,9/28/2006,70000000,55011732,-14988268,-74272.88404360753
The Good Night,1/25/2007,15000000,20380,-14979620,-73610.2880112433
All The Queen's Men,10/14/2001,15000000,23000,-14977000,-84282.4985931345
Walk of Shame,5/2/2014,15000000,59209,-14940791,-62802.82051282051
Mrs. Winterbourne,4/19/1996,25000000,10070000,-14930000,-95338.44189016602
Silent Trigger,6/26/1996,15000000,76382,-14923618,-95054.89171974522
The Messengers,2/2/2007,16000000,1109660,-14890340,-73171.56349662652
Tetro,6/11/2009,15000000,113221,-14886779,-69018.3686999578
Possession,10/2/2002,25000000,10113733,-14886267,-82108.4776613348
Down,5/11/2001,15000000,163169,-14836831,-83493.70287000564
Bandslam,8/6/2009,20000000,5210988,-14789012,-68520.30727318217
Down with Love,5/8/2003,35000000,20298207,-14701793,-80118.76294277929
The Yellow Handkerchief,12/17/2008,15000000,317000,-14683000,-69540.54834874942
Straw Dogs,9/16/2011,25000000,10324441,-14675559,-64815.36164931698
Obitaemyy Ostrov,12/18/2008,36500000,21834845,-14665155,-69456.03216777256
Alex Cross,10/18/2012,45000000,30353232,-14646768,-63620.469027586536
Equilibrium,12/6/2002,20000000,5359645,-14640355,-80930.65229408513
Alex & Emma,6/16/2003,30000000,15368897,-14631103,-79560.10331702011
Anonymous,10/21/2011,30000000,15395087,-14604913,-64557.80842505415
Fur: An Imaginary Portrait of Diane Arbus,8/30/2006,16800000,2281089,-14518911,-71556.97880729423
The Brothers Bloom,9/9/2008,20000000,5530764,-14469236,-66135.10190462696
Highlander II: The Quickening,1/30/1991,30000000,15556340,-14443660,-107148.81305637982
Cosmopolis,5/25/2012,20500000,6063556,-14436444,-62909.926005978785
I Could Never Be Your Woman,5/11/2007,24000000,9576495,-14423505,-69360.78076836147
The Bad Lieutenant: Port of Call - New Orleans,9/11/2009,25000000,10589102,-14410898,-66726.69688705323
Captivity,3/9/2007,17000000,2626800,-14373200,-69992.98765047333
Steel,8/15/1997,16000000,1686429,-14313571,-89014.74502487562
Summer Catch,8/22/2001,34000000,19693891,-14306109,-80236.16937745373
One Eight Seven,7/29/1997,20000000,5716080,-14283920,-88830.34825870646
Abandon,10/14/2002,25000000,10719357,-14280643,-78768.02537231108
Stay Tuned,8/14/1992,25000000,10736401,-14263599,-101232.0723917672
Slow Burn,9/12/2005,15500000,1237615,-14262385,-71742.37927565392
The Fall of the Roman Empire,3/24/1964,19000000,4750000,-14250000,-461165.04854368937
Screamers,9/8/1995,20000000,5781885,-14218115,-92807.53916449087
Pathfinder,1/11/2007,45000000,30822861,-14177139,-70039.61643348352
W.E.,9/1/2011,15000000,868439,-14131561,-62284.0287541485
The Manhattan Project,6/13/1986,18000000,3900000,-14100000,-128767.12328767123
The Bachelor,11/5/1999,51000000,36911617,-14088383,-83709.94058229352
Surviving Picasso,9/4/1996,16000000,1985001,-14014999,-88814.94930291508
Big Trouble in Little China,5/30/1986,25000000,11000000,-14000000,-127853.88127853881
The Internship,6/7/2013,58000000,44000000,-14000000,-59956.14636151843
The Aviator,12/17/2004,116000000,102000000,-14000000,-73413.7388568432
Suspect Zero,8/27/2004,27000000,13000000,-14000000,-73723.0121116377
Fishtales,8/24/2007,14000000,9216,-13990784,-67105.30001438917
Ghosts of Mars,8/24/2001,28000000,14010832,-13989168,-78458.59786876051
Margaret,9/30/2011,14000000,46495,-13953505,-61626.372995437705
Blues Brothers 2000,2/5/1998,28000000,14051384,-13948616,-86155.75046324891
Equals,7/15/2015,16000000,2084628,-13915372,-58307.72582902445
Return to Oz,6/21/1985,25000000,11137801,-13862199,-128591.82745825603
The Other Man,12/25/2008,15000000,1143856,-13856144,-65624.45356938189
The Whole Ten Yards,4/7/2004,40000000,26155781,-13844219,-73639.46276595745
Onegin,12/22/1999,14000000,206128,-13793872,-81717.25118483412
Stop-Loss,3/28/2008,25000000,11207130,-13792870,-64205.74147088533
The Boat That Rocked,4/1/2009,50000000,36348784,-13651216,-64018.08291127368
Chéri,2/10/2009,23000000,9366227,-13633773,-64251.756655497586
Repo Men,3/18/2010,32000000,18409891,-13590109,-62337.37597989074
Farewell to the King,3/3/1989,16000000,2420917,-13579083,-111030.93213409648
Sphinx,2/11/1981,14000000,439564,-13560436,-154271.17178612057
The Marrying Man,4/5/1991,26000000,12454768,-13545232,-100186.62721893493
Funny People,7/31/2009,75000000,61458982,-13541018,-62738.113550228416
Manderlay,5/16/2005,14200000,674918,-13525082,-69537.69665809769
What Dreams May Come,10/2/1998,85000000,71485043,-13514957,-82408.2743902439
Little Boy,4/23/2015,20000000,6485961,-13514039,-56828.23742141671
The Quick and the Dead,2/9/1995,32000000,18552460,-13447540,-89115.57322730284
A Cure for Wellness,2/15/2017,40000000,26559557,-13440443,-55173.55287085955
Pawn Sacrifice,9/16/2015,19000000,5578519,-13421481,-56431.18845600787
Ronin,9/25/1998,55000000,41610884,-13389116,-81640.9512195122
The Devil's Double,2/11/2011,19100000,5728213,-13371787,-60421.34300909588
Something Wicked This Way Comes,4/29/1983,19000000,5656087,-13343913,-134515.25201612903
The Pagemaster,11/23/1994,27000000,13670688,-13329312,-89040.16032064128
Stonewall,9/18/2015,13500000,187674,-13312326,-55972.24160983527
The Double,10/27/2011,17000000,3696232,-13303768,-58806.38288467489
A Civil Action,3/5/1998,70000000,56702901,-13297099,-81979.64858199754
Escobar: Paradise Lost,10/11/2014,17000000,3758328,-13241672,-55770.1414714888
The Hoax,10/14/2006,25000000,11772461,-13227539,-65547.76511397422
This Must Be the Place,10/1/2011,25000000,11790979,-13209021,-58338.32109212485
The Big Wedding,4/25/2013,35000000,21819348,-13180652,-56582.67831462363
Flawless,9/1/2007,20000000,6819587,-13180413,-63218.4421315171
Most Wanted,10/10/1997,25000000,11838218,-13161782,-81446.67079207921
Things We Lost in the Fire,9/26/2007,16000000,2849142,-13150858,-62942.03966764942
Universal Soldier: Regeneration,10/1/2009,14000000,875386,-13124614,-60712.35145274474
A Dirty Shame,9/12/2004,15000000,1914166,-13085834,-68909.0784623486
88 Minutes,2/14/2007,30000000,16930884,-13069116,-64222.015833001635
The King and I,3/19/1999,25000000,12000000,-13000000,-78219.01323706379
An American Carol,10/3/2008,20000000,7000000,-13000000,-60025.949679784644
Venuto al mondo,9/13/2012,13000000,18295,-12981705,-56099.016019394396
Little Black Book,8/6/2004,35000000,22034832,-12965168,-68417.77308707124
Big Bully,1/26/1996,15000000,2042530,-12957470,-83650.5487411233
The Musketeer,9/7/2001,40000000,27053815,-12946185,-72609.00168255749
キャプテンハーロック,9/7/2013,30000000,17137302,-12862698,-54933.815647301504
Pennies from Heaven,12/11/1981,22000000,9171289,-12828711,-136475.6489361702
Gold,12/22/2016,20000000,7227038,-12772962,-52598.47882753594
Johnny Handsome,9/12/1989,20000000,7237794,-12762206,-102097.648
Empire of the Sun,12/9/1987,35000000,22238696,-12761304,-110583.22357019063
The Company,9/10/2003,15000000,2281585,-12718415,-68673.94708423327
Love's Labour's Lost,3/31/2000,13000000,299792,-12700208,-74140.15178050204
Almost Famous,9/15/2000,60000000,47383689,-12616311,-72632.76338514681
Body Snatchers,6/9/1993,13000000,428868,-12571132,-87057.70083102492
The Homesman,5/18/2014,16000000,3442853,-12557147,-52685.1931879686
Stone,10/7/2010,22000000,9479718,-12520282,-57245.78096209152
Proof,9/5/2005,20000000,7535331,-12464669,-62699.542253521126
Delirious,8/9/1991,18000000,5546827,-12453173,-91165.24890190337
Hackers,9/14/1995,20000000,7563728,-12436272,-81176.71018276762
L'illusionniste,2/16/2010,18000000,5602431,-12397569,-56966.00668103349
Dutch,7/19/1991,17000000,4603929,-12396071,-90747.22547584187
Pandorum,9/8/2009,33000000,20645327,-12354673,-57205.77027258542
Scott Pilgrim vs. the World,7/27/2010,60000000,47664559,-12335441,-56503.72402799663
Deux frères,4/7/2004,74500000,62172050,-12327950,-65574.20212765958
U Turn,10/3/1997,19000000,6682098,-12317902,-76224.64108910892
City of Joy,4/15/1992,27000000,14683921,-12316079,-88287.3046594982
Labyrinth,6/27/1986,25000000,12729917,-12270083,-112055.55251141553
King Solomon's Mines,3/20/1985,12500000,238227,-12261773,-114703.20860617398
Riding in Cars with Boys,10/19/2001,48000000,35743308,-12256692,-69090.710259301
Enter the Void,5/5/2009,13000000,754249,-12245751,-57261.666729013916
Flipped,8/6/2010,14000000,1755212,-12244788,-56088.478874271685
Shoot 'Em Up,7/26/2007,39000000,26820641,-12179359,-58577.98544611552
The End of the Affair,12/3/1999,23000000,10827816,-12172184,-72324.32560903148
Pompeii,2/18/2014,130000000,117831631,-12168369,-51496.95081953338
Diggstown,8/14/1992,17000000,4836637,-12163363,-86326.21007806955
eXistenZ,4/14/1999,15000000,2856712,-12143288,-73064.30806257522
Music of the Heart,10/29/1999,27000000,14859394,-12140606,-72136.6963755199
L'Empire des loups,4/20/2005,24000000,11875866,-12124134,-62366.944444444445
Ed Wood,9/27/1994,18000000,5887457,-12112543,-81020.35451505017
Take Me Home Tonight,3/4/2011,19000000,6928068,-12071932,-54021.09483726903
Serving Sara,8/20/2002,29000000,16930185,-12069815,-66684.06077348067
Sky Captain and the World of Tomorrow,9/17/2004,70000000,57958696,-12041304,-63076.5007857517
The Young Messiah,3/10/2016,18500000,6490401,-12009599,-50432.52901751969
Brokedown Palace,8/13/1999,25000000,13000000,-12000000,-71813.2854578097
In the Cut,9/9/2003,12000000,23,-11999977,-64794.692224622035
The Samaritan,3/2/2012,12000000,2521,-11997479,-52301.20928367162
Rock the Kasbah,10/22/2015,15000000,3020664,-11979336,-50474.163211649306
That's My Boy,6/14/2012,70000000,58058367,-11941633,-52038.2476751584
Deadfall,11/8/2012,12000000,66351,-11933649,-51835.62316209207
Clockers,9/15/1995,25000000,13071518,-11928482,-77862.1540469974
Whiskey Tango Foxtrot,3/4/2016,35000000,23083334,-11916666,-50042.27067340803
Mozart and the Whale,9/10/2005,12000000,84967,-11915033,-59934.773641851105
Foxcatcher,5/19/2014,24000000,12096300,-11903700,-49943.568722387485
Infamous,11/16/2006,13000000,1151330,-11848670,-58714.91575817641
Country of My Skull,5/4/2004,12000000,163536,-11836464,-62593.67530407192
Cirque du Freak: The Vampire's Assistant,10/23/2009,40000000,28169671,-11830329,-54686.4928581334
Alone in the Dark,11/12/1982,20000000,8178569,-11821431,-120626.8469387755
Red Scorpion,12/24/1988,16000000,4192440,-11807560,-97502.55986787779
Antitrust,1/12/2001,30000000,18195610,-11804390,-67415.13420902341
Henry's Crime,1/14/2010,12000000,204940,-11795060,-54433.630074716064
Midnight Special,2/18/2016,18000000,6212282,-11787718,-49500.7726806981
Bopha!,9/16/1993,12000000,212483,-11787517,-80902.6561427591
Drona,10/2/2008,15000000,3250000,-11750000,-54254.22374903612
Life of Crime,9/14/2013,12000000,265452,-11734548,-50115.72972765205
Hummingbird,5/7/2013,20000000,8352885,-11647115,-49999.42046405804
Starchaser: The Legend of Orin,1/1/1985,15000000,3360800,-11639200,-110324.17061611374
Ready to Rumble,4/7/2000,24000000,12372410,-11627590,-67878.51722124926
Pride and Prejudice and Zombies,2/4/2016,28000000,16374328,-11625672,-49030.504700330224
Article 99,3/13/1992,18000000,6375979,-11624021,-83445.9511844939
Death Defying Acts,9/13/2007,20000000,8380329,-11619671,-55732.509952515706
Run,2/1/1991,16000000,4409328,-11590672,-85984.21364985162
Clifford,4/1/1994,19000000,7411659,-11588341,-78618.32428765265
Lords of Dogtown,6/3/2005,25000000,13411957,-11588043,-59578.62724935733
Jefferson in Paris,3/31/1995,14000000,2474000,-11526000,-75878.8676761027
Dream House,9/30/2011,50000000,38502340,-11497660,-50780.00715481338
Looney Tunes: Back in Action,11/14/2003,80000000,68514844,-11485156,-62250.16802168022
The Midnight Meat Train,8/7/2008,15000000,3533227,-11466773,-52339.14079402609
Oscar,4/26/1991,35000000,23562716,-11437284,-84345.75221238939
Tideland,9/9/2005,12000000,566611,-11433389,-57512.01710261569
Assassination of a High School President,1/17/2008,11500000,69564,-11430436,-53995.34231174389
Casino Jack,9/16/2010,12500000,1083683,-11416317,-52198.18390478759
The Avengers,8/13/1998,60000000,48585416,-11414584,-69856.69522643818
Boat Trip,10/1/2002,20000000,8586376,-11413624,-62954.35190292333
Sunset,4/29/1988,16000000,4594452,-11405548,-97068.49361702127
An Unfinished Life,9/9/2005,30000000,18618284,-11381716,-57252.09255533199
Youth,5/20/2015,13360000,2000000,-11360000,-47603.48309992541
I Saw the Light,2/5/2016,13000000,1646788,-11353212,-47881.42262484659
Lost Highway,1/15/1997,15000000,3675201,-11324799,-71180.38340666248
Nothing But the Truth,12/19/2008,11500000,186702,-11313298,-53581.212732603024
RoboCop 3,4/17/1993,22000000,10696210,-11303790,-78389.66712898752
The Funeral,1/26/1996,12500000,1227324,-11272676,-72773.89283408651
Shadows and Fog,12/5/1991,14000000,2735731,-11264269,-81684.32922407541
The Vatican Tapes,7/24/2015,13000000,1784763,-11215237,-47060.36103324997
Ratchet & Clank,4/13/2016,20000000,8821329,-11178671,-46721.65961021646
Little Children,10/6/2006,26000000,14821658,-11178342,-55393.171456888005
Crooked Arrows,5/18/2012,13000000,1832541,-11167459,-48664.61708747679
The Paperboy,9/14/2012,12500000,1353868,-11146132,-48166.78838583102
Spartan,3/12/2004,19250000,8112712,-11137288,-59430.56563500533
Michael Collins,10/25/1996,28000000,16900000,-11100000,-69987.3896595208
The Life of David Gale,2/21/2003,50000000,38955598,-11044402,-59958.75135722042
Shorts,8/21/2009,40000000,28972508,-11027492,-51060.53183558751
Rampart,11/23/2011,12000000,972512,-11027488,-48865.113970718565
The Super,10/4/1991,22000000,11000863,-10999137,-80051.94323144105
Moonlight Mile,9/9/2002,21000000,10011050,-10988950,-60712.43093922652
The Arrival,5/31/1996,25000000,14048372,-10951628,-69889.13848117422
Red Sonja,4/9/1985,17900000,6948633,-10951367,-102444.96725912066
Disaster Movie,8/29/2008,25000000,14109284,-10890716,-49778.62082520123
Devil in a Blue Dress,9/15/1995,27000000,16140822,-10859178,-70882.36292428199
Wanderlust,2/23/2012,35000000,24159934,-10840066,-47255.640998814255
Louder Than Bombs,5/18/2015,11000000,161789,-10838211,-45416.9537123174
Canadian Bacon,6/8/1995,11000000,178104,-10821896,-70963.2524590164
The Replacement Killers,2/6/1998,30000000,19204929,-10795071,-66677.39962940087
The Blob,8/5/1988,19000000,8247943,-10752057,-90353.42016806723
Aloha,5/27/2015,37000000,26250020,-10749980,-45047.226342828886
Sahara,4/6/2005,130000000,119269486,-10730514,-55141.3874614594
The Lookout,3/9/2007,16000000,5367030,-10632970,-51779.23760177646
Snow Cake,2/9/2006,12000000,1381665,-10618335,-53439.02868646201
Birdy,12/14/1984,12000000,1400000,-10600000,-100664.767331434
Poulet aux Prunes,10/25/2011,12000000,1428291,-10571709,-46729.91645670336
Aftermath,4/6/2017,10500000,3451,-10496549,-42926.45711668384
Shattered,10/11/1991,22000000,11511031,-10488969,-76338.93013100437
Black Nativity,11/27/2013,17500000,7018189,-10481811,-44976.854652884154
Krull,7/29/1983,27000000,16519460,-10480540,-104596.20758483034
Calendar Girl,9/3/1993,13000000,2570145,-10429855,-71880.46175051689
Punisher: War Zone,12/5/2008,20500000,10089373,-10410627,-49520.649009646666
Tracers,1/15/2015,11000000,593683,-10406317,-44527.194307402
Precious Cargo,7/15/2016,10500000,100659,-10399341,-43217.50170387486
Attack the Block,5/12/2011,14350531,3964682,-10385849,-45962.40551592289
Colonia,2/18/2016,14000000,3621046,-10378954,-43584.87729494566
There Goes My Baby,9/2/1994,10500000,123509,-10376491,-69454.42436412316
Atlas Shrugged Part I,4/14/2011,15000000,4627375,-10372625,-46119.82339288414
Find Me Guilty,3/16/2006,13000000,2636637,-10363363,-51431.08188585608
Ondine,9/14/2009,12000000,1644755,-10355245,-47947.83047567012
The Ladies Man,10/13/2000,24000000,13700000,-10300000,-59195.402298850575
A Home of Our Own,11/5/1993,12000000,1703282,-10296718,-70622.20850480109
Nine 1/2 Weeks,2/14/1986,17000000,6735922,-10264078,-93907.39249771272
Mal de pierres,10/19/2016,10300000,47748,-10252252,-42478.24555733718
Antichrist,5/18/2009,11000000,791867,-10208133,-47327.14089006133
Marvin's Room,12/18/1996,23000000,12803305,-10196695,-64089.84915147706
Le Moine,7/12/2011,11000000,807535,-10192465,-45114.97330937226
Robinson Crusoe,2/4/2016,13500000,3342697,-10157303,-42837.75531291252
The Immigrant,7/3/2013,16000000,5867686,-10132314,-43375.37457833182
The Company Men,10/21/2010,15000000,4882577,-10117423,-46239.87331069501
Highlander,3/7/1986,16000000,5900000,-10100000,-92830.88235294117
Universal Soldier: Day of Reckoning,10/4/2012,11500000,1402307,-10097693,-43653.05187253855
Keeping Up with the Joneses,10/20/2016,40000000,29918745,-10081255,-41769.752188702856
Metallica: Through the Never,9/25/2013,18000000,7972967,-10027033,-42933.8674179819
Sorcerer,6/24/1977,22000000,12000000,-10000000,-163934.4262295082
Deadfall,10/8/1993,10000000,18,-9999982,-68634.05628002746
The Duel,6/24/2016,10000000,4500,-9995500,-41539.22236813671
Janky Promoters,10/16/2009,10000000,9069,-9990931,-46183.75167568067
Forces spéciales,11/2/2011,10000000,10759,-9989241,-44155.244662511606
Cherry 2000,11/12/1987,10000000,14000,-9986000,-86533.79549393414
Strangerland,7/1/2015,10000000,17472,-9982528,-41828.45458278512
Solitary Man,9/7/2009,15000000,5024782,-9975218,-46188.19367594423
Jimmy P.,9/11/2013,10000000,30283,-9969717,-42578.51624393015
The Ice Storm,9/27/1997,18000000,8038061,-9961939,-61645.66212871287
Money for Nothing,9/10/1993,11000000,1044824,-9955176,-68609.06960716748
The Rover,5/18/2014,12250000,2295423,-9954577,-41765.76194811679
Inhale,8/27/2010,10000000,55089,-9944911,-45527.17692353472
Byzantium,9/9/2012,10000000,89237,-9910763,-42828.2765862744
Midnight in the Garden of Good and Evil,11/21/1997,35000000,25105255,-9894745,-61343.73837569745
The Deep End of the Ocean,3/12/1999,38000000,28121100,-9878900,-59872.121212121216
The Corruptor,3/12/1999,25000000,15156200,-9843800,-59659.393939393936
Reindeer Games,2/25/2000,42000000,32168970,-9831030,-57424.24065420561
Grimsby,2/24/2016,35000000,25182929,-9817071,-41225.333008583475
The Art of War,8/23/2000,40000000,30199105,-9800895,-56424.26597582038
Bridget Jones: The Edge of Reason,11/10/2004,50000000,40203020,-9796980,-51293.089005235604
The In Crowd,7/19/2000,15000000,5217498,-9782502,-56611.70138888888
North Country,2/12/2005,35000000,25224242,-9775758,-50968.49843587069
Noises Off...,3/20/1992,12000000,2280148,-9719852,-69676.35842293907
How to Lose Friends & Alienate People,10/2/2008,27000000,17286299,-9713701,-44851.85595619029
World's Greatest Dad,8/20/2009,10000000,295750,-9704250,-44933.53212729605
In the Land of Blood and Honey,12/23/2011,10000000,303877,-9696123,-42777.32777446893
Æon Flux,11/30/2005,62000000,52304001,-9695999,-49268.28760162601
American Dreamz,3/4/2006,17000000,7314027,-9685973,-48478.34334334334
Code Name: The Cleaner,1/5/2007,20000000,10337477,-9662523,-47735.964548257056
The Way Back,9/3/2010,30000000,20348249,-9651751,-44185.108886233684
Roommates,3/1/1995,22000000,12400000,-9600000,-63408.19022457067
The Greatest Game Ever Played,9/30/2005,25000000,15431177,-9568823,-48036.26004016065
The Infiltrator,7/13/2016,25000000,15436808,-9563192,-39742.640091759895
Alone in the Dark,1/28/2005,20000000,10442808,-9557192,-49828.94681960375
Song to Song,3/17/2017,10000000,443684,-9556316,-39081.30081300813
Gemma Bovery,9/10/2014,9700000,154701,-9545299,-40101.0750700539
The Conspirator,9/10/2010,25000000,15478800,-9521200,-43587.454621198594
The Ward,9/13/2010,10000000,498974,-9501026,-43495.09931834517
Miss Sloane,11/25/2016,13000000,3500605,-9499395,-39346.04774843434
Legend,7/19/1985,25000000,15502112,-9497888,-87943.4074074074
Laurence Anyways,5/18/2012,9500000,12250,-9487750,-41344.92195330271
Jack Ryan: Shadow Recruit,1/15/2014,60000000,50549107,-9450893,-40402.9352417107
Swept Away,10/11/2002,10000000,598645,-9401355,-51855.23993381136
Bordello of Blood,8/16/1996,15000000,5600000,-9400000,-59569.07477820025
Losing Isaiah,3/17/1995,17000000,7603766,-9396234,-61858.025016458196
The Ledge,5/6/2011,10000000,610986,-9389014,-41550.92846648139
Trust,9/10/2010,9500000,120000,-9380000,-42941.04990409222
Meet Dave,7/8/2008,60000000,50650079,-9349921,-42506.596533978285
Parkland,10/2/2013,10000000,653651,-9346349,-40019.30668904627
Out on a Limb,9/4/1992,11000000,1659542,-9340458,-66103.73673036094
Deconstructing Harry,8/26/1997,20000000,10686841,-9313159,-57773.939205955336
Leviathan,3/17/1989,25000000,15704614,-9295386,-75510.85296506905
The Gun in Betty Lou's Handbag,8/21/1992,13000000,3721911,-9278089,-65662.34253361641
The Grand Seduction,5/30/2014,12700000,3430018,-9269982,-38893.45187397994
Mannequin Two: On the Move,1/7/1991,13000000,3752426,-9247574,-68704.11589895988
Out Cold,11/21/2001,24000000,14782676,-9217324,-52163.689869835885
The Lazarus Project,10/21/2008,9750000,558000,-9192000,-43271.74296810639
Gamer,9/3/2009,50000000,40828540,-9171460,-42466.55770041071
Highlander: Endgame,9/1/2000,25000000,15843608,-9156392,-52713.828439838806
Superhero Movie,3/27/2008,35000000,25871834,-9128166,-42491.56747648064
The Tale of Despereaux,12/19/2008,60000000,50877145,-9122855,-43206.99715358785
James and the Giant Peach,4/12/1996,38000000,28921264,-9078736,-58085.32309660908
Dune,12/14/1984,40000000,30925690,-9074310,-86175.78347578348
Transsiberian,1/18/2008,15000000,5926410,-9073590,-42862.02189019004
Simpatico,9/15/1999,10000000,929606,-9070394,-54022.596783799876
Billy Lynn's Long Halftime Walk,11/10/2016,40000000,30930984,-9069016,-37575.73346923386
Thank You,4/8/2011,13100000,4100000,-9000000,-40016.718095559925
Doctor Dolittle,12/19/1967,18000000,9000000,-9000000,-263929.61876832845
The Two Jakes,8/10/1990,19000000,10000000,-9000000,-68389.05775075988
Death at a Funeral,2/9/2007,9000000,46,-8999954,-44226.035508774
Highway to Hell,11/21/1991,9000000,26055,-8973945,-65075.74329224075
Phantom,1/3/2013,10000000,1034589,-8965411,-38932.65155462915
Dredd,9/7/2012,50000000,41037742,-8962258,-38729.41613693622
Over the Top,2/13/1987,25000000,16057580,-8942420,-80129.21146953406
50 to 1,3/21/2014,10000000,1064454,-8935546,-37691.2752244044
Vanishing on 7th Street,9/11/2010,10000000,1068682,-8931318,-40887.01193468199
Miller's Crossing,9/21/1990,14000000,5080409,-8919591,-66813.41573033707
Happily N'Ever After,9/14/2006,47000000,38085778,-8914222,-43934.06604238541
Gossip,4/21/2000,14000000,5108820,-8891180,-51843.61516034985
Inherent Vice,12/25/2014,20000000,11110975,-8889025,-38034.91123500794
Two Lovers,11/19/2008,12000000,3148182,-8851818,-42105.799417774986
Catch and Release,10/20/2006,25000000,16158487,-8841513,-43878.47642679901
The Molly Maguires,1/27/1970,11000000,2200000,-8800000,-231578.94736842104
The Legend of Hercules,1/10/2014,70000000,61279452,-8720548,-37280.681954205786
Connie and Carla,4/16/2004,20000000,11341016,-8658984,-45790.50237969329
The Perfect Game,4/1/2010,12500000,3878993,-8621007,-39544.271108073524
Jennifer Eight,11/6/1992,20000000,11390479,-8609521,-60630.42957746479
Post Grad,8/21/2009,15000000,6405245,-8594755,-39796.24390537531
Tenacious D in The Pick of Destiny,11/22/2006,22000000,13405595,-8594405,-42588.726461843406
"\"アップルシー�?\"\"In a utopian society created at the end of the third world war\"",4/17/2004,10000000,1461989,-8538011,-45150.77207826547
Gremlins 2: The New Batch,6/15/1990,50000000,41482207,-8517793,-65571.92455735181
The Red Violin,9/10/1998,18000000,9495408,-8504592,-51984.058679706606
Annapolis,1/27/2006,26000000,17496992,-8503008,-42793.195772521394
The Private Life of Sherlock Holmes,10/29/1970,10000000,1500000,-8500000,-214646.46464646465
Welcome to the Punch,3/15/2013,8500000,9747,-8490253,-36474.38921180721
The Little Vampire,10/27/2000,22000000,13555988,-8444012,-48500.93049971281
So I Married an Axe Murderer,7/30/1993,20000000,11585483,-8414517,-58111.30524861878
Lovelace,8/8/2013,10000000,1585582,-8414418,-35977.962775304964
Joe's Apartment,7/26/1996,13000000,4619014,-8380986,-53280.26700572155
Gun Shy,2/4/2000,10000000,1631839,-8368161,-49282.45583038869
Rent,11/23/2005,40000000,31670620,-8329380,-42324.08536585366
SpaceCamp,6/6/1986,18000000,9697739,-8302261,-75819.73515981736
Mighty Aphrodite,9/13/1995,15000000,6700000,-8300000,-54177.54569190601
How About You...,11/16/2007,9000000,706000,-8294000,-39488.468643470645
Damnation Alley,9/10/1977,17000000,8720000,-8280000,-134853.42019543974
Camilla,11/25/1994,8500000,250993,-8249007,-55103.5871743487
A Better Life,6/24/2011,10000000,1759252,-8240748,-36476.075813776435
The Monster Squad,8/14/1987,12000000,3769990,-8230010,-71940.64685314686
Princess Kaiulani,5/14/2010,9000000,771499,-8228501,-37714.62292256781
Romeo Is Bleeding,9/13/1993,11500000,3275585,-8224415,-56681.01309441764
Killer Elite,9/23/2011,66000000,57777106,-8222894,-36316.83456923165
The Tie That Binds,9/8/1995,14000000,5780000,-8220000,-53655.35248041776
Bad Santa 2,11/23/2016,26000000,17782178,-8217822,-34037.832598827
Mr. 3000,6/15/2004,30000000,21800302,-8199698,-43224.55455983132
Return to the Blue Lagoon,8/2/1991,11000000,2807854,-8192146,-59971.78623718888
Taras Bulba,4/2/2009,25000000,16815892,-8184108,-38379.79741136747
Waking the Dead,3/23/2000,8500000,327418,-8172582,-47709.176882661995
The Perez Family,5/12/1995,11000000,2832826,-8167174,-53660.80157687254
It's a Boy Girl Thing,12/26/2006,15500000,7385434,-8114566,-40088.56019287013
Pulse,8/11/2006,38000000,29907685,-8092315,-39687.66552231486
A Cry in the Dark,11/11/1988,15000000,6908797,-8091203,-67258.54530340814
Demolition,4/6/2016,10000000,1978592,-8021408,-33525.764750627975
Leaves of Grass,9/13/2009,9000000,985117,-8014883,-37111.26596872699
Playing God,10/17/1997,12000000,4000000,-8000000,-49535.60371517028
Punch-Drunk Love,10/25/2002,25000000,17000000,-8000000,-44125.75841147269
The Man Who Loved Women,12/18/1983,19000000,11000000,-8000000,-78508.34151128557
A Most Violent Year,12/30/2014,20000000,12007070,-7992930,-34200.64439661628
Mr. Right,2/29/2016,8000000,34694,-7965306,-33449.12065577075
La Princesse de Montpensier,11/3/2010,14734000,6775121,-7958879,-36374.633803010016
Zaytoun,10/14/2012,8000000,42330,-7957670,-34401.57878582205
Undiscovered,8/26/2005,9000000,1046166,-7953834,-40009.22535211268
Aloft,2/12/2014,8000000,53086,-7946914,-33848.19895988176
Hallam Foe,2/16/2007,8000000,60641,-7939359,-38662.19467061436
Under the Skin,3/14/2014,13300000,5380251,-7919749,-33516.64670557316
A Street Cat Named Bob,11/4/2016,8000000,82703,-7917297,-32803.80604343016
Oliver Twist,9/23/2005,50000000,42093706,-7906294,-39690.230923694784
Wuthering Heights,9/5/2011,8000000,100915,-7899085,-34814.75523273495
Flash Gordon,9/1/1980,35000000,27107960,-7892040,-93952.85714285714
The Jacket,3/4/2005,29000000,21126225,-7873775,-40733.44542162441
10th & Wolf,2/19/2006,8000000,143451,-7856549,-39322.067067067066
Heartbeeps,12/18/1981,10000000,2154696,-7845304,-83195.164369035
Restless,9/16/2011,8000000,163265,-7836735,-34611.34347079114
Fear and Loathing in Las Vegas,5/22/1998,18500000,10680275,-7819725,-47973.77300613497
Fled,7/19/1996,25000000,17193231,-7806769,-49629.80928162746
Foolproof,10/3/2003,8256269,460978,-7795291,-42136.708108108105
Doomsday,3/14/2008,30000000,22211426,-7788574,-36475.65658836312
"\"नीरज�?\"\"Neerja is a portrayal on the life of the courageous Neerja Bhanot\"",2/19/2016,10721568,2978994,-7742574,-32513.79067072044
The Zero Theorem,1/2/2014,8500000,770706,-7729294,-33043.03254159613
Escape from L.A.,8/9/1996,50000000,42277365,-7722635,-49094.94596312778
Muppets from Space,7/14/1999,24000000,16290976,-7709024,-46244.895020995806
Ma vie de courgette,10/12/2016,8000000,292279,-7707721,-31885.79359530714
Dragonfly,2/22/2002,60000000,52322400,-7677600,-42939.59731543624
Mandela: Long Walk to Freedom,12/6/2013,35000000,27330000,-7670000,-32911.53362597565
She Hate Me,7/30/2004,8000000,365134,-7634866,-40289.530343007915
Red Tails,1/19/2012,58000000,50365377,-7634623,-33534.75531816764
Undisputed,8/23/2002,20000000,12398628,-7601372,-41996.530386740335
Slackers,2/1/2002,14000000,6413915,-7586085,-42666.39482564679
Fido,9/7/2006,8000000,426224,-7573776,-37327.6293740759
Brooklyn Rules,4/30/2007,8000000,458232,-7541768,-36267.39248565754
The Weather Man,10/20/2005,20000000,12482775,-7517225,-38042.636639676115
Rumble Fish,10/20/1983,10000000,2494480,-7505520,-74165.21739130435
Unfriend,1/7/2016,9900000,2400000,-7500000,-31656.789748265208
Running Scared,1/6/2006,17000000,9500000,-7500000,-37821.482602118
Getaway,8/29/2013,18000000,10501938,-7498062,-32022.609534954237
Elle,5/25/2016,9804690,2341534,-7463156,-30965.139533146903
"\"アキ�?\"\"Childhood friends Tetsuo and Kaneda are pulled into the post-apocalyptic underworld of Neo-Tokyo and forced to fight for their very survival. Kaneda is a bike gang leader\"",7/16/1988,8000000,553171,-7446829,-62578.39495798319
Prefontaine,1/24/1997,8000000,589304,-7410696,-46432.93233082707
Behind the Candelabra,5/26/2013,23000000,15600000,-7400000,-31691.10593394546
The Apparition,8/23/2012,17000000,9627492,-7372508,-31859.48566810857
Bandits,10/12/2001,75000000,67631903,-7368097,-41463.68598761959
Triple 9,2/19/2016,20000000,12639297,-7360703,-30910.18006819747
Empire State,9/3/2013,11000000,3639345,-7360655,-31435.77380215162
Man-Thing,4/21/2005,7500000,143000,-7357000,-37844.65020576132
Levity,3/16/2003,7500000,209151,-7290849,-39667.295973884655
The Mission,9/29/1986,24500000,17218023,-7281977,-66019.73708068902
Deception,4/24/2008,25000000,17741298,-7258702,-33507.0626684885
Showtime,3/14/2002,85000000,77741732,-7258268,-40594.34004474273
La piel que habito,8/17/2011,13000000,5774854,-7225146,-31844.408499310233
The Boost,12/23/1988,8000000,784990,-7215010,-59578.94302229563
Basic,4/18/2003,50000000,42792561,-7207439,-39277.59673024523
Down in the Valley,5/13/2005,8000000,852872,-7147128,-36765.06172839506
Bee Season,9/3/2005,14000000,6856989,-7143011,-35930.63883299799
Invaders from Mars,1/1/1986,12000000,4884663,-7115337,-64920.958029197085
Battle in Seattle,9/7/2007,8000000,908847,-7091153,-34011.957408029164
From Justin to Kelly,6/20/2003,12000000,4922166,-7077834,-38487.40619902121
Funny Games,10/20/2007,15000000,7938872,-7061128,-33596.102332795694
Girl 6,3/22/1996,12000000,4939939,-7060061,-45169.93602047345
Truth,9/12/2015,9600000,2541554,-7058446,-29664.191304713277
Felix The Cat: The Movie,10/1/1988,9000000,1964253,-7035747,-58533.66888519135
The Runaways,3/19/2010,10000000,2995811,-7004189,-32127.980954914707
55 Days at Peking,5/6/1963,17000000,10000000,-7000000,-229508.19672131148
Sweetwater,1/24/2013,7000000,6147,-6993853,-30124.363601905534
The Unbearable Lightness of Being,2/5/1988,17000000,10006806,-6993194,-60286.15517241379
The Water Diviner,12/25/2014,22500000,15520023,-6979977,-29866.35830334564
Ca$h,1/1/2010,7000000,46488,-6953512,-32090.120773281276
The Producers,12/25/2005,45000000,38058335,-6941665,-35005.874936964196
Vanity Fair,9/1/2004,23000000,16123851,-6876149,-36209.31542917325
The Thing,10/12/2011,35000000,28128670,-6871330,-30347.582600553837
Cameron's Closet,12/2/1988,7000000,136203,-6863797,-56960.970954356846
Promised Land,9/23/2012,15000000,8138788,-6861212,-29661.51212405487
The Neverending Story,4/5/1984,27000000,20158808,-6841192,-66354.9175557711
The Zookeeper's Wife,3/31/2017,20000000,13162475,-6837525,-27962.5926289444
Hearts in Atlantis,9/7/2001,31000000,24185781,-6814219,-38217.717330342115
The Indian Runner,5/19/1991,7000000,191125,-6808875,-50065.257352941175
The Limey,5/15/1999,10000000,3193102,-6806898,-40956.064981949465
Brideshead Revisited,7/25/2008,20000000,13204291,-6795709,-31018.453940461735
Trumbo,10/27/2015,15000000,8235661,-6764339,-28501.108133616475
Дуэлянт,9/29/2016,12823507,6101904,-6721603,-27806.35753260883
Someone to Watch Over Me,10/9/1987,17000000,10278549,-6721451,-58295.32523850824
Whisper,11/27/2007,12000000,5285197,-6714803,-31969.77184863547
Life,4/16/1999,80000000,73345029,-6654971,-40041.943441636584
Coriolanus,2/14/2011,7700000,1072602,-6627398,-29946.35554812502
Collateral Damage,2/6/2002,85000000,78382433,-6617567,-37219.16197975253
Hesher,1/22/2010,7000000,382946,-6617054,-30529.775169441866
One Night with the King,10/13/2006,20000000,13391174,-6608826,-32749.385530227948
Kalifornia,9/1/1993,9000000,2395231,-6604769,-45518.73880082702
Last Holiday,1/13/2006,45000000,38399961,-6600039,-33283.10136157337
Out of the Furnace,12/6/2013,22000000,15400000,-6600000,-28320.224502143326
Everybody Wants Some!!,3/30/2016,10000000,3400278,-6599722,-27583.77671246045
Original Sin,8/3/2001,42000000,35402320,-6597680,-37170.028169014084
Jude,2/6/1996,7000000,405000,-6595000,-42575.855390574565
99 Homes,10/9/2014,8000000,1411927,-6588073,-27747.08233480603
Disconnect,9/11/2012,10000000,3428048,-6571952,-28399.970614544935
Rhinestone,6/22/1984,28000000,21435321,-6564679,-63061.27761767532
Before I Go to Sleep,9/3/2014,22000000,15447154,-6552846,-27529.380626893137
The Extra Man,8/1/2010,7000000,453079,-6546921,-29988.827916010112
Chloe,3/25/2009,15000000,8459458,-6540542,-30672.209716751076
Les triplettes de Belleville,6/11/2003,8000000,1477676,-6522324,-35505.302123026675
Curse of the Pink Panther,8/12/1983,11000000,4491986,-6508014,-64950.23952095808
The River,12/1/1984,18000000,11500000,-6500000,-61728.3950617284
Barbarella,10/10/1968,9000000,2500000,-6500000,-184135.9773371105
For Your Consideration,11/22/2006,12000000,5542025,-6457975,-32001.858275520317
Bottle Rocket,2/21/1996,7000000,560069,-6439931,-41361.14964675659
Quills,11/22/2000,13500000,7060876,-6439124,-37006.45977011494
Free Fire,3/31/2017,10000000,3565109,-6434891,-26315.98943253014
Freeheld,10/2/2015,7000000,573335,-6426665,-27021.186690099985
Once Upon a Forest,6/18/1993,13000000,6582052,-6417948,-44445.62326869806
Streets of Fire,6/1/1984,14500000,8089290,-6410710,-61819.76856316297
Never Talk to Strangers,10/20/1995,6400000,6,-6399994,-41666.62760416667
The Glass House,9/14/2001,30000000,23619609,-6380391,-35784.582164890635
Manhunter,8/14/1986,15000000,8620929,-6379071,-58150.14585232452
Wolfen,7/24/1981,17000000,10626725,-6373275,-69049.56663055255
2 Days in New York,3/28/2012,8000000,1653792,-6346208,-27582.01534215616
Rock-A-Doodle,8/2/1991,18000000,11657385,-6342615,-46432.02781844803
Killer Joe,9/10/2011,10000000,3665069,-6334931,-27920.837942782593
Nadine,8/7/1987,12000000,5669831,-6330169,-55333.645104895106
Bicentennial Man,12/17/1999,100000000,93700000,-6300000,-37322.27488151658
A Quiet Passion,10/7/2016,8138338,1864266,-6274072,-25954.98264585548
By the Sea,11/12/2015,10000000,3727746,-6272254,-26427.73957595982
Chalet Girl,2/2/2011,8000000,1749457,-6250543,-28243.51020518822
The Rocker,8/20/2008,15000000,8762890,-6237110,-28508.2021912123
Banlieue 13 - Ultimatum,2/18/2009,15000000,8786375,-6213625,-29211.857514256568
Little Monsters,8/25/1989,7000000,793775,-6206225,-49649.8
The Man Who Knew Too Little,11/14/1997,20000000,13801755,-6198245,-38379.22600619195
In the Heart of the Sea,11/20/2015,100000000,93820758,-6179242,-26125.11151041116
My Stepmother is an Alien,12/9/1988,20000000,13854000,-6146000,-51004.14937759336
Black Rose,4/17/2014,7000000,855450,-6144550,-25828.289197141654
Gimme Shelter,10/17/2013,7500000,1359910,-6140090,-26344.51600169907
Permanent Record,4/22/1988,8000000,1893139,-6106861,-51973.28510638298
ബാംഗ്ലൂർ ഡെയ്സ്,5/30/2014,7400000,1300000,-6100000,-25593.367541736072
Earth Girls Are Easy,9/8/1988,10000000,3916303,-6083697,-50782.111853088485
Perfect,6/7/1985,19000000,12918858,-6081142,-56516.18959107807
Home on the Range,4/2/2004,110000000,103951461,-6048539,-32173.07978723404
Gracie,6/1/2007,9000000,2955039,-6044961,-29013.21321609584
Children of Men,9/22/2006,76000000,69959751,-6040249,-29931.858275520317
Limbo,6/4/1999,8000000,1997807,-6002193,-36114.277978339356
Red Rock West,7/8/1993,8000000,2000000,-6000000,-41551.24653739612
Blow Out,7/24/1981,18000000,12000000,-6000000,-65005.41711809317
Zabriskie Point,2/9/1970,7000000,1000000,-6000000,-157894.73684210525
The Good Doctor,1/1/2011,6000000,5206,-5994794,-27221.470963523338
Barefoot,2/2/2014,6000000,15071,-5984929,-25491.53892350744
Maurice Richard,10/25/2005,8000000,2019009,-5980991,-30268.173076923078
The Boondock Saints,1/22/1999,6000000,30471,-5969529,-36288.93009118541
Maniac,12/26/2012,6000000,31081,-5968919,-25920.26663192635
Song One,1/20/2014,6000000,32251,-5967749,-25418.364348052015
Mutant Chronicles,8/7/2008,8000000,2033165,-5966835,-27235.126845165825
Virtuosity,8/4/1995,30000000,24048000,-5952000,-38927.403531720076
Ben-Hur,8/17/2016,100000000,94061311,-5938689,-24598.17833888364
The Hand,4/24/1981,6500000,566736,-5933264,-66071.98218262807
The Visual Bible: The Gospel of John,9/11/2003,10000000,4069090,-5930910,-32024.352051835856
Denial,9/30/2016,10000000,4073489,-5926511,-24517.17005406881
Johnny Mnemonic,5/26/1995,25000000,19075720,-5924280,-38847.737704918036
Bad Moon,11/1/1996,7000000,1100000,-5900000,-37200.50441361917
Suite Française,11/5/2014,15000000,9104716,-5895284,-24964.044192063553
Shadow Dancer,2/12/2012,6300000,419953,-5880047,-25827.855207038472
Mindhunters,5/7/2004,27000000,21148829,-5851171,-30942.20518244315
Twin Peaks: Fire Walk with Me,6/3/1992,10000000,4160851,-5839149,-41648.708987161204
Judy Moody and the Not Bummer Summer,6/10/2011,20000000,14166853,-5833147,-25842.173115602378
The Book of Henry,6/16/2017,10000000,4219536,-5780464,-23614.357030222316
Victor Frankenstein,11/10/2015,40000000,34227298,-5772702,-24322.909293154007
Conviction,9/11/2010,12500000,6732980,-5767020,-26401.054756705533
Dark Blue,12/14/2002,15000000,9237470,-5762530,-31854.78164731896
Losin' It,4/8/1983,7000000,1246141,-5753859,-58355.56795131846
The Time That Remains,8/12/2009,6500000,753808,-5746192,-26623.201163857408
Showdown in Little Tokyo,8/23/1991,8000000,2275557,-5724443,-41723.34548104957
JCVD,6/4/2008,6000000,276891,-5723109,-26155.012224938877
Mickey,5/2/2004,6000000,293793,-5706207,-30175.60549973559
Atrapa la bandera,8/28/2015,14000000,8306690,-5693310,-23926.999936960223
Трудно быть богом,2/27/2013,7000000,1310673,-5689327,-24441.524575444746
The Neon Demon,6/8/2016,7000000,1333124,-5666876,-23512.25219693135
Burke & Hare,10/29/2010,10000000,4349187,-5650813,-25826.03072169943
Valhalla Rising,9/4/2009,5641880,30638,-5611242,-25981.701077469454
While She Was Out,10/27/2008,6000000,391410,-5608590,-26402.683299988228
The Wild Bunch,6/17/1969,6244087,638641,-5605446,-152321.90217391305
Bastille Day,4/22/2016,20000000,14397593,-5602407,-23321.110273946942
The Pledge,1/9/2001,35000000,29400000,-5600000,-31981.724728726444
I Hope They Serve Beer in Hell,9/25/2009,7000000,1429299,-5570701,-25769.166007484608
Into the Blue,9/30/2005,50000000,44434439,-5565561,-27939.56325301205
Table For Five,2/18/1983,8000000,2439705,-5560295,-56795.65883554647
Never Let Me Go,9/15/2010,15000000,9455232,-5544768,-25383.599082581408
Walker,12/4/1987,5800000,257043,-5542957,-48032.55632582322
The Right Stuff,10/20/1983,27000000,21500000,-5500000,-54347.82608695652
The Negotiator,7/29/1998,50000000,44547681,-5452319,-33367.925336597305
Flipper,5/17/1996,25530000,20080020,-5449980,-34779.70644543714
Mutiny on the Bounty,11/8/1962,19000000,13680000,-5320000,-175000.0
Human Nature,5/18/2001,6000000,705308,-5294692,-29745.460674157304
Year of the Dragon,8/16/1985,24000000,18707466,-5292534,-48869.196675900275
King Kong Lives,11/21/1986,10000000,4711220,-5288780,-47862.262443438914
Infinitely Polar Bear,1/18/2014,6700000,1430655,-5269345,-22443.66026211661
Running with Scissors,10/27/2006,12000000,6754898,-5245102,-26030.282878411912
The Lost City,9/3/2005,9600000,4386236,-5213764,-26226.177062374245
Centurion,2/15/2010,12000000,6814789,-5185211,-23923.53546398697
Serial Mom,4/13/1994,13000000,7820688,-5179312,-35137.801899592945
The Work and the Glory III: A House Divided,11/22/2006,6500000,1325092,-5174908,-25643.74628344896
My Soul to Take,10/8/2010,25000000,19829957,-5170043,-23638.696727645154
Blindness,5/14/2008,25000000,19844979,-5155021,-23796.212009306102
Beastmaster 2: Through the Portal of Time,6/8/1991,6000000,869325,-5130675,-37725.55147058824
Запрещeнная реальность,10/8/2009,7000000,1877122,-5122878,-23697.60890381493
The Four Feathers,9/8/2002,35000000,29882645,-5117355,-28272.67955801105
Green Zone,3/11/2010,100000000,94882889,-5117111,-23512.785402814858
Edge of Darkness,1/29/2010,80000000,74901339,-5098661,-23524.210924559728
Whatever It Takes,3/31/2000,15000000,9902115,-5097885,-29759.98248686515
A Perfect Man,11/1/2013,5000000,388,-4999612,-21451.209727591402
Philadelphia Experiment II,11/12/1993,5000000,2970,-4997030,-34273.182441700956
Analyze That,12/6/2002,60000000,55003135,-4996865,-27622.249861802098
13 Sins,4/18/2014,5000000,13809,-4986191,-20959.188734762505
5 Flights Up,9/5/2014,6000000,1020921,-4979079,-20917.775415807184
The Messenger,11/13/2009,6500000,1521261,-4978739,-23014.556464660473
Hood of Horror,6/27/2006,5000000,25900,-4974100,-24442.751842751844
La Tête haute,5/13/2015,5000000,26144,-4973856,-20915.69142785055
Woo,5/8/1998,13000000,8026971,-4973029,-30546.861179361178
Road to Nowhere,4/13/2011,5000000,27046,-4972954,-22111.25536890968
Meet Monica Velour,6/4/2010,5000000,31649,-4968351,-22794.260546418
Elizabethtown,10/6/2005,57000000,52034889,-4965111,-24925.256024096387
Dead Ringers,9/23/1988,13000000,8038508,-4961492,-41276.971713810315
CBGB,10/11/2013,5000000,40400,-4959600,-21236.073407380132
Viva la libertà,2/13/2013,5000000,48125,-4951875,-21329.027506180923
A Home at the End of the World,7/23/2004,6500000,1548955,-4951045,-26126.88654353562
Auto Focus,10/18/2002,7000000,2062066,-4937934,-27236.260341974626
What Maisie Knew,5/2/2013,6000000,1066471,-4933529,-21178.9435274421
The Secret of Moonacre,9/6/2008,12000000,7070330,-4929670,-22532.23513709932
Better Living Through Chemistry,3/14/2014,5000000,75143,-4924857,-20842.16206150838
Mio min Mio,7/1/1987,7200000,2300000,-4900000,-43057.996485061514
The Big Picture,9/15/1989,5000000,117463,-4882537,-39060.296
Gaby: A True Story,10/30/1987,5000000,125400,-4874600,-42240.90121317157
The House of Mirth,9/23/2000,10000000,5164404,-4835596,-27790.7816091954
Cool as Ice,10/18/1991,6000000,1193062,-4806938,-34883.43976777939
Heist,11/13/2015,8900000,4100000,-4800000,-20224.491859642025
Brainstorm,9/30/1983,15000000,10219460,-4780540,-47332.07920792079
Black and White,9/4/1999,10000000,5241315,-4758685,-28342.37641453246
Off Limits,3/11/1988,12000000,7242035,-4757965,-40840.90128755365
Clouds of Sils Maria,8/20/2014,6600000,1851517,-4748483,-19949.010843125474
Pinocchio and the Emperor of the Night,8/6/1987,8000000,3261638,-4738362,-41419.24825174825
Donnie Darko,1/18/2001,6000000,1270522,-4729478,-26902.605233219565
A Bronx Tale,9/14/1993,22000000,17287898,-4712102,-32474.858718125433
Wet Hot American Summer,7/27/2001,5000000,295206,-4704794,-26505.881690140846
Into the Night,2/15/1985,11400000,6700000,-4700000,-44339.622641509435
Julia,2/9/2008,6000000,1300000,-4700000,-22201.962275559417
Razorback,4/19/1984,5500000,801000,-4699000,-45444.8742746615
해운대,6/6/2009,16000000,11301649,-4698351,-21782.58450668311
Personal Shopper,10/19/2016,6000000,1305195,-4694805,-19452.02669948167
The Year of Living Dangerously,12/17/1982,6000000,1317657,-4682343,-47876.71779141104
Masters of the Universe,8/7/1987,22000000,17336370,-4663630,-40765.9965034965
No Escape,4/29/1994,20000000,15340000,-4660000,-31593.22033898305
Антикиллер,8/1/2002,5000000,340312,-4659688,-25786.87327061428
Meet Bill,9/7/2007,5000000,346592,-4653408,-22319.57408029162
PCU,4/29/1994,9000000,4350774,-4649226,-31520.17627118644
Seeking Justice,9/2/2011,17000000,12355798,-4644202,-20469.048741895815
Cake,9/7/2014,7000000,2360281,-4639719,-19492.078762850215
Queen of Katwe,9/23/2016,15000000,10367161,-4632839,-19165.42491798667
Mr. Destiny,10/12/1990,20000000,15379253,-4620747,-34612.33707865168
The Awakening,8/17/2011,4798235,209696,-4588539,-20223.7173243304
Les Invasions barbares,5/21/2003,8000000,3432342,-4567658,-24864.768644529126
A Prayer for the Dying,9/11/1987,6000000,1432687,-4567313,-39715.7652173913
Home Fries,11/25/1998,15000000,10443316,-4556684,-27801.610738255033
3 Generations,2/11/2016,5000000,443962,-4556038,-19214.789697652155
Wild Target,6/17/2010,8000000,3453043,-4546957,-20856.548522780962
Tamara,5/12/2005,4750000,206871,-4543129,-23370.005144032923
Dark Water,6/27/2005,30000000,25473093,-4526907,-23167.38485158649
The Greatest Story Ever Told,2/15/1965,20000000,15473333,-4526667,-145085.48076923078
Wise Guys,4/17/1986,13000000,8475466,-4524534,-41547.603305785124
Mimic,8/22/1997,30000000,25480490,-4519510,-28036.662531017373
Meet the Applegates,2/1/1991,5000000,485772,-4514228,-33488.33827893175
At Long Last Love,3/1/1975,6000000,1500000,-4500000,-85388.99430740037
Mishima: A Life in Four Chapters,5/15/1985,5000000,502758,-4497242,-41912.78657968313
The Work and the Glory II: American Zion,10/21/2005,6500000,2025032,-4474968,-22646.599190283403
Two for the Money,10/7/2005,35000000,30526509,-4473491,-22457.284136546186
キャシャーン,4/24/2004,6000000,1530216,-4469784,-23637.144368059227
Ernest et Célestine,12/12/2012,12516654,8109160,-4407494,-19196.318831363977
Anthropoid,8/12/2016,9000000,4600000,-4400000,-18268.70777956313
The Dark Half,4/23/1993,15000000,10611160,-4388840,-30435.78363384189
The Romantics,9/10/2010,4500000,123820,-4376180,-20033.876734465917
The Purple Rose of Cairo,3/1/1985,15000000,10631333,-4368667,-41058.90037593985
The Road,11/25/2009,32000000,27635305,-4364695,-20211.69350170642
Anywhere But Here,11/12/1999,23000000,18653615,-4346385,-25825.222816399284
Everything is Illuminated,9/16/2005,7000000,2697930,-4302070,-21596.736947791167
Joyeux Noël,11/9/2005,22000000,17709155,-4290845,-21714.802631578947
Mao's Last Dancer,10/1/2009,25000000,20719451,-4280549,-19801.130555054424
Party Monster,9/5/2003,5000000,742898,-4257102,-22986.511879049678
La Folle histoire de Max et Léon,11/1/2016,12156348,7900000,-4256348,-17635.36396895833
Igby Goes Down,9/13/2002,9000000,4777465,-4222535,-23328.922651933703
Redacted,1/1/2007,5000000,782102,-4217898,-20837.76974152241
EuroTrip,2/20/2004,25000000,20796847,-4203153,-22428.7780149413
Bulletproof,4/20/1988,5000000,807947,-4192053,-35677.04680851064
Atlas Shrugged Part III: Who is John Galt?,9/12/2014,5000000,846704,-4153296,-17448.55081901097
At Close Range,4/18/1986,6500000,2347000,-4153000,-38135.90449954086
The Work and the Glory,11/24/2004,7500000,3347647,-4152353,-21820.036784025222
Tough Guys Don't Dance,9/18/1987,5000000,858250,-4141750,-35921.50910667823
The Alamo,10/23/1960,12000000,7900000,-4100000,-137583.89261744966
The East,5/31/2013,6500000,2401510,-4098490,-17552.119021515693
Black Snake Moan,12/8/2006,15000000,10903846,-4096154,-20298.08721506442
The Rundown,9/26/2003,85000000,80916492,-4083508,-22073.016216216216
Bright Star,11/5/2009,8500000,4440055,-4059945,-18767.369296907502
Teaching Mrs. Tingle,8/11/1999,13000000,8946237,-4053763,-24259.50329144225
La grande bellezza,5/21/2013,12400000,8371085,-4028915,-17254.15838700836
Bad Company,6/7/2002,70000000,65977295,-4022705,-22360.783768760422
Doom,10/20/2005,60000000,55987321,-4012679,-20307.07995951417
Ladrón que roba a ladrón,8/31/2007,4002313,6,-4002307,-19196.63772842822
Animal Kingdom,6/3/2010,5000000,1000000,-4000000,-18351.57020622577
The Sacrament,9/2/2013,4000000,9221,-3990779,-17043.758461492467
Novocaine,11/23/2001,6000000,2025238,-3974762,-22494.40860215054
Hanging Up,2/16/2000,40000000,36037909,-3962091,-23143.054906542056
December Boys,9/20/2007,4000000,46474,-3953526,-18922.186698319103
Dirty Girl,9/12/2010,4000000,55125,-3944875,-18059.38957786842
17 filles,6/13/2011,4141459,201607,-3939852,-17454.4439620418
The Loft,10/14/2014,14000000,10076790,-3923210,-16523.440296841636
Premium Rush,8/24/2012,35000000,31083599,-3916401,-16924.29788208654
Young Adam,9/26/2003,6400000,2500000,-3900000,-21081.08108108108
MacGruber,5/21/2010,10000000,6110000,-3890000,-17846.902025554562
Dragonslayer,6/26/1981,18000000,14110013,-3889987,-42467.10698689957
Mallrats,10/20/1995,6000000,2122561,-3877439,-25243.743489583336
Manglehorn,6/3/2015,4000000,143101,-3856899,-16162.132602519298
Los lunes al sol,9/27/2002,4000000,146402,-3853598,-21255.366795366794
Bride Flight,10/15/2008,6400000,2556911,-3843089,-17745.00514837953
Band of the Hand,4/11/1986,8700000,4865912,-3834088,-35304.677716390426
Videodrome,2/4/1983,5952000,2120439,-3831561,-39137.49744637385
Casualties of War,8/18/1989,22500000,18671317,-3828683,-30629.464
Maggie,5/8/2015,4000000,187112,-3812888,-16033.674649397615
Repentance,2/28/2014,5000000,1189612,-3810388,-16125.691408547862
Белый тигр,5/3/2012,11000000,7200000,-3800000,-16535.03905315145
Major Dundee,4/7/1965,3800000,14873,-3785127,-120545.44585987262
Balada triste de trompeta,12/17/2010,7000000,3218666,-3781334,-17170.47719811282
RRRrrrr!!!,1/28/2004,17820000,14054361,-3765639,-20223.62513426423
Life During Wartime,10/10/2009,4500000,744816,-3755184,-17370.876642751078
The Music Never Stopped,3/18/2011,4000000,253899,-3746101,-16656.296408277234
The Master,9/7/2012,32000000,28258060,-3741940,-16170.383782685916
Closet Land,3/6/1991,4000000,259012,-3740988,-27711.022222222222
Max Steel,10/14/2016,10000000,6272403,-3727597,-15420.561868869683
Frankenweenie,10/4/2012,39000000,35287788,-3712212,-16048.159019873161
The Black Cauldron,7/24/1985,25000000,21288692,-3711308,-34363.96296296296
Prêt-à-Porter,12/23/1994,15000000,11300653,-3699347,-24613.0871590153
Der Räuber,2/14/2010,3900000,208475,-3691525,-17031.964418361084
Saint John of Las Vegas,6/10/2009,3800000,111731,-3688269,-17099.623075389558
Nobel Son,4/28/2007,4000000,333912,-3666088,-17629.745754968764
The Face of Love,10/25/2013,4000000,350006,-3649994,-15660.572620125371
Another Happy Day,11/18/2011,4000000,355688,-3644312,-16148.711404161793
15 Minutes,3/1/2001,60000000,56359980,-3640020,-20658.45629965948
Ella Enchanted,4/9/2004,31000000,27388767,-3611233,-19208.686170212764
Search and Destroy,1/1/1995,4000000,389503,-3610497,-24021.93612774451
Антидурь,9/6/2007,5000000,1413000,-3587000,-17204.66209410523
The Doors,3/1/1991,38000000,34416893,-3583107,-26541.533333333333
Paradies: Liebe,4/27/2012,3600000,24267,-3575733,-15559.18021016905
Head Over Heels,2/2/2001,14000000,10424470,-3575530,-20338.62343572241
People Like Us,6/29/2012,16000000,12434778,-3565222,-15561.587750541237
Gods and Monsters,1/21/1998,10000000,6451628,-3548372,-21917.059913526868
Club Dread,2/27/2004,8500000,5001655,-3498345,-18667.796157950906
Oorlogswinter,11/17/2008,4000000,530048,-3469952,-16505.660520958198
Defendor,9/12/2009,3500000,44462,-3455538,-16000.157430001529
Battle of the Year,9/21/2013,20000000,16549477,-3450523,-14774.489822133542
La terza madre,9/6/2007,3500000,54947,-3445053,-16523.8284809823
4.3.2.1,6/2/2010,4600000,1163967,-3436033,-15764.150207602137
He Got Game,5/1/1998,25000000,21567853,-3432147,-21081.98402948403
Swing Vote,8/1/2008,21000000,17600000,-3400000,-15519.019928247353
The Signal,3/15/2014,4000000,600896,-3399104,-14385.123554231399
Camille Claudel 1915,3/13/2013,3512454,115860,-3396594,-14591.872768748954
Camille Claudel 1915,3/13/2013,3512454,115860,-3396594,-14591.872768748954
Paparazzi,9/3/2004,20000000,16605763,-3394237,-17873.81253291206
For Richer or Poorer,12/11/1997,35000000,31611225,-3388775,-21009.14445133292
Winter Passing,2/7/2006,3500000,113783,-3386217,-17041.85707096125
The Cat's Meow,8/3/2001,7000000,3646994,-3353006,-18890.174647887325
Apartment Zero,9/30/1988,4000000,670774,-3329226,-27697.38768718802
Кавказская пленница!,8/21/2014,3500000,179000,-3321000,-13951.964239951938
Death Wish 5: The Face of Death,1/14/1994,5000000,1702394,-3297606,-22555.44459644323
The Big Kahuna,4/28/2000,7000000,3728888,-3271112,-19073.539358600585
Opposite Sex,11/8/2014,3300000,45000,-3255000,-13783.553743155862
Men with Brooms,9/20/2002,7500000,4245870,-3254130,-17948.869277440706
1941,12/13/1979,35000000,31755742,-3244258,-42298.01825293351
Le dernier souffle,3/25/1999,3800000,559298,-3240702,-19498.80866425993
From Beyond,6/5/1986,4500000,1261000,-3239000,-29579.908675799088
The Rage: Carrie 2,3/11/1999,21000000,17762705,-3237295,-19619.969696969696
Local Color,9/19/2006,3250000,32788,-3217212,-15942.576808721506
Faithful,4/3/1996,13000000,9789900,-3210100,-20538.067818298143
The Invisible,4/27/2007,30000000,26810113,-3189887,-15339.756382574573
Mindscape,10/13/2013,4357373,1200000,-3157373,-13519.27671636423
What If,9/7/2013,11000000,7847000,-3153000,-13465.784607237272
An Awfully Big Adventure,7/21/1995,4000000,851545,-3148455,-20591.595814257686
Bitter Moon,9/2/1992,5000000,1862805,-3137195,-22202.370842179756
The Cold Light of Day,4/4/2012,20000000,16863583,-3136417,-13631.557902514287
Mirrormask,1/25/2005,4000000,866999,-3133001,-16334.728884254431
The Amateur,12/11/1981,10000000,6892098,-3107902,-33062.78723404255
One for the Money,1/26/2012,40000000,36893721,-3106279,-13644.19778356606
The Wackness,7/3/2008,6000000,2899975,-3100025,-14093.328908366824
Go Go Tales,5/23/2007,4000000,907456,-3092544,-14842.881277837505
Elles,9/9/2011,4000000,911466,-3088534,-13612.533000718413
Shattered Glass,11/14/2003,6000000,2944752,-3055248,-16559.60975609756
Death Sentence,8/31/2007,20000000,16974459,-3025541,-14511.684013621756
Zero Effect,1/30/1998,5000000,1980338,-3019662,-18651.402100061765
The Return,11/10/2006,15000000,11992014,-3007986,-14927.970223325063
Knockaround Guys,9/7/2001,15000000,12000000,-3000000,-16825.574873808186
Tristan & Isolde,4/7/2006,31000000,28000000,-3000000,-14888.33746898263
ATM,2/17/2012,3000000,3010,-2996990,-13064.928157913093
Naqoyqatsi,9/2/2002,3000000,13308,-2986692,-16501.06077348066
Women in Trouble,11/13/2009,3000000,18097,-2981903,-13784.047519992602
The Divide,3/13/2011,3000000,22000,-2978000,-13326.352436825124
The Joneses,9/13/2009,10000000,7022728,-2977272,-13785.645162037144
This Is Elvis,4/4/1981,5000000,2028612,-2971388,-33348.91133557801
The Three Burials of Melquiades Estrada,11/17/2005,15000000,12036149,-2963851,-15060.218495934958
Racing with the Moon,3/23/1984,9000000,6045657,-2954343,-28655.121241513094
The Wiz,10/24/1978,24000000,21049053,-2950947,-43782.59643916914
It Came from Hollywood,12/10/1982,5000000,2091037,-2908963,-29804.948770491806
Freakonomics,10/1/2010,3000000,103735,-2896265,-13242.429507432182
Red State,8/19/2011,4000000,1104682,-2895318,-12760.944779165142
All Is Lost,10/18/2013,9000000,6108720,-2891280,-12405.253379900374
The Dilemma,1/13/2011,70000000,67112664,-2887336,-13110.964794776204
The Bronze,1/22/2016,3500000,615816,-2884184,-12163.85574688648
Sydney White,9/21/2007,16500000,13620075,-2879925,-13783.766320787227
Paterson,11/17/2016,5000000,2152738,-2847262,-11793.225421650817
Citizen Ruth,12/13/1996,3000000,153155,-2846845,-17949.842370744012
Barton Fink,8/1/1991,9000000,6153939,-2846061,-20835.0
Морфий,11/27/2008,3600000,766075,-2833925,-13480.24525752992
No One Lives,3/9/2013,2900000,74918,-2825082,-12136.639558711706
Rescue Dawn,9/9/2006,10000000,7177143,-2822857,-13912.552981764416
Don Juan DeMarco,10/1/1994,25000000,22200000,-2800000,-18729.096989966554
Hideaway,3/3/1995,15000000,12201255,-2798745,-18485.766182298546
Dead & Buried,5/29/1981,3000000,216166,-2783834,-30726.644591611483
The Hollars,8/25/2016,3800000,1016985,-2783015,-11527.308348658813
Gåten Ragnarok,11/11/2013,6500000,3721345,-2778655,-11922.027382448974
Hard Eight,2/28/1996,3000000,222559,-2777441,-17838.413615928068
Gymkata,5/3/1985,8500000,5730596,-2769404,-25809.91612301957
Braindead,8/13/1992,3000000,242623,-2757377,-19569.744499645138
Mobsters,7/26/1991,23000000,20246790,-2753210,-20155.27086383602
Rendition,9/7/2007,27500000,24748670,-2751330,-13196.460261883063
Love,7/6/2015,3000000,249083,-2750917,-11526.800305044122
Austenland,8/15/2013,4900000,2159041,-2740959,-11719.660334278275
Class of 1999,5/11/1990,5200000,2459895,-2740105,-21208.24303405573
Bliss,10/4/1985,3400000,660537,-2739463,-25202.051517939282
Cry-Baby,4/5/1990,11000000,8266343,-2733657,-21207.57951900698
Snowden,9/15/2016,40000000,37279439,-2720561,-11268.622529284094
12 Rounds,3/19/2009,20000000,17280326,-2719674,-12754.051772650533
Only the Strong,8/27/1993,6000000,3283371,-2716629,-18722.460372157133
Shooting Fish,8/22/1997,3000000,302204,-2697796,-16735.707196029776
Club Paradise,7/11/1986,15000000,12308521,-2691479,-24579.71689497717
Bones,10/24/2001,10000000,7316658,-2683342,-15125.941375422773
Jem and the Holograms,10/22/2015,5000000,2333684,-2666316,-11234.3512994236
Saving Silverman,2/9/2001,22000000,19351569,-2648431,-15065.022753128555
The Guest,9/17/2014,5000000,2367161,-2632839,-11088.76609401389
El hombre de las mil caras,9/23/2016,5000000,2387127,-2612873,-10809.100273446711
Black Dynamite,10/16/2009,2900000,296557,-2603443,-12034.590671659038
Fun Size,10/25/2012,14000000,11417362,-2582638,-11218.08175622554
Monte Carlo,7/1/2011,20000000,17425000,-2575000,-11397.739042678446
A Guy Thing,1/17/2003,20000000,17432163,-2567837,-14024.232659748772
Maximum Overdrive,7/25/1986,10000000,7433663,-2566337,-23394.138559708295
Hot to Trot,8/26/1988,9000000,6436211,-2563789,-21400.575959933223
Capitalism: A Love Story,9/6/2009,20000000,17436509,-2563491,-11869.717413147258
The Incredible Burt Wonderstone,3/14/2013,30000000,27437881,-2562119,-11006.94238592964
Nieve negra,1/19/2017,4000000,1440000,-2560000,-10508.901778713727
Kill the Messenger,10/9/2014,5000000,2450846,-2549154,-10736.308769210684
Matilda,8/2/1996,36000000,33459416,-2540584,-16151.20152574698
Wonderland,10/23/2003,5000000,2466444,-2533556,-13732.010840108402
Abre los ojos,12/19/1997,2900000,368234,-2531766,-15666.868811881188
Untraceable,1/22/2008,35000000,32483410,-2516590,-11887.922604904272
Veronica Mars,3/13/2014,6000000,3485127,-2514873,-10643.027935656155
Bangkok Dangerous,8/21/2008,45000000,42487390,-2512610,-11484.48462631923
Inkheart,12/11/2008,60000000,57490374,-2509626,-11937.639134653804
Predestination,8/28/2014,5500000,3000000,-2500000,-10502.833664522688
About Cherry,2/14/2012,2500000,3003,-2496997,-10967.952631740774
Nuit Blanche,11/14/2011,2500000,3358,-2496642,-11035.857313353667
Idioterne,4/28/1998,2500000,7235,-2492765,-15311.824324324323
Батальонъ,2/20/2015,10000000,7547762,-2452238,-10385.602175174383
Hatchet II,8/26/2010,2500000,52604,-2447396,-11204.024922289518
Dom durakov,12/6/2002,2500000,57862,-2442138,-13499.933665008291
Eye of the Dolphin,8/24/2007,2500000,71904,-2428096,-11646.102930596191
Banlieue 13,11/9/2004,12000000,9584131,-2415869,-12648.528795811519
While We're Young,4/3/2015,10000000,7587485,-2412515,-10196.640729673414
Macbeth,8/16/2015,15000000,12601706,-2398294,-10079.19477190107
Sleep Dealer,12/10/2008,2500000,107559,-2392441,-11380.220522480355
Goal!: The Dream Begins,6/6/2005,30000000,27610873,-2389127,-12283.429305912596
Bulletproof,9/6/1996,25000000,22611954,-2388046,-15133.371356147021
Everything Must Go,10/15/2010,5000000,2614773,-2385227,-10905.839212476738
Surveillance,2/8/2008,3500000,1115493,-2384507,-11263.986055278161
I Know Who Killed Me,7/27/2007,12000000,9620399,-2379601,-11444.956400871502
For Greater Glory - The True Story of Cristiada,6/1/2012,12000000,9622846,-2377154,-10358.962514925177
Albert Nobbs,12/21/2011,8000000,5634828,-2365172,-10434.659078375576
Frantic,2/16/1988,20000000,17637950,-2362050,-20275.10729613734
I Love You Phillip Morris,1/18/2009,13000000,10652035,-2347965,-11065.233066123765
Anomalisa,12/30/2015,8000000,5659286,-2340714,-9879.93212784278
The Keep,12/16/1983,6000000,3661757,-2338243,-22946.447497546615
The Quiet American,11/22/2002,30000000,27674124,-2325876,-12857.247097844112
Matewan,8/28/1987,4000000,1680358,-2319642,-20170.8
Life After Beth,8/15/2014,2400000,88273,-2311727,-9719.182516859224
Frankenhooker,6/1/1990,2500000,205068,-2294932,-17666.913010007698
Detroit Rock City,8/13/1999,6500000,4217115,-2282885,-13661.78934769599
The Other Side of Heaven,4/12/2001,7000000,4720371,-2279629,-12886.540418315431
Алеша Попович и Тугарин Змей,12/23/2004,4000000,1730000,-2270000,-11903.513371788149
Jimmy Vestvood: Amerikan Hero,3/13/2016,2500000,230069,-2269931,-9532.238422387583
Hobo with a Shotgun,5/6/2011,3000000,748453,-2251547,-9964.184560372449
Curdled,9/6/1996,2300000,49620,-2250380,-14260.963244613433
Hard Contract,4/30/1969,4000000,1750000,-2250000,-61813.18681318682
Pa Negre,10/10/2010,6000000,3770657,-2229343,-10193.099569751863
La vida precoz y breve de Sabina Rivas,11/9/2012,4620000,2395000,-2225000,-9664.626597921128
Manhattan Murder Mystery,8/18/1993,13500000,11285588,-2214412,-15261.281874569264
Delicatessen,4/17/1991,4000000,1794187,-2205813,-16267.057522123894
Орлеан,9/17/2015,2500000,302000,-2198000,-9241.584608010495
School for Scoundrels,9/29/2006,20000000,17807569,-2192431,-10864.375619425173
Super,9/9/2010,2500000,324138,-2175862,-9960.959352496579
Dead Calm,4/7/1989,10000000,7825000,-2175000,-17668.56214459789
Fred Claus,11/3/2007,100000000,97838349,-2161651,-10284.907482740738
Toni Erdmann,7/14/2016,3537415,1390172,-2147243,-8923.496018750935
Like Dandelion Dust,2/5/2009,2500000,352810,-2147190,-10119.042569736042
Nightbreed,2/16/1990,11000000,8862354,-2137646,-16609.52602952603
Away We Go,6/5/2009,17000000,14899417,-2100583,-9738.762964027575
Bedknobs and Broomsticks,10/7/1971,20000000,17900000,-2100000,-51344.74327628362
Boris - Il film,4/1/2011,3347850,1248748,-2099102,-9333.24144309178
Los cronocrímenes,9/20/2007,2600000,553198,-2046802,-9796.310832025118
Dans les forêts de Sibérie,6/15/2016,3500000,1492523,-2007477,-8329.157988200051
Evan Almighty,6/9/2007,175000000,173000000,-2000000,-9599.13991706343
Myra Breckinridge,6/24/1970,5000000,3000000,-2000000,-51282.05128205128
Dreaming of Joseph Lees,10/29/1999,2000000,7,-1999993,-11883.499702911467
Zyzzyx Road,2/25/2006,2000000,30,-1999970,-10009.85985985986
Exorcist: The Beginning,8/20/2004,80000000,78000586,-1999414,-10528.773038441284
Stolen Lives,10/10/2009,2000000,7306,-1992694,-9217.88164328305
Guinevere,9/4/1999,2600000,614202,-1985798,-11827.266229898749
Cruel World,9/1/2005,2000000,16344,-1983656,-9978.14889336016
Kingpin,7/4/1996,27000000,25023434,-1976566,-12589.592356687897
Cowboys & Angels,5/14/2003,2000000,33700,-1966300,-10715.531335149864
Lost River,4/8/2015,2000000,45431,-1954569,-8261.104231209769
Decoding Annie Parker,5/2/2014,2000000,48390,-1951610,-8203.48886086591
Heavenly Creatures,9/2/1994,5000000,3049135,-1950865,-13057.998661311914
Return of the Living Dead 3,10/1/1993,2000000,54207,-1945793,-13354.790665751545
Warrior,9/9/2011,25000000,23057115,-1942885,-8563.152025880496
Aftershock,9/12/2012,2000000,58510,-1941490,-8389.936345918662
25th Hour,12/16/2002,15000000,13060843,-1939157,-10672.30049532196
Fehér Isten,6/12/2014,2200000,282358,-1917642,-8045.72401958522
Powaqqatsi,4/29/1988,2500000,589244,-1910756,-16261.753191489363
Take Shelter,11/25/2011,5000000,3099314,-1900686,-8422.338615335531
Lock Up,8/4/1989,24000000,22099847,-1900153,-15250.02407704655
Bamako,6/21/2006,2000000,111000,-1889000,-9282.555282555282
It's All Gone Pete Tong,9/12/2004,2000000,120620,-1879380,-9896.682464454976
Six-String Samurai,9/18/1998,2000000,124494,-1875506,-11436.012195121952
The Raid 2: Berandal,3/27/2014,4500000,2627209,-1872791,-7899.671829655126
The Astronaut Farmer,10/15/2006,13000000,11130889,-1869111,-9262.195242814667
Flypaper,8/19/2011,5000000,3142154,-1857846,-8188.347606098136
Miracle Mile,5/19/1989,3000000,1145404,-1854596,-14944.36744560838
Гороскоп на удачу,7/16/2015,2800000,964206,-1835794,-7703.192400006714
Death of a President,10/27/2006,2000000,167000,-1833000,-9096.774193548386
G.I. Jane,8/22/1997,50000000,48169156,-1830844,-11357.593052109181
Quest for Camelot,5/15/1998,40000000,38172500,-1827500,-11225.429975429975
L'avenir,3/16/2016,2100000,282382,-1817618,-7596.800147119673
Original Gangstas,5/10/1996,4800000,3014000,-1786000,-11404.85312899106
Green Room,4/15/2016,5000000,3220371,-1779629,-7438.023748124433
Glengarry Glen Ross,9/15/1992,12500000,10725228,-1774772,-12560.311394196744
Simon Birch,9/11/1998,20000000,18253415,-1746585,-10675.947432762836
The Age of Innocence,9/17/1993,34000000,32255440,-1744560,-11973.644474948525
The Sweet Hereafter,5/14/1997,5000000,3263585,-1736415,-10845.81511555278
The TV Set,4/28/2006,2000000,265198,-1734802,-8566.923456790124
七人の侍,4/26/1954,2000000,271841,-1728159,-64243.82899628253
Нирвана,7/3/2008,2000000,273137,-1726863,-7850.661926497063
The Pick-up Artist,9/18/1987,15000000,13290368,-1709632,-14827.684301821337
Bad Words,9/6/2013,9500000,7800000,-1700000,-7260.334231621745
Ten Canoes,6/29/2006,2000000,300000,-1700000,-8353.808353808354
One-Eyed Jacks,3/30/1961,6000000,4300000,-1700000,-57046.97986577181
Table 19,1/20/2017,5000000,3305592,-1694408,-6955.612205104207
Tutta la vita davanti,3/28/2008,5940000,4250000,-1690000,-7866.941621707173
Standing Still,1/2/2005,1700000,12762,-1687238,-8847.603565810174
Hot Tub Time Machine 2,2/20/2015,14000000,12314651,-1685349,-7137.710222387864
幸福时光,12/31/2000,1900000,240093,-1659907,-9479.765848086809
Bacalaureat,5/20/2016,2000000,343617,-1656383,-6872.445211560962
Monkey Shines,7/29/1988,7000000,5344577,-1655423,-13911.117647058823
Roadgames,6/26/1981,1750000,100000,-1650000,-18013.100436681223
Joe,4/11/2014,4000000,2365467,-1634533,-6894.669130053317
Barfi!,9/14/2012,4437508,2804874,-1632634,-7055.248976910811
Subway,4/10/1985,2000000,390659,-1609341,-15054.639850327409
Шапито-шоу,12/12/2011,2000000,393816,-1606184,-7117.338438087136
Simply Irresistible,2/5/1999,6000000,4398989,-1601011,-9732.589665653495
You Kill Me,2/9/2007,4000000,2426851,-1573149,-7730.499904176433
Ladyhawke,3/27/1985,20000000,18432000,-1568000,-14667.913938260055
Beyond the Mat,10/22/1999,2053648,500000,-1553648,-9231.420083184788
Night Of The Living Dead 3D,5/6/2007,3000000,1449945,-1550055,-7454.015167180414
The Myth Of Fingerprints,9/17/1997,2000000,458815,-1541185,-9537.03589108911
It's Kind of a Funny Story,7/6/2010,8000000,6491240,-1508760,-6920.568228208668
A Countess from Hong Kong,1/5/1967,3500000,2000000,-1500000,-45592.705167173255
Best Man Down,10/20/2012,1500000,1938,-1498062,-6507.060606981987
Night on Earth,10/3/1991,3500000,2015810,-1484190,-10801.965065502183
Captain Ron,9/18/1992,24000000,22518097,-1481903,-10450.655853314527
City Lights,1/30/1931,1500000,19181,-1480819,-94319.68152866242
Pontypool,3/6/2009,1500000,32000,-1468000,-6901.4475175004345
Beautiful,4/27/2009,1500000,56000,-1444000,-6752.207092623074
The Mother,1/1/2003,2500000,1062253,-1437747,-7912.751788662631
The Virginity Hit,9/10/2010,2000000,563706,-1436294,-6575.263574727956
The New Adventures of Pippi Longstocking,7/6/1988,5000000,3569939,-1430061,-12068.025316455696
I Spit on Your Grave,6/17/2010,2000000,572809,-1427191,-6546.417382609135
The Losers,4/23/2010,25000000,23580000,-1420000,-6508.447231159878
Шпион,4/5/2012,6000000,4588176,-1411824,-6136.097529174001
Mommy,5/22/2014,4900000,3494070,-1405930,-5898.767742287376
L'Auberge espagnole,5/17/2002,5300000,3897799,-1402201,-7794.3357420789325
Fired Up!,2/20/2009,20000000,18599102,-1400898,-6585.983667827877
Sur la Piste du Marsupilami,4/3/2012,50000000,48600000,-1400000,-6084.707825368885
만추,9/10/2010,6200000,4820000,-1380000,-6317.553184184143
Sherrybaby,9/8/2006,2000000,622806,-1377194,-6787.550517496304
Batalla en el cielo,5/15/2005,1601792,253527,-1348265,-6935.519547325102
南京!南京!,4/22/2009,12000000,10652498,-1347502,-6300.978228340566
Inside Deep Throat,2/11/2005,2000000,653621,-1346379,-7019.702815432742
All About Eve,11/9/1950,1400000,63463,-1336537,-54110.80971659919
Mambo Italiano,6/6/2003,4361898,3031801,-1330097,-7240.593358737072
My Name Is Bruce,10/1/2007,1500000,173066,-1326934,-6350.9112838381125
Nothing Left to Fear,9/26/2013,3000000,1675381,-1324619,-5671.769158966542
Waste Land,1/24/2010,1500000,187716,-1312284,-6054.618184838125
The Lair of the White Worm,9/14/1988,2500000,1189315,-1310685,-10940.609348914859
Космос как предчувствие,6/23/2005,2000000,696681,-1303319,-6670.005117707267
The Silver Chalice,12/20/1954,4500000,3200000,-1300000,-48689.13857677903
Catch That Kid,2/6/2004,18000000,16702864,-1297136,-6966.358754027928
Voditel dlya Very,7/27/2004,3300000,2011837,-1288163,-6797.693931398417
Vampire's Kiss,9/17/1988,2000000,725131,-1274869,-10606.231281198003
Aferim!,1/22/2015,1379375,105097,-1274278,-5428.881826160308
Kaappari,1/17/2013,1800000,532269,-1267731,-5460.450711990558
Fortress,9/30/1992,8000000,6739141,-1260859,-8891.812411847672
The Wicker Man,9/1/2006,40000000,38755073,-1244927,-6135.6678166584525
Rambling Rose,9/10/1991,7500000,6266621,-1233379,-8989.642857142859
Na Igre 2. Novyy Uroven,4/15/2010,3500000,2294357,-1205643,-5530.244164231753
Poor White Trash,6/16/2000,1200000,1404,-1198596,-6936.319444444444
Córki dancingu,12/25/2015,1300000,101657,-1198343,-5058.092319640717
Body Double,10/25/1984,10000000,8801940,-1198060,-11377.58784425451
20th Century Women,12/25/2016,7000000,5816211,-1183789,-4874.789469566256
Soul Plane,5/28/2004,16000000,14822346,-1177654,-6207.98102266737
Sid & Nancy,11/7/1986,4000000,2826523,-1173477,-10629.320652173912
Trailer Park Boys: The Movie,10/6/2006,5000000,3833507,-1166493,-5780.441030723488
Double Dragon,11/4/1994,3500000,2341309,-1158691,-7740.086840347362
Higher Ground,8/26/2011,2000000,841733,-1158267,-5104.994071991149
Session 9,8/10/2001,1500000,373967,-1126033,-6343.847887323944
Il cartaio,1/2/2004,2600000,1479042,-1120958,-6052.68898488121
Chandni Chowk To China,1/16/2009,10500000,9400000,-1100000,-5183.959885575867
The Believer,1/19/2001,1500000,416925,-1083075,-6160.836177474403
Killing Zoe,10/1/1993,1500000,418961,-1081039,-7419.622512010982
Mechenosets,10/12/2006,5000000,3919731,-1080269,-5353.16650148662
Sukiyaki Western Django,9/15/2007,3800000,2725258,-1074742,-5154.885126384958
Runaway Train,11/15/1985,9000000,7936012,-1063988,-9761.357798165138
Mustang,6/17/2015,1300000,250000,-1050000,-4399.674843078264
Na Kryuchke!,2/3/2011,3000000,1957000,-1043000,-4712.867529110881
A Scanner Darkly,5/25/2006,8700000,7659918,-1040082,-5126.08181370133
The Founder,11/24/2016,25000000,23964782,-1035218,-4287.824314920972
Добрыня Никитич и Змей Горыныч,3/16/2006,4500000,3468423,-1031577,-5119.488833746898
Glukhar v kino,5/6/2010,2500000,1477030,-1022970,-4688.694552154663
Big Game,9/5/2014,8500000,7500000,-1000000,-4201.1334658090755
On Deadly Ground,2/18/1994,50000000,49000000,-1000000,-6793.478260869566
The End of Poverty?,5/19/2008,1000000,57,-999943,-4569.810113566255
Wilson,8/1/1944,2995000,2000000,-995000,-56214.68926553673
Special,1/30/2006,1000000,7202,-992798,-4996.46703573226
Honeymoon,9/12/2014,1000000,9318,-990682,-4161.987304174666
Alone With Her,4/28/2006,1000000,10018,-989982,-4888.8
Waltzing Anna,8/11/2006,1000000,11455,-988545,-4848.185384992643
The Concorde... Airport '79,8/17/1979,14000000,13015688,-984312,-13194.530831099197
Itty Bitty Titty Committee,2/9/2007,1000000,18479,-981521,-4823.2227185391575
Tusk,9/19/2014,2800000,1826705,-973295,-4099.240627882392
What's Eating Gilbert Grape,12/17/1993,11000000,10032765,-967235,-6615.834473324214
Lieksa!,9/14/2007,1400000,435000,-965000,-4628.519353446209
We Don't Live Here Anymore,1/20/2004,3000000,2037545,-962455,-5168.931256713212
We Need to Talk About Kevin,9/28/2011,7000000,6038942,-961058,-4244.5621210046775
Bottle Shock,8/6/2008,5000000,4040588,-959412,-4379.157043352839
Prison,3/4/1988,1300000,354704,-945296,-8114.128755364807
Camp X-Ray,10/17/2014,1000000,59744,-940256,-3981.588051712675
Norm of the North,1/14/2016,18000000,17062499,-937501,-3957.102939438451
Dear Zindagi,11/24/2016,4300000,3376375,-923625,-3825.61135226482
Faster,11/23/2010,24000000,23081726,-918274,-4189.607581018255
The Night Flier,4/30/1997,1000000,91549,-908451,-5674.272329793879
Top Dog,4/28/1995,6000000,5093707,-906293,-5954.618922470434
L!fe Happens,6/18/2011,930000,30905,-899095,-3979.6699745930014
After.Life,4/9/2010,4500000,3606395,-893605,-4098.936282447055
The Black Dahlia,9/15/2006,50000000,49111202,-888798,-4380.473139477575
The House of Yes,10/10/1997,1500000,626057,-873943,-5408.063118811881
American Ultra,8/19/2015,28000000,27139524,-860476,-3616.2810733572887
Ken Park,8/31/2002,1300000,447741,-852259,-4708.613259668508
Kidulthood,3/3/2006,994000,165000,-829000,-4149.149149149149
The Treatment,4/8/2006,900000,82701,-817299,-4056.074441687345
Center Stage,5/12/2000,18000000,17200925,-799075,-4659.32944606414
Bulworth,5/15/1998,30000000,29202884,-797116,-4896.289926289926
Space Battleship Yamato,12/1/2010,12000000,11212294,-787706,-3593.893575570652
The Ballad of Jack and Rose,3/25/2005,1500000,712294,-787706,-4047.8211716341216
College,8/28/2008,7000000,6230276,-769724,-3518.2075389769775
Все и сразу,6/5/2014,750000,3,-749997,-3146.712930524496
Crimes and Misdemeanors,10/13/1989,19000000,18254702,-745298,-5933.901273885351
The Pirate,6/11/1948,3700000,2956000,-744000,-30871.369294605807
The Mudge Boy,1/17/2003,800000,62852,-737148,-4025.9311851447296
Napola �?Elite für den Führer,7/4/2004,4500000,3764219,-735781,-3884.7993664202745
Taxi to the Dark Side,4/30/2007,1000000,274661,-725339,-3488.06197673468
Blue in the Face,9/15/1995,2000000,1275000,-725000,-4732.375979112272
31,9/15/2016,1500000,779820,-720180,-2983.001143197972
Lars and the Real Girl,10/12/2007,12000000,11293663,-706337,-3380.6380901328635
La mariée était en noir,3/22/1968,747000,44566,-702434,-20419.593023255813
Foolish Wives,1/11/1922,1100000,400200,-699800,-41408.284023668646
Native Son,12/24/1986,2000000,1301121,-698879,-6284.88309352518
Bel Ami,3/9/2012,9000000,8303261,-696739,-3037.3291134825977
The Girlfriend Experience,1/20/2009,1700000,1007962,-692038,-3261.3611193583197
Naturally Native,10/8/1999,700000,10508,-689492,-4099.239001189061
Critters 2,4/29/1988,4500000,3813293,-686707,-5844.314893617021
Shaft in Africa,6/14/1973,2142000,1458000,-684000,-15475.113122171944
Zathura: A Space Adventure,11/6/2005,65000000,64321501,-678499,-3433.699392712551
Alatriste,9/1/2006,24000000,23321954,-678046,-3341.774273040907
The Innkeepers,12/1/2011,750000,78396,-671604,-2976.0182920344573
The Tracey Fragments,2/8/2007,700000,31576,-668424,-3284.654961449442
A Place Called Chiapas,2/20/1998,891000,229000,-662000,-4081.381011097411
Vượt Sóng,2/22/2006,1300000,639000,-661000,-3308.308308308308
Fish Tank,5/14/2009,3000000,2357852,-642148,-3002.7121053419123
The Frighteners,7/18/1996,30000000,29359216,-640784,-4073.642720915448
The Next Best Thing,3/3/2000,25000000,24362772,-637228,-3722.1261682242994
Galaxina,6/6/1980,5500000,4865000,-635000,-7678.355501813785
Edge of Seventeen,5/14/1998,1500000,870751,-629249,-3865.165847665847
Stake Land,9/30/2010,650000,33245,-616755,-2819.9541861177536
A Girl Walks Home Alone at Night,1/19/2014,1000000,395000,-605000,-2576.8695081799633
Я остаюсь,4/19/2007,1000000,404785,-595215,-2862.3123939042744
On the Job,5/23/2013,1052753,466088,-586665,-2512.4409003700152
Drowning Mona,3/3/2000,16000000,15427192,-572808,-3345.841121495327
No End in Sight,7/27/2007,2000000,1431623,-568377,-2733.672571266419
Jagal,8/31/2012,1000000,444575,-555425,-2400.208291019718
Blue Car,1/11/2002,1000000,464000,-536000,-3026.5386787125917
Talk Radio,12/21/1988,4000000,3468572,-531428,-4388.340214698596
The Diary of a Teenage Girl,8/7/2015,2000000,1477002,-522998,-2194.556806928616
Ace in the Hole,6/29/1951,1821052,1300000,-521052,-20117.83783783784
The Quiet,9/12/2005,900000,381420,-518580,-2608.551307847082
Miss Julie,9/7/2014,5500000,5000000,-500000,-2100.5667329045377
Anjaana Anjaani,9/24/2010,6400000,5900000,-500000,-2286.12186858457
Forever Fever,5/28/1998,1070000,570000,-500000,-3067.4846625766872
Šišanje,10/6/2010,500000,198,-499802,-2285.2165643246108
White Girl,9/2/2016,700000,200242,-499758,-2070.0084497241414
Ridicule,5/9/1996,3000000,2503829,-496171,-3168.397190293742
Zvezda,5/6/2002,1300000,809000,-491000,-2730.8120133481643
Squeeze,6/6/1997,500000,10300,-489700,-3054.8970679975046
Biker Boyz,1/31/2003,24000000,23510601,-489399,-2672.850901146914
Peter and Vandy,1/1/2009,500000,11276,-488724,-2314.6587857518366
Aquarius,9/1/2016,762241,285930,-476311,-1972.8904683798069
Strangeland,10/2/1998,1100000,631221,-468779,-2858.4085365853657
Red Lights,3/2/2012,14000000,13551174,-448826,-1956.5895933598383
Fire and Ice,3/25/1983,1200000,760883,-439117,-4453.519269776876
Hamlet,5/12/2000,2000000,1568749,-431251,-2514.583090379009
Texas Chainsaw Massacre: The Next Generation,1/1/1994,600000,185898,-414102,-2832.435020519836
Die Angst des Tormanns beim Elfmeter,2/19/1972,410000,100,-409900,-9900.96618357488
En kongelig affære,3/29/2012,8000000,7594693,-405307,-1761.553338983419
Rubber,7/9/2010,500000,98017,-401983,-1843.8656765025619
The Amazing Truth About Queen Raquela,3/7/2008,400000,5255,-394745,-1848.6802667565846
Duniyadari,7/19/2014,390000,3,-389997,-1639.662479188739
הסיפור של יוסי,5/16/2012,500000,116207,-383793,-1672.4609766513565
Batman: Mask of the Phantasm,12/25/1993,6000000,5617391,-382609,-2617.02462380301
2 Coelhos,1/20/2012,2000000,1620436,-379564,-1667.2186521305614
Fiza,9/8/2000,1000000,623791,-376209,-2165.854922279793
Le Mépris,10/21/1963,900000,528428,-371572,-12064.025974025973
Beröringen,7/14/1971,6900000,6530000,-370000,-9090.90909090909
Le passé,5/17/2013,11000000,10631747,-368253,-1577.073626147732
Seeking a Friend for the End of the World,6/22/2012,10000000,9636289,-363711,-1587.5366645715483
Unknown,11/3/2006,3700000,3338228,-361772,-1795.394540942928
Антикиллер Д.К.: Любовь без памяти,12/3/2009,2500000,2141028,-358972,-1662.299894882588
Jackpot,7/26/2001,400000,43719,-356281,-2007.2169014084507
Clue,12/13/1985,15000000,14643997,-356003,-3257.11802378774
May,1/13/2002,500000,150277,-349723,-1974.72049689441
The Lords of Salem,9/10/2012,1500000,1165882,-334118,-1443.8543345706914
Kill List,9/2/2011,500000,171760,-328240,-1446.6986059262458
Star!,7/18/1968,14320000,14000000,-320000,-9142.857142857143
Sunshine Superman,5/22/2015,400000,88097,-311903,-1307.013132862327
Twelve and Holding,9/11/2005,400000,95687,-304313,-1530.7494969818913
रावण,6/18/2010,4500000,4200000,-300000,-1376.077353894987
Your Friends & Neighbors,2/4/1998,5000000,4710749,-289251,-1786.602841260037
Zid,11/28/2014,1556288,1268395,-287893,-1226.0574416980392
Raising Helen,5/27/2004,50000000,49718611,-281389,-1483.336847654191
Boy Culture,1/31/2007,500000,220151,-279849,-1375.1861188507069
Te3n,6/10/2016,5069632,4817642,-251990,-1045.5235708536293
Pushing Hands,2/1/1992,400000,152322,-247678,-1786.998556998557
Sex Drive,10/16/2008,19000000,18755936,-244064,-1148.9419795221843
P2,11/9/2007,8000000,7766240,-233760,-1112.2054268545085
The Brave One,9/14/2007,70000000,69766619,-233381,-1119.3870209602378
Behind the Burly Q,4/23/2010,250000,23859,-226141,-1036.4977220434691
Поводир,11/12/2014,722083,499168,-222915,-943.9511160232224
Panic,12/1/2000,1000000,779137,-220863,-1269.3275862068965
True Romance,9/9/1993,12500000,12281551,-218449,-1505.5065472088215
Dr. Horrible's Sing-Along Blog,7/15/2008,200000,3,-199997,-909.2260551726646
Afflicted,4/4/2014,318000,121179,-196821,-830.2161368698117
The Canyons,7/29/2013,250000,56825,-193175,-825.9683508852944
Happiness,10/16/1998,3000000,2807390,-192610,-1174.4512195121952
Il capitale umano,1/9/2014,6000000,5809330,-190670,-815.1216676071753
Утомлённые солнцем,5/1/1994,2800000,2616503,-183497,-1244.0474576271185
A United Kingdom,11/25/2016,14000000,13819139,-180861,-749.1177640080851
Win Win,3/18/2011,10831173,10654385,-176788,-786.0528398530942
Fire in the Sky,3/12/1993,19885552,19724334,-161218,-1122.6880222841226
90 Minutes in Heaven,9/11/2015,5000000,4842699,-157301,-661.0813423270083
The Hitcher,2/21/1986,6000000,5844868,-155132,-1425.8455882352941
羅生門,12/26/1950,250000,96568,-153432,-6040.629921259843
The Transformers: The Movie,8/8/1986,6000000,5849647,-150353,-1370.5834092980856
Tanu Weds Manu,3/25/2011,400000,252000,-148000,-658.0526975714298
Brigham City,3/30/2001,1000000,852206,-147794,-835.4663651780667
Intermission,8/29/2003,5000000,4856298,-143702,-775.9287257019439
Scouts Guide to the Zombie Apocalypse,10/23/2015,15000000,14860766,-139234,-586.6535207469578
Charly,9/23/1968,950000,814666,-135334,-3833.8243626062326
Raise Your Voice,8/10/2004,15000000,14867514,-132486,-699.1345646437994
Serenity,8/25/2005,39000000,38869464,-130536,-656.6197183098591
Running Time,12/18/1997,130000,1596,-128404,-794.5792079207921
The House of Usher,9/11/2007,130000,1677,-128323,-615.4875533598733
Logan,9/10/2010,135000,10474,-124526,-570.0721940679091
Smashed,9/12/2012,500000,376597,-123403,-533.2725457743284
Burn,11/1/2012,225000,111300,-113700,-493.8732782847785
Dahmer,6/21/2002,250000,144008,-105992,-588.517490283176
Vulgar,9/13/2000,120000,14904,-105096,-605.0431778929188
Not of This Earth,5/20/1988,210000,107352,-102648,-869.8983050847457
The 33,8/6/2015,25000000,24902723,-97277,-408.18493093203983
El Abrazo de la Serpiente,5/25/2015,1400000,1320005,-79995,-335.2148442410681
Wabash Avenue,3/31/1950,2115000,2039000,-76000,-3220.338983050847
Manny & Lo,1/22/1996,500000,431326,-68674,-443.34409296320206
Peeping Tom,4/6/1960,150000,83957,-66043,-2238.7457627118642
Une Femme est une femme,9/6/1961,160000,100655,-59345,-1978.1666666666667
Vivre sa vie: film en douze tableaux,9/20/1962,64000,24517,-39483,-1298.782894736842
Latter Days,7/10/2003,850000,819939,-30061,-163.4638390429581
Down Terrace,9/1/2009,31192,10000,-21192,-98.12519389356807
Win a Date with Tad Hamilton!,1/23/2004,17000000,16980098,-19902,-106.88506981740065
Big Fan,1/18/2009,250000,232732,-17268,-81.37874482193098
Wish I Was Here,1/18/2014,5500000,5483299,-16701,-71.13437629109681
Eegah,6/8/1962,15000,3274,-11726,-388.27814569536423
Nasty Old People,10/10/2009,15000,5300,-9700,-44.870638412041984
Four Eyed Monsters,1/21/2005,250000,245000,-5000,-26.068821689259643
Stitches,5/19/2012,100000,95000,-5000,-21.78858104044832
The Afflicted,10/22/2011,180000,175742,-4258,-18.821553286478363
Loving,11/4/2016,9000000,8996802,-3198,-13.250301425712545
The Merry Widow,8/26/1925,592,1,-591,-33.389830508474574
Assisted Living,2/2/2005,500,41,-459,-2.3931178310740355
"\"검사외�?\"\"After a prosecution lawyer is framed and convicted for murder\"",2/3/2016,500,50,-450,-1.8978453129546922
American Adobo,9/29/2001,344,4,-340,-1.9133370849746765
Vibes,8/5/1988,1884000,1883811,-189,-1.588235294117647
Sunday,8/27/1997,450,288,-162,-1.0049627791563276
Bodyguard,8/31/2011,130,8,-122,-0.5377078659608884
I Married a Strange Person!,8/28/1998,250,203,-47,-0.28728606356968217
Man Trouble,7/17/1992,30,4,-26,-0.18452803406671398
The 51st State,12/7/2001,28,14,-14,-0.07923033389926429
Angela's Ashes,12/25/1999,25,13,-12,-0.07109004739336493
The Wind in the Willows,10/16/1996,12,1,-11,-0.06935687263556116
William & Kate,4/18/2011,20,15,-5,-0.022127418526844984
Split Second,5/1/1992,7,5,-2,-0.014316392269148177
Raja Natwarlal,8/29/2014,5,4,-1,-0.0042011334658090755
Mute Witness,9/28/1995,2,1,-1,-0.0065061808718282375
Miami Rhapsody,1/27/1995,6,5,-1,-0.0066269052352551355
தீணா,1/14/2001,500000,500000,0,0.0
The Letters,12/4/2015,1,1,0,0.0
Villan,12/5/2002,500000,500000,0,0.0
Citizen,6/8/2001,500000,500000,0,0.0
Desmundo,11/8/2002,3,3,0,0.0
Bikini Spring Break,6/26/2012,500000,500000,0,0.0
Amarkalam,8/25/1999,500000,500000,0,0.0
Vaali,5/1/1999,500000,500000,0,0.0
Lost in the Sun,11/5/2015,25000,25000,0,0.0
காதல�?கோட்டை,7/12/1996,500000,500000,0,0.0
முகவரி,2/2/2000,500000,500000,0,0.0
Treehouse,10/20/2014,3250000,3250000,0,0.0
Varalaru,10/20/2006,500000,500000,0,0.0
F.I.S.T.,4/26/1978,11,11,0,0.0
The War of the Worlds,8/13/1953,2000000,2000000,0,0.0
Narco,12/1/2004,823258,823258,0,0.0
Kandukondain Kandukondain,5/5/2000,500000,500000,0,0.0
Bran Nue Dae,8/9/2009,7,7,0,0.0
Hross í oss,8/30/2013,10,11,1,0.004270784842130438
예의없는 것들,8/24/2006,3,4,1,0.0049285362247412515
Tere Naam,8/15/2003,1,2,1,0.005417118093174431
Saamy,5/5/2003,1,3,2,0.010899182561307902
Pollock,9/6/2000,6,8,2,0.011514104778353483
East of Eden,3/9/1955,1,5,4,0.149812734082397
The Prophecy,9/1/1995,8,16,8,0.05221932114882507
Starter for 10,9/13/2006,8,21,13,0.06407097092163627
A Farewell to Arms,12/8/1932,4,25,21,1.6030534351145038
A Farewell to Arms,12/8/1932,4,25,21,1.6030534351145038
Madonna: Truth or Dare,5/10/1991,4,29,25,0.18436578171091447
The Immortals,10/5/1995,50,83,33,0.21470396877033182
Boy,2/14/2010,3,43,40,0.18455206905938423
वांटेड,9/18/2009,75,134,59,0.2729245016814925
Rugrats in Paris: The Movie,9/14/2000,30,103,73,0.42026482440990215
Every Which Way But Loose,12/19/1978,5,85,80,1.171303074670571
Lost & Found,4/23/1999,1,100,99,0.5956678700361011
Make Your Move,8/7/2013,15,122,107,0.4575054408941452
The Cherry Orchard,1/1/1999,5,135,130,0.7912355447352404
The Mysterious Lady,8/4/1928,337,551,214,12.514619883040934
Falling From Grace,2/21/1992,3,232,229,1.6439339554917443
Star of Midnight,4/19/1935,280,831,551,39.927536231884055
Nick of Time,11/22/1995,8169363,8175346,5983,38.9771986970684
Quiet City,3/12/2007,2500,15425,12925,62.9407066890023
Captive,9/5/2012,11180,24591,13411,57.95416733288103
Bwakaw,9/5/2012,11178,34659,23481,101.47056917033625
West Is West,10/19/2010,3837625,3867000,29375,134.25318665649007
Death Proof,5/21/2007,25000000,25037897,37897,181.88930271847642
Following,9/12/1998,6000,48482,42482,259.66992665036673
Basquiat,8/9/1996,2962051,3011195,49144,312.4221233312142
The Rapture,10/4/1991,1227401,1277401,50000,363.901018922853
Miranda,4/6/1948,784170,834332,50162,2107.6470588235293
Beautiful Creatures,2/13/2013,60000000,60052138,52138,224.57207343021804
Bande à part,8/5/1964,120000,182857,62857,2027.6451612903227
The Disappearance of Alice Creed,9/12/2009,800000,867714,67714,313.53573892549394
Absolute Power,2/14/1997,50000000,50068310,68310,428.0075187969925
The Castle,4/10/1997,786675,861789,75114,468.87640449438203
Jawbreaker,1/30/1999,3000000,3076820,76820,466.99088145896656
Stoker,2/28/2013,12000000,12077441,77441,332.6889286987752
The Thief of Bagdad,3/18/1924,1135654,1213880,78226,4601.529411764706
Bellflower,4/16/2011,17000,101236,84236,372.7850454054628
Dracula: Prince of Darkness,1/9/1966,280379,364937,84558,2659.056603773585
Mala noćna muzika,1/1/2002,200000,286000,86000,485.60135516657255
Where the Wild Things Are,10/16/2009,100000000,100086793,86793,401.206490084593
Swoon,9/11/1992,250000,340147,90147,637.9830148619957
ಲೂಸಿಯಾ,10/19/2013,79000,170000,91000,390.4423153658359
S. Darko,4/28/2009,4000000,4100000,100000,467.6043692952267
Dingo,6/2/1991,200000,300000,100000,735.2941176470588
The Heart is Deceitful Above All Things,9/15/2004,74050,176153,102103,537.6671932596103
Mean Creek,1/15/2004,500000,603943,103943,561.2473002159827
Theeviravaathi: The Terrorist,9/12/1998,24554,140021,115467,705.7885085574572
The Cheat,12/13/1915,17311,137365,120054,11655.728155339804
The Dreamers,9/1/2003,15000000,15121165,121165,654.2386609071275
La battaglia di Algeri,9/8/1966,800000,921548,121548,3717.0642201834858
Rabbit Hole,12/16/2010,5000000,5129058,129058,586.0332481166816
The Hunchback of Notre Dame,6/21/1996,100000000,100138851,138851,884.4012738853503
Shikshanachya Aaicha Gho,1/15/2010,380000,520000,140000,646.0932127907996
Rane,5/27/1998,10000,150000,140000,858.8957055214723
The Frisco Kid,7/6/1979,9200000,9346177,146177,1999.6853625171
Bizim Aile,9/7/1975,65700,214600,148900,2727.106227106227
ആമേൻ,3/21/2013,110000,270000,160000,688.0802989708899
The Foot Fist Way,6/24/2006,79000,245000,166000,815.7248157248157
'N Beetje Verliefd,12/14/2006,800000,966214,166214,823.6570862239842
The Painted Veil,11/23/1934,947000,1120000,173000,12910.44776119403
Bleed for This,11/4/2016,6000000,6174491,174491,722.9700894540362
Life in a Day,1/27/2011,45202,225861,180659,816.3201677292835
The Fast and the Furious,2/15/1955,66000,250000,184000,6891.385767790262
Angel Heart,3/6/1987,17000000,17185632,185632,1655.9500446030331
The Signal,2/22/2007,50000,249905,199905,973.47481397795
Lootera,4/4/2013,4100000,4300000,200000,860.1003737136124
Dark City,2/27/1998,27000000,27200316,200316,1234.9938347718867
Ruby in Paradise,10/8/1993,800000,1001437,201437,1382.5463280713795
Na Igre,11/26/2009,3500000,3704408,204408,946.5568259172304
Tim,7/13/1979,600000,809000,209000,2859.0971272229826
Appaloosa,9/12/2008,20000000,20211394,211394,966.2268092127816
FC Venus,12/30/2005,2196531,2411594,215063,1084.5335350479072
Barfly,9/2/1987,3000000,3221568,221568,1926.6782608695653
Ladri di biciclette,11/24/1948,133000,361712,228712,9490.1244813278
Laitakaupungin valot,2/3/2006,1380000,1615018,235018,1182.778057372924
Another Gay Movie,4/28/2006,500000,745327,245327,1211.4913580246914
Valentino,3/8/1951,1300000,1550000,250000,9689.922480620155
The Angrez,6/2/2006,50000,300000,250000,1232.1340561853128
Airborne,9/17/1993,2600000,2850263,250263,1717.6595744680853
Cube,9/9/1997,250000,501818,251818,1562.1464019851119
Leprechaun 2,4/7/1994,2000000,2260622,260622,1768.1275440976933
Killer of Sheep,11/14/1978,100000,362222,262222,3890.53412462908
The Watch,7/26/2012,68000000,68267862,267862,1162.7014615047378
Batman: The Killing Joke,7/21/2016,3500000,3775000,275000,1141.7942362226956
Shadow of the Vampire,5/15/2000,8000000,8279017,279017,1626.9212827988338
Flesh and the Devil,12/25/1926,373000,658000,285000,16285.714285714286
Poslednyaya skazka Rity,11/1/2012,200000,486937,286937,1246.354589720312
Anna Karenina,8/30/1935,1152000,1439000,287000,20948.905109489053
Surviving the Game,4/15/1994,7400000,7690013,290013,1967.5237449118044
Outside Providence,8/16/1999,7000000,7292175,292175,1740.172721858249
Paper Heart,7/31/2009,1000000,1296971,296971,1375.9231631716968
From a Whisper to a Scream,9/25/1987,1100000,1400000,300000,2601.9080659150045
Four Rooms,12/9/1995,4000000,4300000,300000,1954.3973941368079
Incendies,9/4/2010,6800000,7103838,303838,1390.9512495479287
Across to Singapore,4/7/1928,290000,596000,306000,17894.736842105263
C'era una volta il West,12/21/1968,5000000,5321508,321508,9031.123595505618
Party Girl,6/9/1995,150000,472370,322370,2113.901639344262
The Bad News Bears,4/7/1976,35000000,35323292,323292,5762.780748663102
The D Train,5/8/2015,447524,771317,323793,1361.5903786716005
Affliction,8/28/1997,6000000,6330054,330054,2047.481389578164
Upstream Color,4/5/2013,100000,444098,344098,1479.794091970533
Five Graves to Cairo,5/3/1943,855000,1200000,345000,19714.285714285714
Sholem Aleichem: Laughing In The Darkness,2/24/2012,500000,845188,345188,1504.7952849271117
Tiny Furniture,11/12/2010,65000,416498,351498,1606.4587779875048
Poison,4/5/1991,250000,609524,359524,2659.201183431953
Demonic,2/12/2015,3000000,3387000,387000,1648.75895740493
Stardust Memories,9/26/1980,10000000,10389003,389003,4587.299528301887
Tape,1/26/2001,100000,490475,390475,2221.13196814562
Attack of the 50 Foot Woman,5/19/1958,88000,480000,392000,13564.01384083045
La doppia ora,10/9/2009,3906840,4300000,393160,1818.6948657812811
Deuce Bigalow: European Gigolo,8/6/2005,22000000,22400154,400154,2037.4439918533603
Mary of Scotland,8/28/1936,864000,1276000,412000,29428.571428571428
Primer,10/8/2004,7000,424760,417760,2188.370874803562
Ong Bak 2,12/4/2008,8500000,8936663,436663,2077.0924900584127
The Ref,3/9/1994,11000000,11439193,439193,2983.648097826087
House of Sand and Fog,12/19/2003,16500000,16942795,442795,2390.901727861771
The Last Wave,1/1/1977,810000,1258000,448000,7658.119658119658
Legend of the Lost,12/17/1957,1750000,2200000,450000,15734.265734265733
Birdman of Alcatraz,7/3/1962,2650000,3100000,450000,14851.485148514852
Made,7/13/2001,5000000,5476060,476060,2682.0281690140846
Weekend,9/22/2011,8000,484592,476592,2104.89309737171
Tucker and Dale vs Evil,1/22/2010,5000000,5476793,476793,2199.8283665757745
Videocracy,9/4/2009,700000,1179676,479676,2221.040982733633
"\"रम�?राघव �?�?\"\"Set in present day Mumbai the story follows the life of a serial killer Ramanna who is inspired by an infamous serial killer from the 1960s Raman Raghav. His strange obsession with Raghavan\"",6/24/2016,521873,1013926,492053,2044.8700899313465
I'm Not Ashamed,10/21/2016,1500000,2000000,500000,2071.654381756183
Fort Apache,3/26/1948,2500000,3000000,500000,21008.403361344535
Redd Inc.,11/3/2012,500000,1000000,500000,2171.826201780029
تین بہادر,5/21/2015,143149,645135,501986,2103.5459566372497
Sparrows,5/14/1926,463455,966878,503423,28282.191011235955
Full Frontal,8/2/2002,2000000,2506446,506446,2802.6895406751523
The Treasure of the Sierra Madre,1/24/1948,3800000,4307000,507000,21574.468085106382
Conversations with Other Women,6/7/2006,450000,973525,523525,2580.2119270576636
Dikari,11/23/2006,800000,1328612,528612,2619.4846382556984
Project X,4/17/1987,18000000,18532286,532286,4706.330680813439
The New World,12/25/2005,30000000,30536013,536013,2703.04084720121
My Best Girl,10/31/1927,483103,1027757,544654,31482.890173410404
Testament,11/4/1983,1500000,2044892,544892,5384.308300395257
Heavy Traffic,8/8/1973,950000,1500000,550000,12195.121951219511
Riding Giants,7/9/2004,2600000,3166000,566000,2988.3843717001055
Drop Dead Gorgeous,7/23/1999,10000000,10571408,571408,3419.5571514063436
Stagecoach,3/2/1939,531374,1103757,572383,41178.633093525175
9 Songs,7/16/2004,1000000,1574623,574623,3032.311345646438
The Women,1/1/1939,1688000,2270000,582000,41571.42857142857
Howl,8/26/2010,30000,617000,587000,2687.2490718232552
Плюс один,8/21/2008,336029,927277,591248,2702.440317574949
Grave,10/7/2016,3500000,4100000,600000,2482.1184053216616
Shabd,2/4/2005,2500000,3100000,600000,3128.2586027111574
The Unholy Three,9/16/1925,103000,704000,601000,33954.80225988701
Tangerine,7/10/2015,100000,702354,602354,2523.963562311966
The Man with the Iron Fists,11/2/2012,15000000,15608545,608545,2643.307951924455
The Maltese Falcon,11/18/1941,375000,1000000,625000,40322.58064516129
Let's Go to Prison,11/17/2006,4000000,4630045,630045,3122.125867195243
Tosun Paşa,1/1/1976,64200,698200,634000,11402.877697841726
Iron Sky,3/10/2012,7500000,8135031,635031,2768.3223477715005
Last Night,5/11/2010,7000000,7644937,644937,2956.012980227154
Living in Oblivion,1/20/1995,500000,1148752,648752,4299.21802518224
12 Angry Men,3/25/1957,350000,1000000,650000,23297.491039426524
Dracula,2/12/1931,355000,1012189,657189,41859.171974522294
Trolljegeren,10/29/2010,3500000,4159678,659678,3014.9403801593216
West of Zanzibar,11/24/1928,259000,921000,662000,38713.450292397654
Claire of the Moon,9/18/1992,130000,799674,669674,4722.665726375176
City Island,3/6/2009,6000000,6670712,670712,3153.190509099286
Tarif Novogodniy,12/4/2008,3200000,3877492,677492,3222.653500009513
Who Killed the Electric Car?,8/4/2006,1000000,1678874,678874,3329.4458067680234
ഗോഡ്ഫാദർ,3/3/1991,18000,700000,682000,5051.851851851852
Flaskepost fra P,3/3/2016,5210000,5900000,690000,2897.5526178758
Zombadings 1: Patayin sa Shokot si Remington,8/31/2011,22361,721651,699290,3082.0797835064723
Der Himmel über Berlin,1/1/1987,2500000,3200000,700000,6294.964028776978
Point Blank,8/30/1967,2500000,3200000,700000,20833.333333333332
Rope,8/23/1948,1500000,2200000,700000,28571.428571428572
The Informer,5/9/1935,243000,950000,707000,51231.88405797101
Invisible Agent,7/31/1942,322000,1040000,718000,43515.15151515151
Cannonball,7/6/1976,780000,1500000,720000,12609.457092819614
بچه‌ها�?آسمان,8/1/1997,180000,900000,720000,4477.611940298507
Dad,10/27/1989,19000000,19738015,738015,5861.9142176330415
The Broken Hearts Club: A Romantic Comedy,2/1/2000,1000000,1744858,744858,4386.6784452296815
Louis C.K.: Live at the Beacon Theater,12/10/2011,250000,1000000,750000,3323.4074231628206
Carnosaur,5/21/1993,1000000,1753979,753979,5221.4612188365645
Saul fia,6/11/2015,1000000,1777043,777043,3256.1578625365614
இன்ற�?நேற்று நாளை,6/26/2015,620000,1400000,780000,3268.3298834295674
Kiss Kiss Bang Bang,9/5/2005,15000000,15785148,785148,3949.4366197183094
Dumbo,10/22/1941,812000,1600000,788000,51168.831168831166
Phoenix Forgotten,4/21/2017,2800000,3600000,800000,3268.8685220219586
The Wrong Man,12/22/1956,1200000,2000000,800000,28985.50724637681
The Wraith,11/21/1986,2700000,3500000,800000,7239.819004524887
Repo Man,2/20/1984,1500000,2300000,800000,7797.270955165693
Captive,9/17/2015,2000000,2801508,801508,3369.974520471918
Morgan,9/1/2016,8000000,8810591,810591,3357.485461504051
Robot & Frank,8/16/2012,2500000,3325038,825038,3565.3113345750126
Avalon,1/20/2001,8000000,8826094,826094,4699.05574516496
From Paris with Love,2/5/2010,52000000,52826594,826594,3813.7408243018162
Choke,9/26/2008,3000000,3830137,830137,3833.0585991790294
Danny Collins,3/19/2015,10000000,10835752,835752,3532.3564343044563
200 Cigarettes,2/26/1999,6000000,6852450,852450,5166.363636363636
Buffalo '66,1/20/1998,1500000,2375097,875097,5405.169857936998
The Opposite of Sex,5/22/1998,5000000,5879254,879254,5394.196319018405
Captain Fantastic,7/2/2016,5000000,5879736,879736,3656.0001329853553
Pumpkinhead,6/9/1988,3500000,4385516,885516,7504.372881355932
Halo Legends,2/16/2010,100000,1000000,900000,4135.440263565392
Бумер,8/2/2003,700000,1600000,900000,4875.406283856988
Love! Valour! Compassion!,5/16/1997,2000000,2900000,900000,5614.47286338116
The Gorgeous Hussy,8/28/1936,1119000,2019000,900000,64285.71428571428
Living Out Loud,10/30/1998,12000000,12902790,902790,5504.817073170731
Pelle Svanslös,12/25/1981,48740,955401,906661,9614.644750795334
Ninotchka,10/6/1939,1365000,2279000,914000,65285.71428571428
Cookie's Fortune,1/22/1999,10000000,10920544,920544,5596.012158054711
Aanrijding in Moscou,1/30/2008,560000,1500000,940000,4440.3924551118835
Cabin in the Sky,4/9/1943,662141,1606624,944483,54280.63218390805
In the Mouth of Madness,12/12/1994,8000000,8946600,946600,6323.3132932531735
Trois,2/11/2000,200000,1160268,960268,5655.288574793874
Howard the Duck,8/1/1986,37000000,37962774,962774,8776.426618049225
Jacob's Ladder,11/2/1990,25000000,25965144,965144,7213.333333333333
L.I.E. Long Island Expressway,1/20/2001,700000,1667192,967192,5501.660978384528
Tumbleweeds,11/28/1999,312000,1281176,969176,5758.6215092097445
Mrs Palfrey at The Claremont,11/25/2005,750000,1720953,970953,4933.704268292683
Laura,10/11/1944,1020000,2000000,980000,55367.23163841808
Robot Monster,6/25/1953,16000,1000000,984000,36716.41791044776
Shootout at Lokhandwala,5/25/2007,11000000,12000000,1000000,4799.569958531715
Hey Ram,2/18/2000,3900000,4900000,1000000,5841.121495327103
Willy Wonka & the Chocolate Factory,6/29/1971,3000000,4000000,1000000,24570.02457002457
The Train,9/21/1964,5800000,6800000,1000000,32154.34083601286
Dillinger,7/20/1973,1000000,2000000,1000000,22172.949002217294
Bad Lieutenant,9/16/1992,1000000,2019469,1019469,7189.4851904090265
Capone,4/16/1975,970000,2000000,1030000,19360.902255639096
Straw Dogs,12/29/1971,2200000,3251794,1051794,25591.094890510947
Two Girls and a Guy,9/7/1997,1000000,2057193,1057193,6558.269230769231
The Meddler,4/5/2016,3200000,4267218,1067218,4460.47621634951
Ultraviolet,3/3/2006,30000000,31070211,1070211,5356.411411411411
Graveyard Shift,10/26/1990,10500000,11582891,1082891,8093.3557548579965
Dazed and Confused,9/24/1993,6900000,7993039,1093039,7501.983527796843
Jersey Girl,3/25/2004,35000000,36098382,1098382,5842.45744680851
Madras Cafe,8/23/2013,5400000,6500000,1100000,4697.863326343482
Goodbye Pork Pie,2/5/1981,300000,1400000,1100000,12514.220705346985
Kama Sutra - A Tale of Love,9/11/1996,3000000,4109095,1109095,7028.485424588086
Re-Animator,10/18/1985,900000,2023414,1123414,10306.550458715596
Lights of New York,7/18/1928,75000,1200000,1125000,65789.47368421052
Mohenjo Daro,8/11/2016,15050000,16180000,1130000,4691.736316115076
Mary and Max,2/9/2009,590235,1725381,1135146,5349.592116610821
Pride and Glory,9/9/2008,30000000,31148328,1148328,5248.70762353565
The Raven,1/25/1963,350000,1499275,1149275,37805.09868421053
Tarnation,10/19/2003,218,1162014,1161796,6296.9972899729
Fifty Shades of Black,1/28/2016,20000000,21164799,1164799,4912.4629392984725
Shalako,11/6/1968,1455000,2620000,1165000,32909.60451977401
La isla mínima,9/25/2014,4000000,5169755,1169755,4926.674051206024
ATL,3/31/2006,20000000,21170563,1170563,5809.245657568238
House of Usher,6/21/1960,270000,1450000,1180000,39864.86486486486
Død snø,1/9/2009,800000,1984662,1184662,5610.709329695988
The Thin Man,5/25/1934,226408,1423000,1196592,89297.9104477612
Snow Flower and the Secret Fan,7/15/2011,134005,1332231,1198226,5303.715441612592
Kelly's Heroes,6/22/1970,4000000,5200000,1200000,30769.23076923077
Crossover,9/1/2006,5800000,7000000,1200000,5914.2434696895025
ലോഹം,8/20/2015,1050255,2250547,1200292,5044.4094223455
Swiss Army Man,6/24/2016,3000000,4210454,1210454,5030.395465199395
Mine vaganti,2/12/2010,7000000,8220215,1220215,5629.830073682413
Walking Tall,4/2/2004,56000000,57223890,1223890,6510.053191489362
Пиковая дама: Черный обряд,9/10/2015,1000000,2228115,1228115,5161.3398054172185
Atithi Tum Kab Jaoge,2/26/2010,3750000,5000000,1250000,5743.667032729712
Best Defense,7/20/1984,18000000,19265302,1265302,12108.153110047846
ഓം ശാന്തി ഓശാന,2/7/2014,220000,1500000,1280000,5451.889207389014
The Ballad of Cable Hogue,5/13/1970,3716946,5000000,1283054,33239.74093264248
To Die For,5/20/1995,20000000,21284514,1284514,8423.04262295082
Shopgirl,10/21/2005,10284523,11588205,1303682,6597.58097165992
"\"金陵十三�?\"\"A Westerner finds refuge with a group of women in a church during Japan's rape of Nanking in 1937. Posing as a priest\"",12/15/2011,94000000,95311434,1311434,5811.239320784147
Pinocchio,12/25/2002,40000000,41323171,1323171,7282.173913043479
Incarnate,12/1/2016,5000000,6341855,1341855,5557.900361178303
El Dorado,12/17/1966,4653000,6000000,1347000,40942.249240121586
After the Sunset,11/12/2004,60000000,61347797,1347797,7056.528795811519
Smoke,6/9/1995,7000000,8349430,1349430,8848.72131147541
Forbidden Planet,3/15/1956,1900000,3250000,1350000,50373.13432835821
Thief of Hearts,10/19/1984,9000000,10364904,1364904,12962.051282051283
The Last Temptation of Christ,8/12/1988,7000000,8373585,1373585,11542.731092436974
Outland,5/22/1981,16000000,17374595,1374595,15172.130242825608
Na Maloom Afraad,10/6/2014,884130,2259444,1375314,5792.429864424912
"\"花木�?\"\"When barbarian hordes threaten her homeland\"",11/26/2009,12000000,13380561,1380561,6392.995568398093
The Kid Stays in the Picture,1/18/2002,40000,1434436,1394436,7842.722159730033
But I'm a Cheerleader,9/12/1999,1200000,2600000,1400000,8338.296605122096
Sidewalks of New York,11/23/2001,1000000,2402459,1402459,7936.949632144879
The Powerpuff Girls Movie,7/3/2002,10000000,11411644,1411644,7838.112159911161
Touch of Evil,4/23/1958,829000,2247465,1418465,49081.833910034606
Somebody Up There Likes Me,7/3/1956,1920000,3360000,1440000,52554.744525547445
Murderball,7/22/2005,300000,1750211,1450211,7383.9663951120165
Mio fratello è figlio unico,4/20/2007,5000000,6463286,1463286,7036.754204155826
Lowriders,4/28/2017,916000,2403885,1487885,6079.625551110802
Queen Christina,12/26/1933,1114000,2610000,1496000,113333.33333333334
The Cowboys,1/13/1972,6000000,7500000,1500000,36496.3503649635
Spacehunter: Adventures in the Forbidden Zone,5/20/1983,15000000,16500000,1500000,15075.37688442211
Traitor,8/23/2008,22000000,23530831,1530831,6997.029019622183
The Charge of the Light Brigade,10/20/1936,1200000,2736000,1536000,109714.28571428571
King of New York,7/18/1990,1000000,2554476,1554476,11812.12765957447
Double Indemnity,4/24/1944,927262,2500000,1572738,89870.74285714286
The Gold Rush,6/25/1925,923000,2500000,1577000,89096.04519774011
My Beautiful Laundrette,9/7/1985,860000,2451545,1591545,14695.706371191136
3 Godfathers,12/1/1948,1243000,2841000,1598000,66307.05394190871
Trick,7/23/1999,450000,2049595,1599595,9572.681029323758
Kongens nei,9/29/2016,7500000,9100000,1600000,6618.982414191098
Dial M for Murder,5/29/1954,1400000,3000000,1600000,59479.55390334573
Cloclo,3/14/2012,27563396,29193330,1629934,7105.452674897119
Wolf Creek 2,8/30/2013,8000000,9630444,1630444,6963.27552114252
Whip It,9/13/2009,15000000,16633035,1633035,7561.432427802139
Night of the Living Dead,10/18/1990,4200000,5835247,1635247,12221.57698056801
Paws,9/25/1997,137731,1778391,1640660,10152.59900990099
Justice League: War,2/2/2014,3500000,5155325,1655325,7050.5066423603275
THX 1138,3/11/1971,777000,2437000,1660000,41500.0
Home Run,4/19/2013,1200000,2861020,1661020,7130.524372706004
Mata Hari,12/26/1931,558000,2227000,1669000,116713.28671328671
Another Earth,7/22/2011,100000,1776935,1676935,7402.21589529674
Beerfest,8/25/2006,17500000,19179969,1679969,8279.788072942336
Sankofa,5/28/1993,1000000,2691899,1691899,11716.752077562327
Paris Can Wait,9/12/2016,5000000,6700000,1700000,7041.436784465762
Swing Time,8/27/1936,886000,2600000,1714000,122428.57142857143
Justice League: The New Frontier,2/26/2008,3500000,5231128,1731128,8107.264621033308
Scarlet Street,12/28/1945,1202007,2948386,1746379,95954.89010989011
Ayurveda: Art of Being,9/20/2001,300000,2074000,1774000,9983.117613956107
An American in Paris,8/8/1951,2723903,4500000,1776097,68575.17374517374
Bounce,11/15/2000,35000000,36779296,1779296,10219.965537047674
Aliens vs Predator: Requiem,12/25/2007,40000000,41797066,1797066,8513.6725412166
"\"இறுதிச்சுற்ற�?\"\"A grumpy boxing coach takes on a young\"",1/28/2016,300000,2100000,1800000,7591.381251818769
The Pit and the Pendulum,8/12/1961,200000,2000000,1800000,60200.668896321076
Svinalängorna,12/10/2010,3000000,4800080,1800080,8212.830608771827
CHiPS,3/23/2017,25000000,26800152,1800152,7361.862230292323
Стиляги,12/25/2008,15000000,16810383,1810383,8574.203265085747
El Mariachi,9/4/1992,220000,2040920,1820920,12886.907289455059
The Green Inferno,9/4/2014,5000000,6833445,1833445,7702.54714722032
42nd Street,2/2/1933,439000,2281000,1842000,145039.37007874018
ആനന്ദം,10/21/2016,450000,2300000,1850000,7665.1212124978765
Atanarjuat,2/1/2002,1934000,3786801,1852801,10420.70303712036
Jackson County Jail,3/31/1976,445000,2300000,1855000,33065.95365418895
The Guilt Trip,12/19/2012,40000000,41863726,1863726,8093.303804064617
Grand Hotel,5/25/1932,700000,2594000,1894000,139264.70588235295
Elegy,8/8/2008,13000000,14894347,1894347,8646.590836475174
Stargate: The Ark of Truth,3/11/2008,7000000,8900000,1900000,8898.130455958937
Night of the Demons,10/14/1988,1200000,3109904,1909904,15889.384359400998
Bolero,8/31/1984,7000000,8914881,1914881,18236.961904761905
I Was a Teenage Werewolf,6/19/1957,82000,2000000,1918000,67773.851590106
Shanghai Noon,5/26/2000,55000000,56932305,1932305,11208.265661252899
Курочка Ряба,10/1/1994,2700000,4635143,1935143,12944.10033444816
La peggior settimana della mia vita,10/27/2011,11000000,12935800,1935800,8556.778499756885
The Adventures of Robin Hood,5/13/1938,2033000,3981000,1948000,138156.02836879433
А зори здесь тихие...,4/30/2015,3300000,5249225,1949225,8196.736822186245
El espinazo del diablo,4/20/2001,4500000,6459020,1959020,11024.310635903208
In a World...,8/9/2013,1000000,2963902,1963902,8397.157480213958
Grease 2,6/11/1982,13200000,15171476,1971476,20324.494845360823
Wild Child,1/1/2008,20000000,21972336,1972336,9344.021224180406
Warlords of the 21st Century,1/1/1982,1000000,3000000,2000000,21208.907741251325
Aadukalam,1/14/2011,4000000,6000000,2000000,9081.70354595115
Alexander's Ragtime Band,5/24/1938,2000000,4000000,2000000,141843.97163120567
The Miracle Worker,5/22/1962,500000,2500000,2000000,66225.16556291391
She Done Him Wrong,2/9/1933,200000,2200000,2000000,157480.31496062994
Metegol,7/18/2013,22000000,24000000,2000000,8551.503568114864
Topaz,12/18/1969,4000000,6000000,2000000,52910.05291005292
Case 39,8/13/2009,27000000,29000000,2000000,9266.38064438411
Suffragette,10/16/2015,14000000,16002420,2002420,8437.06812283008
The Gift,12/22/2000,10000000,12008642,2008642,11471.399200456883
Phoonk,8/22/2008,750000,2760000,2010000,9187.185476019618
Raising Victor Vargas,5/16/2002,800000,2816116,2016116,11206.870483602
Laws of Attraction,4/4/2004,28000000,30016165,2016165,10724.281914893618
Dil Chahta Hai,7/24/2001,2079000,4099000,2020000,11380.281690140846
Bronson,10/9/2008,230000,2260712,2030712,9376.570486625757
Desert Hearts,10/1/1985,350000,2400000,2050000,18859.24563017479
The To Do List,7/24/2013,1500000,3566225,2066225,8834.665230014067
Firestarter,5/11/1984,15000000,17080167,2080167,20117.66924564797
Godzilla 1985,12/15/1984,2000000,4100000,2100000,19943.019943019943
Pocketful of Miracles,12/18/1961,2900000,5000000,2100000,70000.0
Battle for Terra,9/6/2007,4000000,6101046,2101046,10077.442563192479
Babylon A.D.,8/20/2008,70000000,72108608,2108608,9637.89691155163
Frailty,11/17/2001,11000000,13110448,2110448,11943.678551216752
The Eagle,2/8/2011,25000000,27122040,2122040,9588.584287127953
Prom,4/29/2011,8000000,10130000,2130000,9426.280292435964
Beginners,9/11/2010,3200000,5332926,2132926,9764.401045600831
C.H.U.D.,8/31/1984,1250000,3412497,2162497,20595.209523809524
The Marine,10/13/2006,20000000,22165608,2165608,10731.456888007928
Glyanets,8/23/2007,2500000,4684165,2184165,10476.11396230035
Fair Game,5/20/2010,22000000,24188922,2188922,10042.538939738031
I Think I Love My Wife,3/16/2007,11000000,13196245,2196245,10625.997890519919
ആക്ഷ�?ഹീറോ ബിജു,2/4/2016,300000,2500000,2200000,9278.35486333405
Lucas,3/28/1986,6000000,8200000,2200000,20257.826887661144
Hunting Elephants,7/3/2013,2300000,4500000,2200000,9417.969485778865
హ్యాపీ డేస్,9/28/2007,440141,2640850,2200709,10532.933529884749
Dead Silence,3/16/2007,20000000,22217407,2217407,10728.385086556418
Reign Over Me,3/23/2007,20000000,22222308,2222308,10752.09738443823
Drugstore Cowboy,9/9/1989,2500000,4729352,2229352,17834.816
Dark Angel,1/26/1990,7000000,9229401,2229401,17417.1953125
Force 10 from Navarone,11/1/1978,5000000,7230000,2230000,33086.053412462905
This Is Spinal Tap,5/4/1984,2500000,4736202,2236202,21626.711798839457
Tentacoli,2/25/1977,750000,3000000,2250000,37815.12605042017
Badmaa$h Company,5/7/2010,6250000,8500000,2250000,10312.68047190826
The Kid,1/21/1921,250000,2500000,2250000,122282.60869565219
Labor Day,12/27/2013,18000000,20275812,2275812,9729.184835582004
Sugar & Spice,1/24/2001,11000000,13276953,2276953,12951.951080773606
Hard Times,9/4/1975,2700000,5000000,2300000,42124.542124542124
The Fly,7/16/1958,700000,3000000,2300000,79584.7750865052
Superman IV: The Quest for Peace,7/23/1987,17000000,19300000,2300000,20104.895104895102
Jab We Met,10/26/2007,2300000,4600000,2300000,10943.15743397232
風の谷のナウシカ,3/11/1984,1000000,3301446,2301446,22431.247563352827
K-PAX,10/22/2001,48000000,50315140,2315140,13050.394588500563
Evil Dead II,3/13/1987,3600000,5923044,2323044,20722.961641391616
Tasogare Seibei,11/2/2002,5000000,7338987,2338987,12901.19691119691
Year One,6/18/2009,60000000,62357900,2357900,10949.101699086608
Woodlawn,10/15/2015,12000000,14394097,2394097,10066.082795852639
Torrente 5: Operación Eurovegas,10/3/2014,9272437,11672363,2399926,10107.80304338487
A Rage in Harlem,5/3/1991,8000000,10400000,2400000,17699.11504424779
Boys on the Side,2/3/1995,21000000,23450000,2450000,16235.917826375082
Oh Boy,7/3/2012,300000,2750275,2450275,10695.033696487184
Xanadu,8/8/1980,20000000,22471595,2471595,29671.008403361346
The Circle,4/27/2017,18000000,20497844,2497844,10206.404530651771
From Prada to Nada,1/28/2011,93,2500000,2499907,11296.002421953017
Khatta Meetha,7/23/2010,7500000,10000000,2500000,11451.500604639232
Mean Streets,10/2/1973,500000,3000000,2500000,54824.56140350877
Disturbing Behavior,7/24/1998,15000000,17507368,2507368,15344.969400244798
Mutiny on the Bounty,11/8/1935,1950000,4460000,2510000,181884.0579710145
Bound,9/13/1996,4500000,7011317,2511317,15914.55640050697
Bad Day at Black Rock,1/7/1955,1271000,3788000,2517000,94269.66292134831
My Old Lady,9/9/2014,5000000,7527232,2527232,10617.2389310636
Sleepless,1/12/2017,30000000,32540674,2540674,10462.380424890565
Blue Velvet,8/1/1986,6000000,8551228,2551228,23256.408386508658
Pizza,10/19/2012,240000,2800000,2560000,11119.750153113748
The Sweeney,9/11/2012,3730500,6294161,2563661,11078.580163953553
The Thirteenth Floor,4/16/1999,16000000,18564088,2564088,15427.725631768953
Top Hat,9/6/1935,609000,3202000,2593000,189270.07299270073
Broadway Danny Rose,1/27/1984,8000000,10600497,2600497,25395.478515625
Thirteen,8/20/2003,2000000,4601043,2601043,14044.508639308857
Carnage,9/16/2011,25000000,27603069,2603069,11496.588213990752
I'm No Angel,10/6/1933,225000,2850000,2625000,198863.63636363638
The Boondock Saints II: All Saints Day,11/24/2009,8000000,10629321,2629321,12175.657215361034
Locke,4/10/2014,2000000,4635300,2635300,11116.032260241614
Ice Princess,3/17/2005,25000000,27645491,2645491,13594.50668036999
10 to Midnight,3/11/1983,4520000,7175592,2655592,27125.55669050051
Rough Cut,6/19/1980,14000000,16656125,2656125,32117.593712212816
Marty,4/11/1955,343000,3000000,2657000,99513.10861423222
Dirty Dancing: Havana Nights,2/27/2004,25000000,27685016,2685016,14327.726787620064
Jack the Giant Slayer,2/27/2013,195000000,197687603,2687603,11546.02552701559
Central do Brasil,1/16/1998,2900000,5596708,2696708,16656.627547869055
Parrish,5/4/1961,1500000,4200000,2700000,90604.02684563758
The Big Red One,5/28/1980,4500000,7206220,2706220,32723.33736396614
Legok na Pomine,2/27/2014,2153912,4864560,2710648,11471.554383752375
Watership Down,10/14/1978,1000000,3713768,2713768,40443.63636363637
Italiano medio,1/29/2015,1816720,4541800,2725080,11609.819275568545
A Guy Named Joe,3/1/1944,2627000,5363000,2736000,157241.37931034484
Tadpole,11/1/2002,150000,2891288,2741288,15120.176503033645
Aquí Entre Nos,3/30/2012,1,2755584,2755583,11976.369602538192
Boiler Room,2/18/2000,26000000,28780255,2780255,16239.807242990655
Ostrov Vezeniya,12/5/2013,2000000,4803665,2803665,12030.367004363889
Agent Cody Banks 2: Destination London,6/24/2004,26000000,28818995,2818995,14883.81731784583
The Conversation,4/7/1974,1600000,4420000,2820000,58750.0
Office Space,2/19/1999,10000000,12827813,2827813,17138.260606060605
Extract,9/3/2009,8000000,10848783,2848783,13190.703295380355
Son of Rambow,1/22/2007,4000000,6870249,2870249,14104.486999936118
Requiem for a Dream,10/27/2000,4500000,7390108,2890108,16600.275703618612
Vamp,7/18/1986,1900000,4790926,2890926,26353.017319963536
कट्यार काळजात घुसली,11/12/2015,1500000,4400000,2900000,12218.963831867057
लगान,6/15/2001,5200000,8100000,2900000,16292.134831460675
The Magnificent Seven,10/22/1960,2000000,4905000,2905000,97483.22147651007
Never Die Alone,3/26/2004,3000000,5923000,2923000,15547.872340425532
A Mighty Heart,1/1/2007,16000000,18928871,2928871,14469.562682791875
Armored,12/4/2009,20000000,22942221,2942221,13624.610440428063
The Legend of Bhagat Singh,6/7/2002,3000000,6000000,3000000,16675.93107281823
3 Strikes,3/1/2000,6000000,9000000,3000000,17523.36448598131
Sylvia,10/17/2003,7000000,10000000,3000000,16260.162601626016
La lengua de las mariposas,9/24/1999,3000000,6000000,3000000,17835.9096313912
Serbuan maut,9/8/2011,1100000,4105187,3005187,13245.185971995115
Return of the Living Dead Part II,1/15/1988,6200000,9205924,3005924,25980.328435609335
Machete Kills,9/12/2013,12000000,15008161,3008161,12847.208401487942
Confessions of a Dangerous Mind,12/30/2002,30000000,33013805,3013805,16586.708860759496
Confessions of a Dangerous Mind,12/30/2002,30000000,33013805,3013805,16586.708860759496
Catfish,9/17/2010,30000,3045943,3015943,13789.62649340911
Harry Brown,11/11/2009,7300000,10329747,3029747,14005.209633430406
Before Sunrise,1/27/1995,2500000,5535405,3035405,20115.341285619616
Transcendence,4/16/2014,100000000,103039258,3039258,12775.359394703657
The Proposition,10/6/2005,2000000,5048693,3048693,15304.68373493976
The Score,7/13/2001,68000000,71069884,3069884,17295.121126760565
Your Sister's Sister,9/11/2011,125000,3200000,3075000,13552.882687128948
Beasts of No Nation,9/11/2015,6000000,9077700,3077700,12934.50167055412
Shut In,11/11/2016,10000000,13082071,3082071,12769.97178406732
Titanic,4/11/1953,1805000,4905000,3100000,116541.35338345864
Zohi Sdom,8/5/2010,2745000,5850000,3105000,14222.763750961925
Clerks,9/13/1994,27000,3151130,3124130,20911.178045515393
Cheetah,8/18/1989,5000000,8153677,3153677,25229.416
Pi,7/10/1998,60000,3221152,3161152,19369.80392156863
Born into Brothels,12/8/2004,350000,3515061,3165061,16631.95480819758
Shortbus,5/20/2006,2000000,5179037,3179037,15667.999014292755
The Machinist,2/9/2004,5000000,8203235,3203235,17203.195488721805
The Wash,11/16/2001,7000000,10229331,3229331,18275.78381437465
Dabba,9/19/2013,1000000,4235151,3235151,13852.307468336003
Sunset Boulevard,8/10/1950,1752000,5000000,3248000,133662.5514403292
The Derby Stallion,7/4/2005,750000,4000000,3250000,16632.548618219036
Brother,9/9/2000,12000000,15250000,3250000,18710.42026482441
Safety Not Guaranteed,6/8/2012,750000,4007792,3257792,14196.533000984844
Paris is Burning,3/13/1990,500000,3779620,3279620,25482.672882672883
Like Crazy,10/28/2011,250000,3542353,3292353,14553.122927993636
The Last Godfather,12/29/2010,13400000,16700000,3300000,14984.810850819396
Four Lions,5/7/2010,967686,4270000,3302314,15135.870711070776
Samyy Luchshiy Film 3-DE,1/19/2011,6500000,9816332,3316332,14985.075166396306
The Texas Chainsaw Massacre 2,8/22/1986,4700000,8025872,3325872,30180.32667876588
Get on the Bus,10/16/1996,2400000,5731103,3331103,21003.171500630517
The Box,9/17/2009,30000000,33333531,3333531,15420.377746013684
The Shawshank Redemption,9/23/1994,25000000,28341469,3341469,22350.963210702343
Tutto tutto niente niente,11/30/2012,5579750,8927600,3347850,14581.164716181549
Diary of the Dead,9/8/2007,2000000,5364858,3364858,16139.181735335027
Suspicion,11/14/1941,1103000,4500000,3397000,220584.41558441558
Human Traffic,6/4/1999,600000,4000000,3400000,20457.280385078222
�?깡패 같은 애인,5/20/2010,800000,4214668,3414668,15666.129883238134
Brick,1/30/2005,475000,3919254,3444254,17957.528675703856
My Life in Ruins,2/6/2009,17000000,20455276,3455276,16283.647434175491
Piranha 3DD,5/11/2012,5000000,8493728,3493728,15202.349716075974
피에타,9/5/2012,103000,3623330,3520330,15212.72044493036
La science des rêves,2/11/2006,6000000,9524340,3524340,17736.990437846
Kidnap,8/4/2017,21000000,24527158,3527158,14366.130523503272
12,6/6/2007,4000000,7537453,3537453,16978.25314851789
Matchstick Men,9/1/2003,62000000,65565672,3565672,19253.088552915768
For Me and My Gal,10/21/1942,802000,4371000,3569000,212440.47619047618
Smart People,4/11/2008,7000000,10569964,3569964,16618.16472165457
Consenting Adults,10/16/1992,18000000,21591728,3591728,25293.859154929578
Rob Roy,4/13/1995,28000000,31596911,3596911,23679.46675444371
99,5/15/2009,3000000,6600000,3600000,16833.75729462816
Eastern Promises,9/14/2007,51500000,55112356,3612356,17326.279437862726
F.C. De Kampioenen: Kampioen zijn blijft plezant,12/17/2013,3849796,7471304,3621508,15482.087586997042
Poltergeist III,6/10/1988,10500000,14144000,3644000,30881.35593220339
Joysticks,3/4/1983,300000,3952448,3652448,37307.94688457609
A Monster Calls,10/7/2016,43000000,46652768,3652768,15111.004471949993
The Raven,3/9/2012,26000000,29657751,3657751,15945.416579479668
Left Behind,10/3/2014,16000000,19682924,3682924,15511.42427547982
Used Cars,7/11/1980,8000000,11715321,3715321,44925.28415961306
Scaramouche,5/8/1952,3005000,6746000,3741000,141704.54545454547
Monsters,6/18/2010,500000,4242978,3742978,17168.757539757167
54,8/28/1998,13000000,16757163,3757163,22965.54400977995
Stop Making Sense,11/16/1984,1200000,4978922,3778922,35887.19848053181
She Wore a Yellow Ribbon,10/22/1949,1600000,5400000,3800000,159663.86554621847
Woman Thou Art Loosed,9/30/2004,3000000,6804016,3804016,19926.746987951807
The Next Karate Kid,7/18/1994,12000000,15826984,3826984,25684.456375838927
Draft Day,4/11/2014,25000000,28831145,3831145,16160.259330498751
The Spanish Prisoner,9/8/1997,10000000,13835130,3835130,23791.129032258064
The Lords of Flatbush,5/1/1974,160000,4000000,3840000,79012.34567901235
Knock Knock,6/26/2015,2500000,6341684,3841684,16097.295666529788
Il peggior Natale della mia vita,12/22/2012,6843500,10703234,3859734,16761.047420531526
Cat People,12/5/1942,134000,4000000,3866000,228757.39644970416
American History X,10/30/1998,20000000,23875127,3875127,23628.823170731706
Donovan's Reef,6/12/1963,2686000,6600000,3914000,127908.49673202613
Crazy/Beautiful,6/29/2001,13000000,16929123,3929123,22135.90422535211
The Air Up There,1/7/1994,17080000,21011500,3931500,26891.244870041042
Lovely & Amazing,8/31/2001,250000,4186931,3936931,22080.37577117218
Next of Kin,10/20/1989,12000000,15942628,3942628,31315.552025416997
Armed and Dangerous,8/15/1986,12000000,15945534,3945534,35966.58158614403
Harsh Times,9/11/2005,2000000,5967038,3967038,19954.919517102615
San Francisco,6/26/1936,1300000,5273000,3973000,285827.3381294964
Blood Feast,6/6/1963,24500,4000000,3975500,129918.30065359476
The Broadway Melody,2/8/1929,379000,4358000,3979000,232690.05847953213
Il Divo,5/23/2008,7275000,11260366,3985366,18213.404017092063
"\"அலைபாயுத�?\"\"After a difficult romance in a class-divided society\"",4/14/2000,2000000,6000000,4000000,23350.84646818447
Sarkar,7/1/2005,1900000,5900000,4000000,20470.829068577277
Wazir,1/7/2016,5200000,9200000,4000000,16883.621199074776
Bommarillu,8/9/2006,1333333,5333333,4000000,19617.4595389897
The Green Berets,7/4/1968,7000000,11000000,4000000,114613.18051575932
Romanzo criminale,9/30/2005,818418,4851244,4032826,20245.11044176707
Ghosts of the Abyss,4/10/2003,13000000,17040871,4040871,21985.152339499455
Hell's Angels,11/15/1930,3950000,8000000,4050000,246951.21951219515
Bug,5/19/2006,4000000,8059140,4059140,20005.618531296204
The Perfect Weapon,3/15/1991,10000000,14061361,4061361,30084.155555555557
Tora! Tora! Tora!,1/26/1970,25485000,29548291,4063291,106928.71052631579
Loose Cannons,2/9/1990,1500000,5585154,4085154,31915.265625
New Nightmare,10/13/1994,14000000,18090181,4090181,27359.07023411371
Cinderfella,12/18/1960,3000000,7100000,4100000,137583.89261744966
Filth,9/23/2013,5000000,9114264,4114264,17616.503815094242
Let Me In,10/1/2010,20000000,24145613,4145613,18954.753075976972
The Bling Ring,6/12/2013,15000000,19145732,4145732,17754.436754830753
Tuck Everlasting,10/11/2002,15000000,19158074,4158074,22934.77109762824
�?காதல�?கண்மணி,4/17/2015,940000,5100000,4160000,17493.32436239776
It Happened One Night,2/22/1934,325000,4500000,4175000,313909.7744360902
Mildred Pierce,9/24/1945,1453000,5638000,4185000,231215.46961325966
Charlie St. Cloud,5/1/2010,44000000,48190704,4190704,19207.729468599035
Masterminds,9/29/2016,25000000,29200000,4200000,17374.828837251633
The Misfits,1/1/1961,4000000,8200000,4200000,140939.59731543623
Expelled: No Intelligence Allowed,4/18/2008,3500000,7700000,4200000,19387.71741940249
Bernie,4/27/2012,5000000,9206470,4206470,18303.722559449994
Half Nelson,8/11/2006,700000,4911725,4211725,20655.83619421285
Man on a Ledge,1/13/2012,42000000,46221189,4221189,18623.02958109986
Hardware,9/14/1990,1500000,5728953,4228953,31868.522984174833
Annie Get Your Gun,5/17/1950,3768785,8000000,4231215,177782.14285714284
Billu,2/13/2009,5750000,10000000,4250000,20028.93592154312
Bad News Bears,7/22/2005,30000000,34252847,4252847,21654.00712830957
Trance,3/27/2013,20000000,24261569,4261569,18326.885447531728
Phantasm II,7/8/1988,3000000,7282851,4282851,36142.20253164557
Swingers,10/18/1996,200000,4505922,4305922,27149.57124842371
The Railway Man,12/26/2013,18000000,22309223,4309223,18422.09596607329
Hardcore Henry,9/12/2015,10000000,14333790,4333790,18213.410662127804
Furry Vengeance,4/2/2010,35000000,39340177,4340177,19908.246907237775
Troll,1/17/1986,1100000,5450815,4350815,39806.17566331199
The Spectacular Now,8/2/2013,2500000,6854611,4354611,18619.23575212612
Rapid Fire,7/24/1992,10000000,14356479,4356479,30918.942512420155
W.,10/17/2008,25100000,29506464,4406464,20743.62245498411
The Virgin Suicides,4/21/1999,6000000,10409377,4409377,26530.54753309266
Mermaids,12/14/1990,31000000,35419397,4419397,33029.87294469357
Seven Psychopaths,9/7/2012,15000000,19422261,4422261,19110.316455422697
Steve Jobs,10/9/2015,30000000,34441873,4441873,18676.044198151685
Company,4/15/2002,1500000,6000000,4500000,25027.808676307006
It's Alive,8/15/2008,11000000,15500000,4500000,20539.879316797967
Zulu,1/22/1964,3500000,8000000,4500000,145631.06796116504
Speed 2: Cruise Control,6/13/1997,160000000,164508066,4508066,28122.682470368058
Den Skaldede Frisør,9/4/2012,5500000,10016934,4516934,19519.435453551534
Self/less,7/10/2015,26000000,30523226,4523226,18953.070135007165
Bathing Beauty,7/1/1944,2361000,6892000,4531000,255988.70056497178
An Ideal Husband,4/15/1999,14000000,18535191,4535191,27287.551143200966
Paris,1/19/2008,19000000,23550000,4550000,21493.38901144582
An American Werewolf in Paris,12/25/1997,22000000,26570463,4570463,28282.568069306933
Jodhaa Akbar,2/15/2008,8376800,13000000,4623200,21839.172764333256
Boys and Girls,6/16/2000,16000000,20627372,4627372,26778.773148148146
Monty Python and the Holy Grail,3/13/1975,400000,5028948,4628948,87835.82542694497
The Thing,6/25/1982,15000000,19629760,4629760,47484.717948717946
PEEPLI [Live],8/13/2010,2270000,6900000,4630000,21208.179119791857
Singin' in the Rain,4/10/1952,2540800,7200000,4659200,176484.84848484848
新少林寺,1/20/2011,29000000,33662874,4662874,21069.51818498118
Bon Cop Bad Cop,7/6/2006,8000000,12671300,4671300,22954.791154791154
The Babadook,5/22/2014,2000000,6676471,4676471,19620.760836273774
The Kid,7/7/2000,65000000,69700000,4700000,27199.074074074073
Rebecca,4/12/1940,1288000,6000000,4712000,336571.4285714286
Alive,1/15/1993,32000000,36733909,4733909,33197.11781206171
Take the Lead,3/17/2006,30000000,34742066,4742066,23533.82630272953
How Green Was My Valley,10/28/1941,1250000,6000000,4750000,308441.55844155845
Moon,6/12/2009,5000000,9760104,4760104,22068.884942951325
Бой с Тенью,3/5/2005,3500000,8262833,4762833,24639.591308846353
പ്രേമം,5/29/2015,6200000,11000000,4800000,20114.147788700877
The Man Who Shot Liberty Valance,4/22/1962,3200000,8000000,4800000,158940.3973509934
Recep İvedik,2/22/2008,500000,5330000,4830000,22619.984264358773
Altered States,12/25/1980,15000000,19853892,4853892,55791.862068965514
Marnie,7/9/1964,2135161,7000000,4864839,156425.69131832797
Grudge Match,12/25/2013,40000000,44907260,4907260,20978.7274064194
Macabre,10/1/1958,90000,5000000,4910000,169896.1937716263
The Crow: City of Angels,8/29/1996,13000000,17917287,4917287,31161.51457541191
Jackie,12/2/2016,9000000,13960394,4960394,20545.718877365056
24,5/5/2016,10000000,15000000,5000000,20813.473810405903
Raging Bull,11/14/1980,18000000,23000000,5000000,58479.53216374269
Igor,9/19/2008,25000000,30000000,5000000,23086.903722994095
Admission,3/21/2013,13000000,18000000,5000000,21502.50934284031
Hang 'em High,7/31/1968,1800000,6800000,5000000,142857.14285714287
Dracula 2000,12/22/2000,28000000,33000337,5000337,28557.03597944032
Before I Fall,3/2/2017,5000000,10025571,5025571,20613.414218973674
Wild at Heart,5/1/1990,9500000,14560247,5060247,39165.99845201239
Miss Potter,12/3/2006,30000000,35078241,5078241,25164.722497522296
Ben-Hur: A Tale of the Christ,12/30/1925,3900000,9000000,5100000,284916.2011173185
Captain Corelli's Mandolin,8/17/2001,57000000,62112895,5112895,28675.799214806502
Godsend,4/30/2004,25000000,30114487,5114487,27046.46747752512
Mulholland Drive,5/16/2001,15000000,20117339,5117339,28749.095505617977
We Are Your Friends,8/26/2015,6000000,11122090,5122090,21526.361133875474
Blade Runner,6/25/1982,28000000,33139618,5139618,52714.03076923077
Бой с тенью 2: Реванш,10/18/2007,6000000,11171900,5171900,24607.354753374537
The Ant Bully,7/27/2006,50000000,55181129,5181129,25410.14713094654
Zwartboek,9/1/2006,21000000,26193068,5193068,25594.2237555446
Blast from the Past,2/12/1999,35000000,40263020,5263020,31994.042553191488
Max Keeble's Big Move,10/5/2001,12000000,17292381,5292381,29782.67304445695
Assault on Precinct 13,1/19/2005,30000000,35294470,5294470,27604.1188738269
"#Pellichoopulu",7/29/2016,200000,5500000,5300000,22005.48891629195
Secretary,1/11/2002,4000000,9304609,5304609,29952.619988706945
Bluffmaster!,1/1/2005,1823152,7133082,5309930,27844.41531200839
Layer Cake,9/30/2004,6500000,11850214,5350214,28026.265060240963
Снежная королева,10/11/2012,7000000,12400000,5400000,23344.587730257612
The Girl Next Door,4/9/2004,25000000,30411183,5411183,28782.88829787234
Cien años de perdón,3/3/2016,6700000,12118661,5418661,22754.862849176086
Voyage to the Bottom of the Sea,7/12/1961,1580000,7000000,5420000,180666.66666666666
Moms' Night Out,3/25/2014,5000000,10429707,5429707,22903.198184517783
Out of Time,10/3/2003,50000000,55495563,5495563,29705.745945945946
Spellbound,12/28/1945,1500000,7000000,5500000,302197.80219780223
Country Strong,12/22/2010,15000000,20529194,5529194,25107.25037802591
Atlantic City,9/2/1980,7200000,12729678,5529678,65829.5
Only God Forgives,5/30/2013,4800000,10337387,5537387,23714.313245169247
Tau man ji D,5/12/2005,1549000,7096000,5547000,28533.95061728395
Patriots Day,12/12/2016,45000000,50548152,5548152,22980.18489678253
Keanu,4/21/2016,15000000,20566327,5566327,23170.92024693105
The Hustler,9/25/1961,2000000,7600000,5600000,186666.66666666666
Belle,9/8/2013,10900000,16505460,5605460,23939.713601168485
Lyubov V Bolshom Gorode,3/5/2009,3500000,9112193,5612193,26384.370195901443
Nebraska,9/21/2013,12000000,17654912,5654912,24213.26847815848
Eye in the Sky,9/11/2015,13000000,18704595,5704595,23974.426863350775
Arthur,4/8/2011,40000000,45735397,5735397,25501.307212791122
Lola rennt,8/20/1998,1530000,7267585,5737585,35070.81295843521
Ringmaster,11/25/1998,3500000,9247881,5747881,35069.43868212325
ना तु�?जानो ना हम,5/9/2002,350000,6100000,5750000,31979.977753058953
Aitraaz,11/12/2004,3500000,9250000,5750000,30104.712041884817
La migliore offerta,1/1/2013,13500000,19255873,5755873,24995.105957964217
Unforgettable,4/20/2017,12000000,17768012,5768012,23568.59107680615
Le scaphandre et le papillon,5/22/2007,14000000,19777647,5777647,27730.220972200892
You Can't Take It With You,8/23/1938,1644736,7433101,5788365,410522.3404255319
The Long Riders,5/12/1980,10000000,15795189,5795189,70845.83129584353
This Is England,9/12/2006,2380000,8176544,5796544,28568.477082306556
Bad Dreams,4/8/1988,4000000,9797098,5797098,49505.53373185312
Heropanti,5/23/2014,4200000,10000000,5800000,24334.677334765445
Vampire in Brooklyn,10/26/1995,14000000,19800000,5800000,37760.41666666667
Strangers on a Train,6/18/1951,1200000,7000000,5800000,223938.22393822396
Gentleman's Agreement,11/11/1947,2000000,7800000,5800000,251082.25108225108
Alan Partridge: Alpha Papa,7/24/2013,4000000,9800000,5800000,24799.360347533104
The Trouble with Harry,10/3/1955,1200000,7000000,5800000,215613.38289962825
La vie d'Adèle - Chapitres 1 et 2,10/9/2013,4300000,10165694,5865694,25115.797316160413
Unleashed,2/2/2005,45000000,50871113,5871113,30610.599582898853
Inside Job,10/8/2010,2000000,7871522,5871522,26846.029692150827
The Andromeda Strain,3/12/1971,6500000,12376563,5876563,146914.075
Moby Dick,6/27/1956,4500000,10400000,5900000,215328.46715328467
Family Plot,4/9/1976,2000000,7900000,5900000,105169.34046345811
Kids,7/28/1995,1500000,7412216,5912216,38667.20732504905
The Rainmaker,11/18/1997,40000000,45916769,5916769,36681.76689398636
Vixen!,10/15/1968,76000,6000000,5924000,167818.6968838527
喜宴,8/4/1993,1000000,6933459,5933459,40976.926795580104
Caligola,1/21/1979,17500000,23438120,5938120,85935.16642547034
Tot yeshchyo Karloson!,3/15/2012,4000000,9938268,5938268,25886.98821231778
Jason X,7/24/2001,11000000,16951798,5951798,33531.25633802817
The Light Between Oceans,9/2/2016,20000000,25956113,5956113,24670.34892390278
Zoolander 2,2/6/2016,50000000,55969000,5969000,25173.863717836794
She's the One,8/26/1996,3500000,9482579,5982579,37912.4144486692
Pink Flamingos,3/12/1972,12000,6000000,5988000,144637.6811594203
A Patch of Blue,12/10/1965,800000,6792000,5992000,188427.67295597485
Red Heat,6/17/1988,29000000,34994648,5994648,50587.74683544304
Beremennyy,7/21/2011,2000000,8000000,6000000,26484.804343507913
Silent Rage,4/2/1982,4500000,10500000,6000000,63224.446786090615
Witness for the Prosecution,12/17/1957,3000000,9000000,6000000,209790.20979020977
Tales from the Hood,5/24/1995,6000000,12000000,6000000,39344.262295081964
Flicka,10/20/2006,15000000,21000000,6000000,29776.67493796526
Red River,8/26/1948,3000000,9012000,6012000,245387.75510204083
Punchline,10/7/1988,15000000,21032267,6032267,50185.24958402662
Next,4/24/2007,70000000,76066841,6066841,29174.65820946482
Hard Candy,1/14/2005,950000,7022209,6072209,31841.68327215522
Children of the Corn II: The Final Sacrifice,1/29/1993,900000,6980986,6080986,42494.66107617051
After Hours,9/13/1985,4500000,10609321,6109321,56411.08956602032
Narc,1/14/2002,6500000,12633747,6133747,34634.3704121965
Hombre,3/21/1967,5860000,12000000,6140000,185498.48942598185
Mo' Better Blues,8/3/1990,10000000,16153593,6153593,46759.82522796353
Larry Crowne,6/30/2011,30000000,36160375,6160375,27267.70743885058
A Streetcar Named Desire,9/18/1951,1800000,8000000,6200000,236641.2213740458
Parasite,3/12/1982,800000,7000000,6200000,65608.4656084656
To Catch a Thief,8/3/1955,2500000,8750000,6250000,233208.9552238806
Pat Garrett & Billy the Kid,5/23/1973,4638783,11000000,6361217,143918.9366515837
The Dressmaker,10/1/2015,11930000,18340000,6410000,26951.1179878741
Get Rich or Die Tryin',11/9/2005,40000000,46442528,6442528,32603.886639676115
Cavalcade,2/8/1933,1180280,7630000,6449720,507851.968503937
The Drop,9/12/2014,12600000,19054534,6454534,27116.358793602514
It's a Wonderful Life,12/20/1946,3180000,9644124,6464124,300656.93023255817
Fantastic Mr. Fox,10/23/2009,40000000,46471023,6471023,29912.73979568252
Mujeres al borde de un ataque de nervios,3/14/1988,700000,7179298,6479298,55616.291845493564
Grandma,6/4/2015,600000,7087452,6487452,27185.326729188142
War and Peace,8/21/1956,6000000,12500000,6500000,237226.2773722628
Чёрная Молния,12/31/2009,15000000,21500000,6500000,29997.18487957284
Carlito's Way,11/10/1993,30000000,36516012,6516012,44691.4403292181
In the Valley of Elah,8/31/2007,23000000,29541790,6541790,31376.996498633027
Torque,1/16/2004,40000000,46546197,6546197,35156.8045112782
Roger & Me,9/1/1989,160000,6706368,6546368,52370.944
I Don't Know How She Does It,9/16/2011,24000000,30551495,6551495,28935.01486169569
Scenes from a Mall,2/22/1991,3000000,9563393,6563393,48617.72592592592
Death on the Nile,10/6/1978,7920000,14560084,6640084,98958.03278688525
Halloween 5: The Revenge of Michael Myers,10/12/1989,5000000,11642254,6642254,52884.18789808918
The Spitfire Grill,8/23/1996,6000000,12643776,6643776,42102.50950570342
Dogville,5/19/2003,10000000,16680836,6680836,36368.18726183996
Gitler kaput!,9/18/2008,3000000,9713500,6713500,30998.78562886417
Murder by Numbers,4/19/2002,50000000,56714147,6714147,37342.30812013348
Los amantes pasajeros,3/8/2013,5000000,11724119,6724119,28887.022979469268
Starman,12/13/1984,22000000,28744356,6744356,64048.9648622982
Nocturnal Animals,11/4/2016,22500000,29252978,6752978,27979.672927206208
Diana,9/19/2013,15000000,21766271,6766271,28971.89846968049
Låt den rätte komma in,1/26/2008,4000000,10785801,6785801,32054.9144279688
Once Bitten,11/15/1985,3200000,10000000,6800000,62385.321100917434
Sands of Iwo Jima,12/14/1949,1000000,7800000,6800000,288135.593220339
La Pianiste,5/14/2001,3000000,9801375,6801375,38274.47945976365
House of the Dead,4/11/2003,7000000,13818181,6818181,37095.65288356909
Kismat Konnection,7/18/2008,4180000,11000000,6820000,31129.32820901381
From Dusk Till Dawn,1/19/1996,19000000,25836616,6836616,44135.67462879277
Friends with Money,9/7/2006,6500000,13368437,6868437,33851.340561853125
Tsotsi,8/18/2005,3000000,9879971,6879971,34607.5
Fantastic Voyage,8/24/1966,5115000,12000000,6885000,210550.45871559632
The Family,9/13/2013,30000000,36894225,6894225,29443.75162823672
The Darkness,5/13/2016,4000000,10898293,6898293,28715.488138401273
Catch-22,6/24/1970,18000000,24911670,6911670,177222.3076923077
Donnie Brasco,2/27/1997,35000000,41954997,6954997,43468.73125
The Valley of Decision,6/1/1945,2160000,9132000,6972000,385193.37016574584
Man's Best Friend,11/19/1993,6000000,12974636,6974636,47837.00960219478
Joan of Arc,10/18/1999,60000000,66976317,6976317,41451.67557932263
Eraserhead,3/19/1977,10000,7000000,6990000,116500.0
சிவாஜி,6/14/2007,12000000,19000000,7000000,33596.98970972201
Wait Until Dark,10/26/1967,4000000,11000000,7000000,207100.59171597636
Goemon,3/17/2009,9000000,16000000,7000000,32826.861752016506
Breakfast at Tiffany's,10/5/1961,2500000,9500000,7000000,233333.33333333334
Judgment at Nuremberg,12/1/1961,3000000,10000000,7000000,233333.33333333334
Before the Devil Knows You're Dead,9/26/2007,18000000,25005257,7005257,33528.24309836505
The Tailor of Panama,2/11/2001,21000000,28008462,7008462,39866.10921501706
In Too Deep,8/25/1999,7000000,14011454,7011454,41759.70220369267
Elephant,5/18/2003,3000000,10012022,7012022,38171.05062602069
Keeping the Faith,4/14/2000,30000000,37036004,7036004,41074.16228838295
Sous les jupes des filles,6/4/2014,5000000,12058187,7058187,29613.56951955795
Annie,6/18/1982,50000000,57059003,7059003,72400.03076923077
A Good Year,9/9/2006,35000000,42064105,7064105,34815.6973878758
Bølgen,8/28/2015,5904067,12975143,7071076,29717.270797873458
Drop Dead Fred,4/19/1991,6788000,13878334,7090334,52288.598820059
Hoop Dreams,9/12/1994,700000,7830611,7130611,47728.31994645247
Battle for the Planet of the Apes,6/15/1973,1700000,8844595,7144595,161642.4208144796
Boom Town,8/30/1940,2000000,9172000,7172000,512285.71428571426
Khumba,7/18/2013,20000000,27187375,7187375,30731.431478939783
Solomon and Sheba,12/25/1959,5000000,12200000,7200000,245733.78839590444
Bachna Ae Haseeno,8/14/2008,2400000,9600000,7200000,32863.80690687675
The Words,9/7/2012,6000000,13231461,7231461,31249.966509224007
Lone Wolf McQuade,4/14/1983,5000000,12232628,7232628,73353.22515212982
Lolita,6/13/1962,2000000,9250000,7250000,240066.2251655629
Niagara,1/26/1953,1250000,8500000,7250000,273584.90566037735
High Noon,3/27/1952,730000,8000000,7270000,275378.7878787879
2046,5/20/2004,12000000,19271312,7271312,38330.58513442278
Our Idiot Brother,8/26/2011,10000000,17273593,7273593,32057.935818836522
New Kids Turbo,12/9/2010,1500000,8786756,7286756,33245.685033693924
The Matador,5/12/2005,10000000,17297244,7297244,37537.26337448559
And So It Goes,7/20/2014,18000000,25312387,7312387,30743.432891041488
Star Trek: Nemesis,12/13/2002,60000000,67312826,7312826,40424.68767274737
The Birth of a Nation,9/9/2016,8500000,15861566,7361566,30491.765660983812
The Pyramid,12/4/2014,6500000,13865435,7365435,31367.37049213839
Elmer Gantry,6/19/1960,3000000,10400000,7400000,250000.0
Our Family Wedding,3/12/2010,14000000,21409028,7409028,34043.99189453708
Push,2/6/2009,38000000,45465299,7465299,35181.64595439057
Fat Pizza,4/10/2003,400000,7888102,7488102,40740.48966267682
Singam,5/28/2010,2200000,9700000,7500000,34409.194136673315
The Hollywood Knights,5/30/1980,2500000,10000000,7500000,90689.23821039902
Hud,5/29/1963,2500000,10000000,7500000,245098.03921568627
In the Land of Women,4/16/2007,10000000,17500000,7500000,36066.535544772996
Tupac: Resurrection,1/23/2003,300000,7808524,7508524,41007.77717094484
Elle s'appelait Sarah,9/16/2010,10000000,17511906,7511906,34346.26516270329
Cocoon: The Return,9/13/1988,17500000,25024919,7524919,62812.34557595994
Hellraiser III: Hell on Earth,9/11/1992,5000000,12534961,7534961,53325.98018400566
Child's Play 3,8/30/1991,13000000,20560255,7560255,55103.899416909626
The Crush,4/2/1993,6000000,13609396,7609396,52843.02777777778
Beyond the Lights,9/10/2014,7000000,14618727,7618727,32007.288966563177
Lakeview Terrace,9/19/2008,20000000,27640028,7640028,35276.918175395826
Dr. Strangelove or: How I Learned to Stop Worrying and Love the Bomb,1/29/1964,1800000,9440272,7640272,247257.9935275081
Leprechaun,1/8/1993,900000,8556940,7656940,53695.23141654979
Adventureland,4/3/2009,9500000,17164377,7664377,35942.49202776214
The Secret of NIMH,6/17/1982,7000000,14665733,7665733,78622.90256410257
Death Race 2000,4/27/1975,300000,8000000,7700000,144736.84210526315
Flirting with Disaster,3/22/1996,7000000,14702438,7702438,49279.83365323096
Raw Deal,6/6/1986,8500000,16209459,7709459,70406.01826484018
Dreamcatcher,3/21/2003,68000000,75715436,7715436,41977.34494015234
Love & Basketball,4/21/2000,20000000,27728118,7728118,45061.912536443146
U2 3D,5/19/2007,15000000,22730842,7730842,37104.717017355244
RockNRolla,9/4/2008,18000000,25739015,7739015,35373.01801328257
The Great Escape,6/20/1963,4000000,11744471,7744471,252262.8990228013
Mickey,8/1/1918,250000,8000000,7750000,503246.75324675324
The Man Who Knew Too Much,6/1/1956,2500000,10250000,7750000,284926.4705882353
Sabrina,9/28/1954,2238813,10000000,7761187,289596.5298507463
Sucker Punch,3/24/2011,82000000,89792502,7792502,34647.81731034299
Wizards,2/9/1977,1200000,9000000,7800000,131979.69543147206
दि�?से,8/22/1998,5200000,13000000,7800000,47677.26161369193
Ποτέ την Κυριακή,5/24/1960,151000,8000000,7849000,265168.91891891893
The Boy in the Striped Pyjamas,5/7/2008,12500000,20416563,7916563,36543.830089737436
Fright Night,8/18/2011,17000000,24922237,7922237,34916.79631890484
Snitch,2/21/2013,35000000,42930462,7930462,34069.50977991434
Pure Luck,8/9/1991,17010000,24941969,7931969,58067.12298682284
Death Wish 3,11/1/1985,9000000,16945171,7945171,72891.47706422018
Turbo: A Power Rangers Movie,3/27/1997,10000000,17979739,7979739,49811.10486891386
Hillary's America: The Secret History of the Democratic Party,7/1/2016,5000000,13000000,8000000,33246.3387469455
Wake Up Sid,10/2/2009,3000000,11000000,8000000,37006.71209240576
Love Me Tender,11/15/1956,1000000,9000000,8000000,290909.0909090909
Conquest of the Planet of the Apes,6/29/1972,1700000,9700000,8000000,190930.78758949882
The Sand Pebbles,12/20/1966,12000000,20000000,8000000,243161.09422492402
Shaft's Big Score!,6/8/1972,1978000,10000000,8022000,192374.10071942446
The Preacher's Wife,12/13/1996,40000000,48093211,8093211,51029.07313997478
No Holds Barred,6/2/1989,8000000,16093651,8093651,65218.78323932313
Rushmore,9/17/1998,9000000,17096053,8096053,49366.17682926829
Josh,6/9/2000,6900000,15000000,8100000,46983.75870069605
Mr. Smith Goes to Washington,10/19/1939,1500000,9600000,8100000,578571.4285714285
Hidalgo,3/5/2004,100000000,108103450,8103450,43241.462113127
Shaft,7/2/1971,4000000,12121618,8121618,199548.3538083538
The Sessions,5/2/2012,1000000,9138338,8138338,35412.56227835433
The Namesake,9/2/2006,12000000,20138836,8138836,40112.54805322819
Kandagar,2/4/2010,7000000,15172408,8172408,37705.870139936604
Before Midnight,4/5/2013,3000000,11176469,8176469,35162.920212788835
The Station Agent,1/26/2003,500000,8679814,8179814,44674.02512288367
Hardball,9/14/2001,32000000,40222729,8222729,46117.38081884464
Lone Star,6/21/1996,5000000,13269963,8269963,52674.923566878984
The Wizard,12/15/1989,6000000,14278900,8278900,65653.44964314037
Missing in Action 2: The Beginning,3/1/1985,2410000,10755447,8345447,78434.6522556391
Barbecue,4/30/2014,6000000,14348529,8348529,35092.59773013871
A Man Apart,4/4/2003,36000000,44350926,8350926,45434.85310119695
The Darjeeling Limited,9/29/2007,16000000,24377151,8377151,40094.33989355592
Reds,12/25/1981,32000000,40382659,8382659,88893.52067868505
Tango & Cash,12/22/1989,55000000,63408614,8408614,66001.6797488226
Midnight Run,7/20/1988,30000000,38413606,8413606,70702.57142857143
Indigènes,5/25/2006,14500000,22963701,8463701,41713.65697387876
Modern Times,2/5/1936,1,8500000,8499999,615941.9565217391
Harper,2/23/1966,3500000,12000000,8500000,264797.507788162
Samson and Delilah,12/21/1949,3000000,11500000,8500000,361702.12765957444
Монгол,9/20/2007,18000000,26527510,8527510,40813.9813148524
Reality Bites,2/18/1994,11500000,20079850,8579850,58287.02445652174
Viy,1/30/2014,26000000,34592118,8592118,36596.30890063506
Welcome Home Roscoe Jenkins,2/8/2008,35000000,43650785,8650785,40864.76643063303
On the Waterfront,6/22/1954,910000,9600000,8690000,323048.3271375465
Show Boat,7/13/1951,2300000,11000000,8700000,335907.3359073359
Orca: The Killer Whale,7/22/1977,6000000,14717854,8717854,142448.59477124183
Dave Chappelle's Block Party,9/12/2005,3000000,11718595,8718595,43856.11167002012
The Choice,2/4/2016,10000000,18730891,8730891,36821.95680504068
Rockstar,11/11/2011,10920000,19660000,8740000,38633.24934800866
Gallipoli,8/13/1981,3000000,11740000,8740000,94691.22426868905
English Vinglish,9/14/2012,2840000,11620000,8780000,37941.80815619233
Jaane Tu... Ya Jaane Na,7/4/2008,2300000,11100000,8800000,40006.54652579513
Glory,12/15/1989,18000000,26828365,8828365,70010.82474226804
A Perfect Getaway,6/8/2009,14000000,22852638,8852638,41042.7691209265
Tin Cup,8/16/1996,45000000,53854588,8854588,56112.724968314316
The Good Girl,1/12/2002,8000000,16856124,8856124,50006.34669678148
The Story of Us,10/13/1999,50000000,58900031,8900031,52913.382877526754
The Birds,3/28/1963,2500000,11403529,8903529,291918.98360655736
Secrets & Lies,5/24/1996,4500000,13417292,8917292,56906.77728142949
Bachelorette,8/6/2012,3000000,11947954,8947954,38840.14602025358
Dil Dhadakne Do,6/5/2015,13000000,22000000,9000000,37714.02710381414
Gabbar Singh,5/11/2012,7000000,16000000,9000000,39161.93459956922
Barry Lyndon,12/18/1975,11000000,20000000,9000000,161870.5035971223
Friday the 13th Part VIII: Jason Takes Manhattan,7/28/1989,5000000,14000000,9000000,72231.13964686998
The Great Dictator,10/15/1940,2000000,11000000,9000000,642857.1428571428
The Night of the Iguana,8/6/1964,3000000,12000000,9000000,290322.5806451613
Battle Beyond the Stars,9/8/1980,2000000,11000000,9000000,107142.85714285714
Jane Austen's Mafia!,7/24/1998,10000000,19000000,9000000,55079.55936352509
Tea with Mussolini,3/25/1999,12000000,21001563,9001563,54161.028880866426
They Live,11/23/1988,4000000,13008928,9008928,74762.88796680498
Kissing Jessica Stein,4/21/2001,1000000,10013424,9013424,50722.70118176703
Yves Saint Laurent,1/8/2014,12000000,21026290,9026290,38587.74089844218
Cousins,2/10/1989,13000000,22030000,9030000,74259.86842105264
Gojira ni-sen mireniamu,12/11/1999,1000000,10037390,9037390,53698.09863339275
Cry_Wolf,9/16/2005,1000000,10047674,9047674,45420.05020080321
Hellbound: Hellraiser II,12/23/1988,3000000,12090735,9090735,75068.00165152767
Pet Sematary II,8/28/1992,8000000,17092453,9092453,64348.5704175513
Frenzy,5/25/1972,3500000,12600000,9100000,218225.41966426856
The Bellboy,7/20/1960,900000,10000000,9100000,307432.4324324324
Les Aventures extraordinaires d'Adèle Blanc-Sec,4/9/2010,25000000,34100000,9100000,41741.395997412954
Vals Im Bashir,6/25/2008,2000000,11125849,9125849,41487.920750668294
Kaminey,8/14/2009,9000000,18130000,9130000,42301.02764161346
Stir of Echoes,9/10/1999,12000000,21133087,9133087,54395.991661703396
Yu-Gi-Oh! The Movie,8/13/2004,20000000,29170410,9170410,48392.66490765171
North by Northwest,7/7/1959,4000000,13275000,9275000,317636.98630136985
The Nun's Story,6/18/1959,3500000,12800000,9300000,318493.1506849315
Rang De Basanti,1/26/2006,2200000,11502151,9302151,46815.05284348264
King Kong,4/7/1933,672000,10000000,9328000,740317.4603174604
The History Boys,10/2/2006,4000000,13401952,9401952,46590.445986124876
King of Kings,10/11/1961,5037000,14483352,9446352,314878.4
The African Queen,12/3/1951,1300000,10750000,9450000,356603.77358490566
Half Baked,1/16/1998,8000000,17460020,9460020,58431.253860407654
Charade,12/5/1963,4000000,13474588,9474588,306620.9708737864
American Ninja,8/30/1985,1000000,10499694,9499694,87716.4727608495
The Rescuers Down Under,11/16/1990,37931000,47431461,9500461,71004.94020926756
In Cold Blood,12/14/1967,3500000,13007551,9507551,280458.73156342184
Katyń,9/21/2007,5200000,14723313,9523313,45580.04843588467
Boys Don't Cry,9/2/1999,2000000,11540607,9540607,56823.150684931505
Casablanca,11/26/1942,878000,10462500,9584500,567130.177514793
The Squid and the Whale,10/5/2005,1500000,11098131,9598131,48183.38855421687
कभी अलविदा ना कहना,8/11/2006,7400000,17000000,9600000,47081.90289357528
Buffy the Vampire Slayer,7/24/1992,7000000,16624456,9624456,68306.99787083037
Sing Street,3/11/2016,4000000,13624522,9624522,40416.75205348294
The Island of Dr. Moreau,8/23/1996,40000000,49627779,9627779,61012.54119138149
Glee: The Concert Movie,8/11/2011,9000000,18663238,9663238,42654.82795912512
Cyborg,4/7/1989,500000,10166459,9666459,78525.25588952072
Dil To Pagal Hai,10/30/1997,1300000,11000000,9700000,60061.91950464396
Garv: Pride and Honour,7/9/2004,1300000,11000000,9700000,51214.36114044351
The Lost Weekend,11/25/1945,1250000,11000000,9750000,535714.2857142857
The Craft,5/3/1996,15000000,24769466,9769466,62384.84035759898
Whiplash,10/10/2014,3300000,13092000,9792000,41241.10801784082
The Sugarland Express,4/5/1974,3000000,12800000,9800000,204166.66666666666
The Edge of Seventeen,11/18/2016,9000000,18803648,9803648,40606.24937870705
House of 1000 Corpses,4/11/2003,7000000,16829545,9829545,53479.57018498368
Bananas,4/28/1971,2000000,11833696,9833696,244012.30769230772
Escape from the Planet of the Apes,5/20/1971,2500000,12348905,9848905,242583.86699507388
Being John Malkovich,9/30/1999,13000000,22863596,9863596,58642.06896551725
Play Misty for Me,11/3/1971,725000,10600000,9875000,241442.54278728607
The Best of Me,10/16/2014,26000000,35926213,9926213,42033.33036912823
Kubo and the Two Strings,8/18/2016,60000000,69929545,9929545,41128.39024471064
The Sitter,12/9/2011,25000000,34942188,9942188,44055.921868907084
Nurse 3-D,9/28/2013,10,10000000,9999990,42818.074383633204
Dostana,11/13/2008,10000000,20000000,10000000,47075.438390020005
Torn Curtain,7/13/1966,3000000,13000000,10000000,307692.3076923077
The Egyptian,8/25/1954,5000000,15000000,10000000,373134.32835820894
Going the Distance,9/1/2010,32000000,42045846,10045846,45989.25100371271
О чём говорят мужчины,3/4/2010,1950000,12005838,10055838,46205.90816565655
Facing the Giants,9/29/2006,100000,10178331,10078331,49942.17542120912
Halloween: The Curse of Michael Myers,9/29/1995,5000000,15116634,10116634,65820.6506180872
Another Year,11/5/2010,8000000,18124262,10124262,46271.12973770926
Scanners,1/14/1981,4100000,14225876,10125876,116389.37931034483
Just My Luck,5/12/2006,28000000,38159905,10159905,50172.37037037037
The International,2/3/2009,50000000,60161391,10161391,47887.49393241059
葉問,12/12/2008,11715578,21888598,10173020,48390.414216945406
The Last Exorcism Part II,2/28/2013,5000000,15179302,10179302,43730.59590244573
The House on Sorority Row,1/21/1983,425000,10604986,10179986,103983.5137895812
High Plains Drifter,4/19/1973,5500000,15700000,10200000,232346.24145785876
Chain Reaction,8/2/1996,50000000,60209334,10209334,64903.58550540368
The Return of the Living Dead,5/15/1985,4000000,14237000,10237000,95405.40540540541
Pink Floyd: The Wall,7/14/1982,12000000,22244207,10244207,105068.78974358975
Bloodsport,2/26/1988,1500000,11806119,10306119,88464.54077253219
Pina,2/24/2011,4317946,14624826,10306880,46122.60423239225
Reno 911!: Miami,2/23/2007,10000000,20342161,10342161,50363.08874517901
Safe,4/16/2012,30000000,40346186,10346186,45019.62883188652
De rouille et d'os,5/17/2012,15400000,25762027,10362027,45154.77300656272
Haywire,11/6/2011,23000000,33372606,10372606,45849.8253989303
Trapeze,5/30/1956,4000000,14400000,10400000,382352.9411764706
ДухLess,10/4/2012,2800000,13218980,10418980,45041.99864255545
What's Your Number?,9/30/2011,20000000,30426096,10426096,46047.389597254674
Queen of the Damned,2/10/2002,35000000,45479110,10479110,58937.62654668166
Creepshow 2,5/1/1987,3500000,14000000,10500000,92838.19628647216
Roman Holiday,9/2/1953,1500000,12000000,10500000,390334.57249070634
Dhoom,8/27/2004,1500000,12000000,10500000,55292.25908372828
Wimbledon,9/13/2004,31000000,41512007,10512007,55355.48709847288
Random Hearts,10/8/1999,64000000,74608570,10608570,63071.16527942925
The Way of the Gun,9/8/2000,8500000,19125401,10625401,61170.99021301094
Sparkle,8/17/2012,14000000,24637469,10637469,45968.65695506186
16 Blocks,3/1/2006,55000000,65664721,10664721,53376.98198198198
Gods of Egypt,2/25/2016,140000000,150680864,10680864,44852.70354257303
RoboCop 2,6/22/1990,35000000,45681173,10681173,81910.83588957055
Wishmaster,9/19/1997,5000000,15719109,10719109,66331.12004950496
Les Poupées Russes,6/15/2005,13000000,23727301,10727301,55153.21850899743
Rudy,9/17/1993,12000000,22750363,10750363,73784.234728895
Convoy,6/27/1978,12000000,22765081,10765081,163852.0700152207
The Dead Zone,10/21/1983,10000000,20766616,10766616,106389.4861660079
The Chronicles of Riddick,6/11/2004,105000000,115772733,10772733,56788.26041117554
Highlander III: The Sorcerer,11/29/1994,26000000,36800000,10800000,72144.28857715431
Antwone Fisher,12/19/2002,12500000,23367586,10867586,59810.59988992846
Fantasia 2000,12/17/1999,80000000,90874570,10874570,64422.80805687203
स्पेशल 26,2/7/2013,7100000,18000000,10900000,46949.16568317497
The Birth of a Nation,2/8/1915,100000,11000000,10900000,1090000.0
Rounders,9/11/1998,12000000,22921898,10921898,66759.76772616137
Leap Year,1/8/2010,19000000,29922472,10922472,50406.67875783965
Young Adult,12/16/2011,12000000,22939027,10939027,48260.768093883045
Akeelah and the Bee,4/28/2006,8000000,18948425,10948425,54066.2962962963
Vizontele Tuuba,1/21/2004,3000000,13954476,10954476,58831.77228786251
The Dark Tower,8/3/2017,60000000,71000000,11000000,44803.0498657945
Vaaranam Aayiram,11/14/2008,3000000,14000000,11000000,51782.982229022
Rules of Engagement,4/7/2000,60000000,71000000,11000000,64214.827787507296
Singh Is Kinng,1/1/2008,14000000,25000000,11000000,52112.942960015156
Aquamarine,3/3/2006,12000000,23006849,11006849,55089.33433433433
Love & Friendship,5/27/2016,3000000,14016568,11016568,45708.48650308276
Kicking & Screaming,5/13/2005,45000000,56070433,11070433,56946.67181069959
The Mechanic,1/13/2011,40000000,51070807,11070807,50270.893594220404
xXx: State of the Union,4/27/2005,60000000,71073932,11073932,56964.670781893
"\"대�?\"\"While the Kingdom of Korea is under occupation by the Japanese\"",12/16/2015,5000,11083449,11078449,46761.084097317194
Arundhati,1/16/2009,2915739,14000000,11084261,52236.69489568459
Silent House,1/21/2011,2000000,13101672,11101672,50163.67160847503
The Shaggy Dog,3/9/2006,50000000,61112916,11112916,55620.2002002002
The Running Man,11/13/1987,27000000,38122105,11122105,96378.72616984401
To Kill a Mockingbird,12/25/1962,2000000,13129846,11129846,366113.3552631579
Critters,4/11/1986,2000000,13167232,11167232,102829.02394106814
Sunshine Cleaning,1/18/2008,5000000,16174377,11174377,52785.76523550613
Prince of Darkness,10/23/1987,3000000,14182492,11182492,96902.01039861351
The Haunting,7/23/1999,80000000,91188905,11188905,66959.33572710952
Shame,10/2/2011,6500000,17693675,11193675,49437.441756727516
Rangeela,1/1/1995,2800000,14000000,11200000,74517.63140385895
Parker,1/23/2013,35000000,46216641,11216641,48313.02171721958
ദൃശ്യം,12/19/2013,750000,12000000,11250000,48094.18765710768
魔女の宅急便,7/29/1989,6900000,18172849,11272849,90472.30337078653
Machete,9/1/2010,20000000,31327899,11327899,51858.40898374375
Beauty Shop,6/2/2005,25000000,36351350,11351350,58361.69665809769
Above the Law,4/8/1988,7500000,18869631,11369631,97093.34756618275
Vegas Vacation,2/13/1997,25000000,36400360,11400360,71430.82706766918
Night of the Comet,11/16/1984,3000000,14418922,11418922,108441.80436847104
Lucky Lady,12/25/1975,13000000,24441725,11441725,205786.42086330935
Magnolia,12/8/1999,37000000,48451803,11451803,68043.98692810457
Top Secret!,6/8/1984,9000000,20458340,11458340,110495.08196721312
Gridiron Gang,9/15/2006,30000000,41480851,11480851,56583.79004435682
All About the Benjamins,3/8/2002,14000000,25482931,11482931,64222.20917225951
Middle School: The Worst Years of My Life,10/7/2016,8500000,19985196,11485196,47512.69396721121
Married to the Mob,8/19/1988,10000000,21486757,11486757,95882.7796327212
Nefes: Vatan Sağolsun,10/15/2009,2000000,13500000,11500000,53197.14863283328
Die Welle,3/11/2008,7500000,19000000,11500000,53857.10539133041
Hocus Pocus,7/16/1993,28000000,39514713,11514713,79521.49861878452
Porky's Revenge,3/22/1985,9000000,20518905,11518905,107754.02245088867
Shocker,10/27/1989,5000000,16554699,11554699,91776.79904686258
十三人の刺客,9/9/2010,6000000,17555141,11555141,52898.708563946915
Mud,5/1/2013,10000000,21587700,11587700,49744.36025671296
रान्झाना,6/21/2013,6400000,18000000,11600000,49658.38456137948
Taxi,10/6/2004,25000000,36609966,11609966,60817.00366684128
The Rookie,12/6/1990,10000000,21633874,11633874,86949.73094170402
The Lobster,10/8/2015,4000000,15656193,11656193,49008.95988025463
Paint Your Wagon,10/15/1969,20000000,31678778,11678778,313103.96782841824
Phantasm,3/28/1979,300000,11988469,11688469,165559.05099150143
Soodhu Kavvum,5/1/2013,310000,12000000,11690000,50183.51971495418
Frankenstein,11/21/1931,291000,12000000,11709000,801986.301369863
Let's Do It Again,10/11/1975,70000,11800000,11730000,213661.20218579235
The Remains of the Day,11/5/1993,11500000,23237911,11737911,80506.9341563786
A Hard Day's Night,7/6/1964,560000,12299668,11739668,377481.2861736334
Chasing Amy,4/4/1997,250000,12021272,11771272,73478.60174781524
My Blueberry Nights,5/16/2007,10000000,21786738,11786738,56571.273613884194
Jay and Silent Bob Strike Back,8/22/2001,22000000,33788161,11788161,66114.19517666854
Deepwater Horizon,9/29/2016,110000000,121790373,11790373,48775.169714845964
Arrambam,10/31/2013,9200000,21000000,11800000,50628.783750734765
Cowboys & Aliens,7/29/2011,163000000,174822325,11822325,52185.3274183937
Winter's Bone,6/11/2010,2000000,13831503,11831503,54281.66448741771
Halloween III: Season of the Witch,10/22/1982,2500000,14400000,11900000,121428.57142857143
올드보이,1/1/2003,3000000,14980005,11980005,65932.88387451845
Don't Be Afraid of the Dark,11/6/2010,25000000,36993168,11993168,54812.630539800644
The Stepford Wives,6/10/2004,90000000,102000000,12000000,63257.77543489721
Sweet Charity,1/1/1969,8000000,20000000,12000000,337078.65168539324
You Again,9/24/2010,20000000,32005248,12005248,54890.919981162355
마더,5/28/2009,5000000,17112713,12112713,56157.191007589485
Muriel's Wedding,9/29/1994,3000000,15119639,12119639,81067.81939799331
Mrs. Miniver,6/4/1942,1344000,13500000,12156000,745766.8711656441
Daddy Day Camp,8/8/2007,6000000,18197398,12197398,58664.74602846328
Lockout,4/12/2012,20000000,32204030,12204030,53041.397744311886
Perfect Stranger,4/12/2007,60795000,73090611,12295611,59489.3268049118
Alexander,11/21/2004,155000000,167298192,12298192,64625.28638991067
Transamerica,12/23/2005,1000000,13350369,12350369,62281.235501765
Spaced Invaders,4/27/1990,3000000,15369573,12369573,95739.72910216718
StreetDance 3D,5/19/2010,5773100,18144030,12370930,56756.497602826144
Less Than Zero,11/6/1987,1,12396383,12396382,107420.98786828422
Cocktail,7/13/2012,6400000,18800000,12400000,54123.89133319366
Hit & Run,8/22/2012,2000000,14400000,12400000,53585.24158733314
2010,12/6/1984,28000000,40400657,12400657,117765.02374169041
The First Power,4/6/1990,10000000,22424195,12424195,96386.30721489526
Tomcats,3/30/2001,11000000,23430766,12430766,70270.01695873374
A Dangerous Method,9/30/2011,15000000,27462041,12462041,55039.24547634716
Trainspotting,2/23/1996,4000000,16491080,12491080,80225.30507386
Las aventuras de Tadeo Jones,8/31/2012,10500000,23000000,12500000,54017.380632392276
Sinbad and the Eye of the Tiger,7/15/1977,3500000,16000000,12500000,204918.03278688525
Black Christmas,12/25/2006,9000000,21510851,12510851,61807.61896292783
More American Graffiti,8/3/1979,2500000,15014674,12514674,169575.52845528457
Mere Brother Ki Dulhan,9/9/2011,5510000,18050000,12540000,55269.31671434049
30 Minutes or Less,8/11/2011,28000000,40547440,12547440,55386.08223531749
Каникулы строгого режима,8/25/2009,5000000,17566040,12566040,58184.46165884919
Black or White,9/6/2014,9000000,21571189,12571189,52813.242812910925
The Serpent and the Rainbow,2/5/1988,7000000,19595031,12595031,108577.85344827586
Return to Me,4/7/2000,24000000,36609995,12609995,73613.51430239345
It Follows,2/4/2015,2000000,14674076,12674076,53996.114552534484
Hellraiser: Bloodline,3/8/1996,4000000,16675000,12675000,81406.55105973026
リン�?2,1/23/1999,6000000,18686644,12686644,77122.45592705168
The World According to Garp,8/13/1982,17000000,29712172,12712172,130114.35005117707
A Mighty Wind,4/16/2003,6000000,18750246,12750246,69483.62942779291
Halloween 4: The Return of Michael Myers,10/21/1988,5000000,17768757,12768757,106140.95594347465
The Nice Guys,5/15/2016,50000000,62788218,12788218,53233.44808495227
God's Not Dead,3/21/2014,17000000,29789000,12789000,53945.63676857663
Clockstoppers,3/17/2002,26000000,38793283,12793283,71152.85317018909
Clockstoppers,3/17/2002,26000000,38793283,12793283,71152.85317018909
Tales from the Darkside: The Movie,5/3/1990,3500000,16324573,12824573,99261.40092879257
Seed of Chucky,11/11/2004,12000000,24829644,12829644,67170.9109947644
Death Warrant,9/14/1990,4000000,16853487,12853487,96861.24340617936
[REC]²,9/15/2009,5600000,18469680,12869680,59590.40417837745
Soul Kitchen,9/9/2009,5000000,17872796,12872796,59604.83217498808
Aliens in the Attic,7/31/2009,45000000,57881056,12881056,59680.3839988139
A Lot Like Love,4/22/2005,30000000,42886719,12886719,66289.70679012345
Gong fu guan lan,2/7/2008,10000000,22896728,12896728,60921.84436896827
Jason Goes to Hell: The Final Friday,8/13/1993,3000000,15938065,12938065,89351.27762430938
Corky Romano,10/12/2001,11000000,23978402,12978402,73035.46426561622
Jagten,8/28/2012,3800000,16800000,13000000,56178.07585768797
Eyes of Laura Mars,8/2/1978,7000000,20000000,13000000,196969.69696969696
Creepshow,11/12/1982,8000000,21028755,13028755,132946.47959183675
Blue Valentine,12/27/2010,3500000,16566240,13066240,59331.859070124374
Ida,10/25/2013,2159280,15298355,13139075,56374.18532709198
The Buddy Holly Story,5/18/1978,1200000,14363400,13163400,201892.6380368098
Righteous Kill,9/11/2008,60000000,73174566,13174566,60217.503188090486
Kickboxer,4/20/1989,1500000,14697005,13197005,106599.39418416802
Children of the Corn,3/9/1984,800000,14000000,13200000,128654.97076023392
Cool Hand Luke,6/22/1967,3000000,16217773,13217773,395741.70658682636
Private Parts,3/7/1997,28000000,41230799,13230799,82692.49375
Fan,4/15/2016,16000000,29251596,13251596,55385.52459448051
Action Jackson,2/12/1988,7000000,20256975,13256975,114284.2672413793
Joe Dirt,4/10/2001,17700000,30987695,13287695,75114.16054267947
Before Sunset,2/10/2004,2700000,15992615,13292615,71388.90977443609
Where Eagles Dare,12/4/1968,7700000,21000000,13300000,374647.88732394367
All Dogs Go to Heaven,11/17/1989,13800000,27100027,13300027,105472.06185567011
Million Dollar Arm,5/9/2014,25000000,38307627,13307627,55937.90248003363
A Night at the Roxbury,10/1/1998,17000000,30331165,13331165,81287.59146341463
The Great Race,7/1/1965,12000000,25333333,13333333,421940.91772151896
City Heat,12/5/1984,25000000,38348988,13348988,126771.01614434949
Baby Boy,6/27/2001,16000000,29381649,13381649,75389.57183098592
The Invention of Lying,9/13/2009,18500000,31912793,13412793,62105.17713190319
The Informant!,9/18/2009,22000000,35424826,13424826,62101.08383408041
Eega,6/6/2012,5990000,19450000,13460000,58654.86016088688
Reservoir Dogs,9/2/1992,1200000,14661007,13461007,95265.44232130218
Poetic Justice,7/23/1993,14000000,27515786,13515786,93341.0635359116
Friday After Next,11/22/2002,20000000,33526835,13526835,74775.20729684908
The Guard,7/7/2011,6000000,19560274,13560274,60021.92792202619
Hellraiser,9/11/1987,1000000,14564027,13564027,117948.06086956522
How To Make An American Quilt,10/6/1995,10000000,23574130,13574130,88315.74495770983
Celda 211,11/6/2009,5700000,19300483,13600483,62869.14898534646
Jack,8/9/1996,45000000,58620973,13620973,86592.32676414493
Joy Ride,10/5/2001,23000000,36642838,13642838,76774.55261676984
Deep Blue Sea,7/28/1999,60000000,73648228,13648228,81677.0077797726
RED,10/13/2010,58000000,71664962,13664962,62479.53692315429
Elektra,1/13/2005,43000000,56681566,13681566,71743.92239119035
The Player,4/3/1992,8000000,21706101,13706101,98251.62007168459
The Incredible Hulk,6/12/2008,150000000,163712074,13712074,62665.146356511206
The Last Starfighter,7/13/1984,15000000,28733290,13733290,131924.0153698367
Little Shop of Horrors,12/19/1986,25000000,38748395,13748395,123636.64568345323
Café Society,5/11/2016,30000000,43763247,13763247,57292.196196129524
Kuch Kuch Hota Hai,10/16/1998,1530000,15306000,13776000,84000.0
Prom Night,7/18/1980,1000000,14796236,13796236,165621.08043217286
Adaptation.,12/6/2002,19000000,32801173,13801173,76291.72470978441
Enough,5/24/2002,38000000,51801187,13801187,76715.88104502502
Jason's Lyric,9/28/1994,7000000,20851521,13851521,92652.3143812709
She's the Man,3/17/2006,20000000,33889159,13889159,68928.8287841191
Delhi Belly,7/1/2011,4090000,18035000,13945000,61724.84308743726
Baggage Claim,9/27/2013,8500000,22456509,13956509,59759.143808928435
Auf der anderen Seite,9/27/2007,3800000,17804565,14004565,67028.01336294368
The Big Hit,4/24/1998,13000000,27007143,14007143,86038.9619164619
The Sisterhood of the Traveling Pants,6/1/2005,25000000,39053061,14053061,72252.24164524421
Endless Love,2/12/2014,20000000,34077920,14077920,59961.921961317144
The 6th Day,11/17/2000,82000000,96085477,14085477,80951.0172413793
My Left Foot: The Story of Christy Brown,7/21/1989,645180,14743391,14098211,113147.76083467095
Breakdown,5/2/1997,36000000,50159144,14159144,88439.37539038101
A Nightmare on Elm Street 5: The Dream Child,8/11/1989,8000000,22168359,14168359,113710.74638844302
Malcolm X,11/18/1992,34000000,48169908,14169908,99858.407329105
The Gambler,12/25/2014,25000000,39171130,14171130,60636.309567107535
The Core,3/28/2003,60000000,74208267,14208267,77302.86724700761
Per un pugno di dollari,9/12/1964,200000,14500000,14300000,459807.0739549839
Confessions of a Teenage Drama Queen,2/17/2004,15000000,29331068,14331068,76473.14834578442
Duel in the Sun,12/31/1946,6000000,20400000,14400000,669767.4418604651
Per qualche dollaro in più,12/18/1965,600000,15000000,14400000,452830.1886792453
Melancholia,5/26/2011,7400000,21817298,14417298,63871.922098864976
License to Drive,7/6/1988,8000000,22433275,14433275,121799.78902953587
Parts Per Billion,3/25/2014,500000,15000000,14500000,61162.85347911183
9 рота,9/19/2005,9500000,24000000,14500000,72791.16465863455
Dick,8/4/1999,13000000,27500000,14500000,86774.38659485338
Ladder 49,10/1/2004,60000000,74541707,14541707,76174.47354635935
Crank: High Voltage,4/16/2009,20000000,34560577,14560577,68085.89424659584
Cat on a Hot Tin Roof,2/17/1958,3000000,17570324,14570324,505914.02777777775
Empire,12/6/2002,4000000,18591272,14591272,80659.32559425097
Drive Me Crazy,10/1/1999,8000000,22593409,14593409,86762.24137931035
முதல்வன்,11/7/1999,7400000,22000000,14600000,86749.8514557338
Swimming Pool,5/18/2003,7800000,22441323,14641323,79702.35710397387
Small Soldiers,7/10/1998,40000000,54682547,14682547,89966.58700980393
Aashiqui 2,4/25/2013,1300000,16000000,14700000,63105.02479125974
Sorority Row,9/9/2009,12500000,27206120,14706120,68093.66159032083
Ayan,4/3/2009,3230939,18000000,14769061,69260.27480772838
Kahaani,3/9/2012,1200000,16000000,14800000,64518.37901932064
Любовь-морковь 2,12/23/2008,3000000,17850711,14850711,70334.84889387761
The Princess Bride,9/18/1987,16000000,30857814,14857814,128862.22029488292
Nighthawks,3/17/1981,5000000,19905359,14905359,167287.97979797982
Harold & Kumar Go to White Castle,5/30/2004,9000000,23936908,14936908,78739.63099630996
The Beguiled,6/23/2017,10500000,25442939,14942939,61044.90861405472
Sergeant York,7/2/1941,1400000,16361885,14961885,1017815.306122449
Breakout,5/21/1975,1000000,16000000,15000000,279850.7462686567
3:10 to Yuma,9/6/2007,55000000,70016220,15016220,72023.69418197515
Sweet Sweetback's Baadasssss Song,4/23/1971,150000,15200000,15050000,373449.1315136477
Road House,5/19/1989,15000000,30050028,15050028,121273.39242546335
Double Impact,7/31/1991,15000000,30102717,15102717,110561.61786237189
When the Game Stands Tall,8/22/2014,15000000,30127963,15127963,63554.59162882146
Juice,1/17/1992,5000000,20146880,15146880,109284.8484848485
Don't Tell Mom the Babysitter's Dead,6/7/1991,10000000,25196249,15196249,111737.125
Marathon Man,10/5/1976,6500000,21709020,15209020,262677.3747841105
The Ghost Writer,2/12/2010,45000000,60222298,15222298,70232.66479346316
The Great Debaters,12/27/2007,15000000,30226144,15226144,72134.47034299791
The Fighting Temptations,9/17/2003,15000000,30238577,15238577,82370.68648648649
Extremely Loud & Incredibly Close,12/24/2011,40000000,55247881,15247881,67270.55787174906
Secret in Their Eyes,10/14/2015,19500000,34854990,15354990,64560.709390425414
Concussion,11/12/2015,35000000,50363790,15363790,64734.34287255199
The Hitcher,1/19/2007,10000000,25399945,15399945,75675.77727654681
Now and Then,10/20/1995,12000000,27400000,15400000,100260.41666666667
Spaceballs,6/24/1987,22700000,38119483,15419483,135496.33567662566
La Vérité si je Mens ! 3,1/31/2012,25496629,40924982,15428353,67768.38133557055
War,8/24/2007,25000000,40452643,15452643,74116.95045325915
A Ghost Story,7/7/2017,100000,15584255,15484255,63256.29325206507
Super Troopers,1/18/2001,3000000,18492362,15492362,88124.92605233219
Accepted,8/18/2006,23000000,38505009,15505009,76416.99852143913
Far from Heaven,9/1/2002,13500000,29027914,15527914,85789.58011049723
Ender's Game,10/23/2013,110000000,125537191,15537191,66663.48162990359
Sicko,5/18/2007,9000000,24538513,15538513,74578.18019505452
The Tigger Movie,2/11/2000,30000000,45554533,15554533,91605.02355712603
Jennifer's Body,9/18/2009,16000000,31556061,15556061,71959.83383986271
Hustle & Flow,7/22/2005,8000000,23563727,15563727,79245.04582484724
Can't Hardly Wait,6/12/1998,10000000,25605015,15605015,95736.28834355828
Gone Baby Gone,10/19/2007,19000000,34619699,15619699,74316.88053402609
Tears of the Sun,3/7/2003,70000000,85632458,15632458,84866.76438653638
Waiting...,10/7/2005,3000000,18637690,15637690,78502.45983935743
Pay It Forward,10/12/2000,40000000,55707411,15707411,90272.47701149425
Robin Hood: Men in Tights,7/28/1993,20000000,35739755,15739755,108699.96546961325
The Last Dragon,3/22/1985,10000000,25754284,15754284,147374.03180542562
Hugo,11/22/2011,170000000,185770160,15770160,69880.88907795385
A Soldier's Story,9/14/1984,6000000,21821347,15821347,150679.49523809523
Houseguest,1/6/1995,10500000,26325256,15825256,105291.124417831
The Black Hole,12/18/1979,20000000,35841901,15841901,203623.4061696658
Black Rain,9/22/1989,30000000,45892212,15892212,126530.35031847135
Falling Down,2/26/1993,25000000,40903593,15903593,110749.25487465182
Fright Night,8/2/1985,9000000,24922237,15922237,147428.12037037036
Beneath the Planet of the Apes,5/1/1970,3000000,18999718,15999718,414500.4663212435
Logan's Run,6/23/1976,9000000,25000000,16000000,280210.1576182137
Tron,7/9/1982,17000000,33000000,16000000,164102.5641025641
Herbie Fully Loaded,6/22/2005,50000000,66002004,16002004,81893.57215967246
Margin Call,9/28/2011,3500000,19504039,16004039,70682.66194390097
Три богатыря и Шамаханская царица,12/29/2010,3000000,19010585,16010585,72701.69328362614
Everything You Always Wanted to Know About Sex *But Were Afraid to Ask,8/6/1972,2000000,18016290,16016290,381340.2380952381
Life of Brian,8/17/1979,4000000,20045115,16045115,215081.9705093834
Wrong Turn,5/30/2003,12600000,28650575,16050575,87373.84322264562
La Belle et la Bête,2/12/2014,33000000,49100000,16100000,68574.54393668994
The Manchurian Candidate,10/24/1962,80000000,96105910,16105910,529799.6710526316
The Manchurian Candidate,7/30/2004,80000000,96105964,16105964,84991.8944591029
Alien Nation,10/7/1988,16000000,32155047,16155047,134401.38935108154
Martin Lawrence Live: Runteldat,8/1/2002,3000000,19184015,16184015,89562.89429994466
Cujo,8/10/1983,5000000,21200000,16200000,161676.64670658682
Starship Troopers,11/6/1997,105000000,121214377,16214377,100398.61919504644
Emma,8/2/1996,6000000,22231658,16231658,103189.17991099808
Natural Born Killers,8/25/1994,34000000,50282766,16282766,108987.72423025435
Vacancy,4/20/2007,19000000,35300645,16300645,78387.7056393635
Saving Grace,1/24/2000,10000000,26330482,16330482,96174.80565371024
Sleeper,12/17/1973,2000000,18344729,16344729,350745.2575107296
Friday the 13th Part VII: The New Blood,5/13/1988,2800000,19170001,16370001,139319.1574468085
A Very Harold & Kumar Christmas,11/4/2011,19000000,35387212,16387212,72436.06948680547
The Wind That Shakes the Barley,6/23/2006,6500000,22889018,16389018,80535.714987715
Irrational Man,7/17/2015,11000000,27391084,16391084,68778.78111415096
Dolphin Tale 2,9/12/2014,36000000,52424533,16424533,69001.65524658552
Friday the 13th Part VI: Jason Lives,8/1/1986,3000000,19472057,16472057,150155.4876937101
Billy Madison,2/10/1995,10000000,26488734,16488734,109269.27766732936
Kingdom of the Spiders,8/24/1977,500000,17000000,16500000,268729.6416938111
A Few Best Men,10/14/2011,12468389,29007412,16539023,73045.44631460863
A Most Wanted Man,7/25/2014,15000000,31554855,16554855,69601.49588819938
Little Big Man,12/14/1970,15000000,31559552,16559552,416069.1457286432
The Hours,12/27/2002,25000000,41597830,16597830,91347.44083654376
Undercover Brother,5/31/2002,25000000,41604473,16604473,92298.34908282378
Burnt,10/2/2015,20000000,36606743,16606743,69823.75818834669
My Best Friend's Girl,9/19/2008,20000000,36620508,16620508,76743.21360465062
The Kingdom,8/22/2007,70000000,86658558,16658558,79900.99285337426
Piku,5/8/2015,5500000,22159216,16659216,70054.10315174198
Hot Pursuit,5/8/2015,35000000,51680201,16680201,70142.34772187297
Exorcist II: The Heretic,6/17/1977,14000000,30749142,16749142,274576.0983606557
The King and I,6/29/1956,4550000,21300000,16750000,611313.8686131387
Men of Honor,9/13/2000,32000000,48814909,16814909,96804.3120322395
Fanaa,5/26/2006,5300000,22175908,16875908,83173.52390340068
Shane,4/23/1953,3100000,20000000,16900000,632958.8014981274
The Emoji Movie,7/28/2017,50000000,66913939,16913939,68890.5502221824
I Love Trouble,6/29/1994,45000000,61947267,16947267,114199.91239892184
The Howling,4/3/1981,1000000,17985893,16985893,190638.52974186308
Valley Girl,4/8/1983,350000,17343596,16993596,172348.84381338744
Looper,9/26/2012,30000000,47042000,17042000,73673.78964797225
Robin Hood,11/8/1973,15000000,32056467,17056467,371600.58823529416
Postcards from the Edge,9/12/1990,22000000,39071603,17071603,128648.10097965336
Uptown Girls,8/15/2003,20000000,37095657,17095657,92609.19284940412
Mrs. Brown's Boys D'Movie,6/27/2014,5900000,23000000,17100000,71773.34732423925
High Fidelity,3/17/2000,30000000,47126295,17126295,99978.37127845884
The Man from Snowy River,3/2/1982,3500000,20659423,17159423,181581.19576719578
Buried,9/24/2010,1987650,19152480,17164830,78481.78646707298
Love and Death,6/10/1975,3000000,20173742,17173742,320405.6343283582
Sixteen Candles,5/4/1984,6500000,23686027,17186027,166209.15860735008
The Spy Next Door,1/15/2010,28000000,45236543,17236543,79545.81031626262
Dope,6/19/2015,700000,17986781,17286781,72434.49093666983
Good Guys Wear Black,6/1/1978,1000000,18300000,17300000,265337.4233128834
Экипаж,4/21/2016,10000000,27305571,17305571,72037.80975652397
The Brothers Grimm,8/26/2005,88000000,105316267,17316267,87103.95875251509
Brothers,1/27/2009,26000000,43318349,17318349,81616.0240912754
The Usual Suspects,7/19/1995,6000000,23341568,17341568,113417.71092217135
The Sisterhood of the Traveling Pants 2,8/6/2008,27000000,44352417,17352417,79203.67800772299
Dinner for Schmucks,7/30/2010,69000000,86387857,17387857,79646.8219795522
Escape to Victory,6/17/1981,10000000,27453418,17453418,190539.4978165939
The November Man,8/27/2014,15000000,32556119,17556119,73755.59906062656
The Covenant,9/8/2006,20000000,37597471,17597471,86729.77328733366
The Quiet Ones,4/1/2014,200000,17834867,17634867,74386.12320307754
How Stella Got Her Groove Back,8/14/1998,20000000,37672350,17672350,108153.91676866585
127 Hours,11/5/2010,18000000,35692920,17692920,80862.3282130501
Breaking Away,5/24/1979,2300000,20000000,17700000,244813.27800829877
The Last House on the Left,3/13/2009,15000000,32721635,17721635,83313.98765449511
Exodus,3/27/1960,4000000,21750000,17750000,601694.9152542372
Ёлки,12/12/2010,5000000,22772019,17772019,81084.4971461682
The Fox and the Hound,7/10/1981,12000000,29800000,17800000,194323.1441048035
Murphy's Romance,12/25/1985,13000000,30867525,17867525,163024.86313868614
The Fisher King,9/9/1991,24000000,41895491,17895491,130433.60787172013
The Sentinel,4/19/2006,60000000,77920346,17920346,88495.53580246914
American Gigolo,2/8/1980,4800000,22743674,17943674,227422.99112801012
A Room with a View,12/13/1985,3000000,20966644,17966644,164379.17657822507
Legend,9/9/2015,25000000,42972994,17972994,75534.2369034861
Mickey's Christmas Carol,10/19/1983,3000000,21000000,18000000,177865.61264822134
Sophie's Choice,12/8/1982,12000000,30036000,18036000,184795.08196721313
That Awkward Moment,1/29/2014,8000000,26049082,18049082,76876.24637428072
Lionheart,6/7/1990,6000000,24078196,18078196,139170.1000769823
Stay Alive,3/24/2006,9000000,27105095,18105095,89851.58808933002
Zack and Miri Make a Porno,9/18/2008,24000000,42105111,18105111,83598.19091022426
Diary of a Wimpy Kid: The Long Haul,5/19/2017,22000000,40120144,18120144,73973.35837194587
Love Happens,9/18/2009,18000000,36133014,18133014,83880.40355819536
Crocodile Dundee in Los Angeles,4/12/2001,21150000,39438674,18288674,103384.25098925947
Thank You for Smoking,9/5/2005,6500000,24793509,18293509,92019.66297786719
Priest,5/5/2011,60000000,78309131,18309131,81026.76089996636
Evolution,6/8/2001,80000000,98376292,18376292,103237.59550561798
Keeping Mum,12/2/2005,169000,18564702,18395702,93474.09552845528
Yentl,11/18/1983,12000000,30400000,18400000,181638.69693978282
Desperado,8/25/1995,7000000,25405445,18405445,120139.98041775457
9,8/19/2009,30000000,48428063,18428063,85327.35253670666
Jungle Fever,6/7/1991,14000000,32482682,18482682,135902.07352941178
The Warriors,2/8/1979,4000000,22490039,18490039,267583.7771345876
The Fury,3/10/1978,5500000,24000000,18500000,291798.10725552053
God's Not Dead 2,4/1/2016,5000000,23507567,18507567,77353.0454190194
An Education,10/29/2009,7500000,26096852,18596852,85965.20131280913
The Way Way Back,6/6/2013,4600000,23198652,18598652,79650.25010278197
The 'Burbs,2/17/1989,18000000,36602000,18602000,152101.39002452986
Because of Winn-Dixie,2/18/2005,14000000,32645546,18645546,96459.11019141231
Honey I Blew Up the Kid,7/16/1992,40000000,58662452,18662452,132451.75301632364
Where the Heart Is,4/27/2000,15000000,33771174,18771174,109452.90962099125
Morning Glory,1/12/2010,40000000,58785180,18785180,86692.69499323909
Ji jie hao,10/9/2007,16000000,34786960,18786960,89917.2952483057
Snatched,5/3/2017,42000000,60845711,18845711,77005.18932877871
Big Eyes,12/24/2014,10000000,28883511,18883511,80799.93752861489
Forces of Nature,3/12/1999,75000000,93888180,18888180,114473.81818181818
Team America: World Police,10/10/2004,32000000,50907422,18907422,99043.59350445258
Amores perros,6/16/2000,2000000,20908467,18908467,109423.99884259258
Rumor Has It...,12/23/2005,70000000,88933562,18933562,95479.38477054967
Death Wish,7/24/1974,3000000,22000000,19000000,380000.0
The Wood,7/16/1999,6000000,25059640,19059640,114061.28067025733
Bugsy,12/10/1991,30000000,49114016,19114016,138607.80275562
The Grudge 2,10/13/2006,20000000,39143839,19143839,94865.40634291378
Tomorrowland,5/19/2015,190000000,209154322,19154322,80265.17989590928
Defiance,12/31/2008,32000000,51155219,19155219,90721.54416674955
How High,12/21/2001,12000000,31155435,19155435,108161.68831168831
Seventh Son,12/12/2014,95000000,114178613,19178613,81676.46031718992
Johnson Family Vacation,4/7/2004,12000000,31179516,19179516,102018.70212765958
The Sword in the Stone,12/25/1963,3000000,22182353,19182353,620788.1229773463
A Passage to India,12/14/1984,8000000,27187653,19187653,182218.92687559355
Joe,7/15/1970,106000,19319254,19213254,492647.53846153844
Elizabeth: The Golden Age,9/9/2007,55000000,74237563,19237563,92270.91467216653
Entourage,6/3/2015,30000000,49263404,19263404,80722.28228530243
The Bye Bye Man,1/12/2017,7400000,26667197,19267197,79341.44433142946
Alpha and Omega,9/17/2010,20000000,39300000,19300000,88244.30412736442
Beasts of the Southern Wild,6/29/2012,1800000,21107746,19307746,84275.02793491165
Sister Act 2: Back in the Habit,12/9/1993,38000000,57319029,19319029,132503.6282578875
The Host,3/22/2013,44000000,63327201,19327201,83116.66401469051
Meet the Robinsons,3/23/2007,150000000,169332978,19332978,93537.9174206284
Brown Sugar,10/5/2002,8000000,27362712,19362712,106799.29398786541
A Low Down Dirty Shame,11/23/1994,10000000,29392418,19392418,129541.87040748163
13 Hours: The Secret Soldiers of Benghazi,1/13/2016,50000000,69411370,19411370,81933.55450877105
The Adventures of Sharkboy and Lavagirl,6/10/2005,50000000,69425966,19425966,99876.43187660669
Twilight Zone: The Movie,6/24/1983,10000000,29450919,19450919,194703.8938938939
The Great Outdoors,6/17/1988,24000000,43455230,19455230,164179.15611814347
In Bruges,2/8/2008,15000000,34533783,19533783,92274.10920531146
Hawaii,10/10/1966,15000000,34562222,19562222,594596.4133738602
Mississippi Burning,12/8/1988,15000000,34604000,19604000,162688.79668049794
Hoosiers,11/14/1986,9000000,28607524,19607524,177604.384057971
Como agua para chocolate,4/16/1992,2000000,21665468,19665468,140769.27702219042
Crimson Peak,10/13/2015,55000000,74679822,19679822,82744.64971955701
Damien: Omen II,6/9/1978,6800000,26518355,19718355,302428.75766871165
Friday the 13th: A New Beginning,3/22/1985,2200000,21930418,19730418,184568.9242282507
The Caine Mutiny,6/24/1954,2000000,21750000,19750000,734200.7434944238
Zodiac,3/2/2007,65000000,84785914,19785914,96351.21157816822
Candyman,10/16/1992,6000000,25792310,19792310,139382.46478873238
Race,2/19/2016,5000000,24804129,19804129,83164.50120101456
Curious George,2/10/2006,50000000,69834815,19834815,99822.92400603926
Green Lantern,6/16/2011,200000000,219851172,19851172,87867.37015430104
Stay Hungry,4/23/1976,5000000,24854765,19854765,351411.7699115044
Network,11/1/1976,3800000,23689877,19889877,342928.9137931034
Florence Foster Jenkins,5/6/2016,29000000,48902953,19902953,82849.91820304791
The Rose,11/7/1979,9250000,29174648,19924648,262511.8313570487
The Natural,5/11/1984,28000000,47951979,19951979,192959.17794970985
The Rocketeer,6/21/1991,42000000,62000000,20000000,146842.87812041116
The Abyss,8/9/1989,70000000,90000098,20000098,160514.43017656502
The Skulls,3/31/2000,15000000,35007180,20007180,116796.14711033273
The Great Gatsby,3/27/1974,6500000,26533200,20033200,417358.3333333333
Whatever Works,6/19/2009,15000000,35097815,20097815,93325.84942721418
Air Bud,8/1/1997,3000000,23144499,20144499,125276.73507462686
Runaway Jury,10/9/2003,60000000,80154140,20154140,108941.2972972973
Freedom Writers,1/5/2007,21000000,41170784,20170784,99650.14623349933
Waitress,5/25/2007,2000000,22179430,20179430,96852.58600829366
Project Almanac,1/29/2015,12000000,32248241,20248241,86264.77705541023
Dumb and Dumberer: When Harry Met Lloyd,6/13/2003,19000000,39267515,20267515,110329.42297223736
Radio,10/24/2003,32000000,52277485,20277485,109905.06775067751
The Killing Fields,11/2/1984,14400000,34700291,20300291,192785.28964862297
Blue Thunder,2/5/1983,22000000,42313354,20313354,207490.8478038815
The Fog,2/8/1980,1000000,21378361,20378361,258280.8745247148
The Perks of Being a Wallflower,9/20/2012,13000000,33400000,20400000,88190.66475875098
Bhaag Milkha Bhaag,7/12/2013,4600000,25000000,20400000,87330.26250449494
The Ninth Gate,8/24/1999,38000000,58401898,20401898,121512.19773674806
Happy Feet Two,11/17/2011,130000000,150406466,20406466,90425.33411322627
Fever Pitch,4/6/2005,30000000,50451307,20451307,105094.07502569373
Ninja Assassin,9/29/2009,40000000,60462347,20462347,94655.52302048785
Taking Lives,3/19/2004,45000000,65470529,20470529,108885.7925531915
Friday the 13th Part 2,5/1/1981,1250000,21722776,20472776,227981.9153674833
Marie Antoinette,5/24/2006,40000000,60474340,20474340,100908.5263676688
The Place Beyond the Pines,3/20/2013,15000000,35485608,20485608,88098.39548275284
"\"バトル・ロワイア�?\"\"In the future\"",12/16/2000,4500000,25000000,20500000,117075.95659623072
Hotel Rwanda,9/11/2004,17500000,38000000,20500000,107951.55344918378
Ernest Goes to Camp,5/22/1987,3000000,23509382,20509382,180699.40088105726
No Way Out,8/14/1987,15000000,35509515,20509515,179278.97727272726
Cinderella Man,6/2/2005,88000000,108539911,20539911,105603.65552699228
Invasion of the Body Snatchers,12/19/1978,3500000,24046533,20546533,300827.7159590044
Once,3/23/2007,160000,20710513,20550513,99428.66473781485
Apollo 18,7/20/2011,5000000,25562924,20562924,90767.50314507051
Dogma,11/12/1999,10000000,30652890,20652890,122714.73559120618
When the Bough Breaks,9/9/2016,10000000,30658387,20658387,85567.48595854665
Dangerous Liaisons,12/16/1988,14000000,34670720,20670720,170691.32947976878
History of the World: Part I,6/12/1981,11000000,31672907,20672907,228177.78145695364
Katy Perry: Part of Me,6/28/2012,12000000,32726956,20726956,90469.63824289406
White Fang,1/18/1991,14000000,34793160,20793160,154251.92878338278
Becoming Jane,3/2/2007,16500000,37311672,20811672,101346.33215162258
The Gauntlet,12/21/1977,5500000,26414658,20914658,334634.528
Amour,7/1/2012,8900000,29844753,20944753,91420.28511069209
Colombiana,7/27/2011,40000000,60965854,20965854,92546.0901807588
The Last Emperor,10/21/1987,23000000,43984230,20984230,181839.0814558059
Teenage Mutant Ninja Turtles III,3/17/1993,21000000,42000000,21000000,145833.33333333334
New in Town,1/30/2009,8000000,29010817,21010817,99017.4840828868
The Elephant Man,10/2/1980,5000000,26010864,21010864,247769.62264150943
Stigmata,9/10/1999,29000000,50041732,21041732,125323.00178677784
Homefront,11/27/2013,22000000,43058898,21058898,90362.53320117228
The Naked Gun 33�? The Final Insult,3/18/1994,30000000,51132598,21132598,143369.05020352782
The Next Three Days,11/18/2010,30000000,51148651,21148651,96490.31613430119
Man of the Year,10/9/2006,20000000,41237648,21237648,105241.0703666997
Missing in Action,11/16/1984,1500000,22812411,21312411,202397.06552706554
Blind Date,3/27/1987,18000000,39321715,21321715,189190.01774622893
A Lonely Place to Die,4/9/2011,4000000,25345000,21345000,94906.31641663628
Mortal Kombat: Annihilation,11/21/1997,30000000,51376861,21376861,132528.5864848109
Neighbors,12/18/1981,8500000,29916207,21416207,227107.17921527041
An Unmarried Woman,5/26/1978,2515000,24000000,21485000,329524.5398773006
This Is Where I Leave You,9/10/2014,19800000,41296320,21496320,90308.90934374093
The Best Years of Our Lives,12/25/1946,2100000,23650000,21550000,1002325.5813953489
Run All Night,3/11/2015,50000000,71561644,21561644,91316.8529427958
Orphan,7/24/2009,20000000,41596251,21596251,100059.54112883049
Daddy's Little Girls,2/14/2007,10000000,31609243,21609243,106188.44810048207
Never Back Down,3/4/2008,20000000,41627431,21627431,101286.15919223709
Mr. Brooks,6/1/2007,20000000,41637263,21637263,103849.55747964983
Dark Skies,2/21/2013,3500000,25174316,21674316,93113.53120851645
Poseidon,5/12/2006,160000000,181674817,21674817,107036.13333333333
The Punisher,4/15/2004,33000000,54700105,21700105,115426.09042553192
Quo Vadis,11/8/1951,8250000,30000000,21750000,823863.6363636364
The Big Parade,11/5/1925,245000,22000000,21755000,1208611.111111111
Barnyard,8/4/2006,51000000,72779000,21779000,106812.16282491416
High Crimes,4/3/2002,42000000,63781810,21781810,121144.66073414905
GoodFellas,9/12/1990,25000000,46836394,21836394,164554.5892991711
House on Haunted Hill,10/29/1999,19000000,40846082,21846082,129804.40879382055
Taps,12/20/1981,14000000,35856053,21856053,231771.50583244965
The Joy Luck Club,9/8/1993,11000000,32861136,21861136,150662.54996554102
Ex Machina,1/21/2015,15000000,36869414,21869414,93171.55613875137
Clerks II,5/25/2006,5000000,26888376,21888376,107877.65401675702
The Legend of Boggy Creek,8/1/1972,100000,22000000,21900000,521428.5714285714
Inside Llewyn Davis,10/6/2013,11000000,32935319,21935319,93922.90597997826
Arthur et les Minimoys,12/13/2006,86000000,107944236,21944236,108742.4975222993
Go,4/9/1999,6500000,28451622,21951622,132079.55475330926
Singham,7/22/2011,3062000,25034000,21972000,96987.35350592597
An American Werewolf in London,8/21/1981,10000000,31973249,21973249,235764.47424892703
Peter Pan,12/25/2003,100000000,121975011,21975011,118655.56695464364
Poltergeist II: The Other Side,5/23/1986,19000000,40996665,21996665,200882.78538812784
The Apartment,6/15/1960,3000000,25000000,22000000,743243.2432432432
The Lawnmower Man,3/5/1992,10000000,32101000,22101000,158657.5735821967
Some Like It Hot,3/18/1959,2883848,25000000,22116152,762625.9310344828
Predator 2,11/20/1990,35000000,57120318,22120318,165323.7518684604
Ernest Saves Christmas,11/11/1988,6000000,28202109,22202109,184556.18453865338
Arachnophobia,8/9/1990,31000000,53208180,22208180,168755.1671732523
Willow,5/1/1988,35000000,57269863,22269863,189530.74893617022
Er ist wieder da,10/8/2015,3196621,25513752,22317131,93833.32772727656
Citizen Kane,4/30/1941,839727,23217674,22377947,1554024.0972222222
Veer-Zaara,11/12/2004,7000000,29385320,22385320,117200.62827225131
Desperately Seeking Susan,3/29/1985,5000000,27400000,22400000,209541.62768942936
Notorious,8/15/1946,2000000,24464742,22464742,1112115.9405940594
Fast Times at Ridgemont High,8/13/1982,4500000,27092880,22592880,231247.4923234391
Mad Max 2,12/24/1981,2000000,24600832,22600832,239669.48038176034
The Tree of Life,5/18/2011,32000000,54674226,22674226,100451.99847600145
Child's Play 2,11/9/1990,13000000,35763605,22763605,170131.576980568
The Reaping,4/5/2007,40000000,62771059,22771059,110172.2371133023
The Guns of Navarone,4/27/1961,6000000,28900000,22900000,768456.3758389262
The Transporter,10/2/2002,21000000,43928932,22928932,126469.56425813568
Killing Them Softly,9/20/2012,15000000,37930465,22930465,99130.04664594473
Run Fatboy Run,9/6/2007,10000000,33000000,23000000,110317.04158472829
John Tucker Must Die,7/27/2006,18000000,41009669,23009669,112847.8126532614
Halloween II,10/30/1981,2500000,25533818,23033818,245825.16542155817
The Shadow,7/1/1994,25000000,48063435,23063435,155413.98247978435
葉問2: 宗師傳奇,4/21/2010,12902809,36000000,23097191,105863.97803628231
House of Wax,4/10/1953,658000,23800000,23142000,870000.0
Eddie the Eagle,2/26/2016,23000000,46152411,23152411,97225.11464229923
The Mothman Prophecies,1/25/2002,32000000,55157539,23157539,130244.87626546681
Killers,6/4/2010,75000000,98159963,23159963,106255.4217420228
Raising Arizona,3/1/1987,6000000,29180280,23180280,206782.15878679752
Ricki and the Flash,7/10/2015,18000000,41325328,23325328,97737.00838871337
Peggy Sue Got Married,10/5/1986,18000000,41382841,23382841,211993.1187669991
T2 Trainspotting,1/27/2017,18000000,41412709,23412709,96110.10127133082
Mother's Day,4/28/2016,25000000,48418160,23418160,97482.65196957902
Sling Blade,8/30/1996,1000000,24444121,23444121,148568.5741444867
The Change-Up,8/5/2011,52000000,75450437,23450437,103513.37261912644
Private Lessons,8/21/1981,2800000,26279000,23479000,251920.6008583691
Arbitrage,9/14/2012,12000000,35485056,23485056,101488.09673000385
Judge Dredd,6/30/1995,90000000,113493481,23493481,154055.6131147541
Les petits mouchoirs,10/20/2010,25000000,48531470,23531470,107546.37733486287
Devil,1/13/2010,10000000,33583175,23583175,108835.20931112618
Stranger Than Fiction,9/9/2006,30000000,53653224,23653224,116575.77131591916
The Outsiders,3/25/1983,10000000,33697647,23697647,240341.24746450305
The One,11/2/2001,49000000,72700000,23700000,133596.39233370914
A Nightmare on Elm Street,11/14/1984,1800000,25504513,23704513,225114.08357075026
Weekend at Bernie's,7/5/1989,6500000,30218387,23718387,190662.27491961414
The Lost Boys,7/31/1987,8500000,32222567,23722567,207365.09615384616
Freddy's Dead: The Final Nightmare,9/5/1991,11000000,34872033,23872033,173994.40962099127
House Party,3/9/1990,2500000,26386000,23886000,185594.4055944056
The Three Musketeers,11/11/1993,30000000,53898845,23898845,163915.26063100135
The Five-Year Engagement,4/27/2012,30000000,53909751,23909751,104039.12277266497
Mad Max Beyond Thunderdome,6/29/1985,12305523,36230219,23924696,221935.95547309832
Jobs,8/16/2013,12000000,35931410,23931410,102205.9030788088
The Hurricane,9/17/1999,50000000,73956241,23956241,142427.11652794294
Max,6/26/2015,20000000,43967255,23967255,100426.78941061118
Excalibur,4/10/1981,11000000,34967437,23967437,268994.8035914703
Nick and Norah's Infinite Playlist,10/3/2008,9000000,32973937,23973937,110696.79507602517
Chinatown,6/20/1974,6000000,30000000,24000000,485829.95951417007
Airport '77,3/11/1977,6000000,30000000,24000000,403361.34453781514
John Carter,3/7/2012,260000000,284139100,24139100,105230.78398549209
The Bridge on the River Kwai,10/2/1957,3000000,27200000,24200000,855123.6749116607
Garden State,7/28/2004,2500000,26781723,24281723,128135.74142480211
Those Magnificent Men in Their Flying Machines or How I Flew from London to Paris in 25 hours 11 minutes,6/3/1965,5600000,29950000,24350000,770569.6202531646
Her,12/18/2013,23000000,47351251,24351251,104102.54535816277
A Clockwork Orange,12/18/1971,2200000,26589000,24389000,593406.3260340632
East Is East,5/14/1999,3800000,28200000,24400000,146811.07099879664
Menace II Society,5/26/1993,3500000,27900000,24400000,168975.06925207755
Halloween II,8/28/2009,15000000,39421467,24421467,113078.57609193912
A Serious Man,10/2/2009,7000000,31430334,24430334,113010.79208241396
A Man for All Seasons,12/12/1966,3900000,28350000,24450000,743161.094224924
Baby Geniuses,3/12/1999,12000000,36450736,24450736,148186.27878787878
The Long Kiss Goodnight,10/11/1996,65000000,89456761,24456761,154496.27921667718
The Roommate,2/4/2011,16000000,40492759,24492759,110672.22300042023
Urban Legends: Final Cut,9/19/2000,14000000,38574362,24574362,141231.9655172414
3 Days to Kill,2/14/2014,28000000,52597999,24597999,104769.97286833261
The Great Mouse Detective,7/2/1986,14000000,38625550,24625550,224890.86757990866
Halloween: Resurrection,7/1/2002,13000000,37664855,24664855,136950.88839533593
Friday,4/26/1995,3500000,28215918,24715918,162391.05124835743
The Hills Have Eyes,7/22/1977,230000,25000000,24770000,404738.56209150323
The Three Stooges,4/13/2012,30000000,54819301,24819301,107870.139296347
Overboard,12/16/1987,1880006,26713187,24833181,214634.23509075193
Jarhead,11/4/2005,72000000,96889998,24889998,125961.52834008097
紅番區,1/30/1995,7500000,32392047,24892047,164957.23658051688
Something Borrowed,5/5/2011,35000000,59901913,24901913,110203.0102140164
The Ghost and the Darkness,10/11/1996,50000000,75000000,25000000,157927.98483891346
The Shining,5/22/1980,19000000,44017374,25017374,302507.5453446191
Rough Night,6/15/2017,20000000,45056771,25056771,102291.32289604213
All About Steve,9/4/2009,15000000,40105542,25105542,116246.0445712116
Delivery Man,10/10/2013,26000000,51164106,25164106,107747.96399852706
Raising Cain,8/7/1992,12000000,37170057,25170057,178637.73598296664
A Walk Among the Tombstones,9/18/2014,28000000,53181600,25181600,106057.70891156663
Secretariat,8/20/2010,35000000,60251371,25251371,115599.18787396024
The Faculty,12/25/1998,15000000,40283321,25283321,153885.09433962262
The Physician,12/25/2013,32000000,57284237,25284237,108091.09680398092
Picture Perfect,8/1/1997,19000000,44332015,25332015,157537.4067164179
In the Heat of the Night,8/2/1967,2000000,27379978,25379978,757611.2835820896
Dressed to Kill,6/25/1980,6500000,31899000,25399000,307122.12817412335
Hostel: Part II,6/8/2007,10200000,35619521,25419521,122002.76935186607
Love the Coopers,11/12/2015,17000000,42426912,25426912,107134.66140829878
La vérité si je mens !,4/1/1997,4000000,29456000,25456000,158901.37328339578
Almost Christmas,11/11/2016,17000000,42487325,25487325,105601.8570309878
The Woman in Black 2: Angel of Death,12/30/2014,1000000,26501323,25501323,109116.64177795274
Vertigo,5/9/1958,2479000,28000000,25521000,883079.5847750865
The Best Man,10/22/1999,9000000,34573780,25573780,151953.53535353535
The Dark Crystal,12/17/1982,15000000,40577001,25577001,261523.52760736196
Cop Out,2/26/2010,30000000,55583804,25583804,117555.88128529483
Hell or High Water,8/12/2016,12000000,37589296,25589296,106246.22066107811
Three Fugitives,1/27/1989,15000000,40590000,25590000,210444.07894736843
The Debt,4/11/2010,20000000,45636368,25636368,117593.16358498961
Bride of Chucky,10/16/1998,25000000,50671850,25671850,156535.67073170733
Out for Justice,4/12/1991,14000000,39673161,25673161,189890.24408284025
The Sweetest Thing,4/12/2002,43000000,68696770,25696770,142918.63181312568
Mar adentro,9/3/2004,12806000,38535221,25729221,135488.26224328595
Sweet November,2/16/2001,40000000,65754228,25754228,146164.74460839955
Populärmusik från Vittula,9/24/2004,2224000,28000000,25776000,135023.57255107386
Taare Zameen Par,12/21/2007,2600000,28430000,25830000,122370.66515065377
Brewster's Millions,5/22/1985,20000000,45833132,25833132,240084.86988847586
Swimfan,9/6/2002,8500000,34411240,25911240,143156.02209944752
Hostage,3/10/2005,52000000,77944725,25944725,134219.99482669425
Shaun of the Dead,4/9/2004,4000000,30039392,26039392,138507.40425531915
Risen,2/19/2016,20000000,46069568,26069568,109475.28261636403
The World's End,7/18/2013,20000000,46089287,26089287,111551.31543503636
Clash of the Titans,3/15/1981,15000000,41092328,26092328,294828.5649717514
The Doctor,7/24/1991,12000000,38120905,26120905,191221.85212298683
Beastly,1/21/2011,17000000,43165571,26165571,118230.93954606455
The Walk,9/30/2015,35000000,61181942,26181942,110083.09017062034
Who's Afraid of Virginia Woolf?,6/21/1966,7500000,33736689,26236689,807282.7384615385
गुरु,1/12/2007,4700000,31000000,26300000,129930.44028140068
Employee of the Month,10/6/2006,12000000,38368909,26368909,130668.52824578791
Movie 43,1/1/2013,6000000,32438988,26438988,114812.35018238665
The Lord of the Rings,11/15/1978,4000000,30471420,26471420,392751.0385756676
Skiptrace,7/21/2016,32000000,58500000,26500000,110027.44458145976
Maximum Risk,9/13/1996,25000000,51702483,26702483,169217.25602027882
Spring Breakers,1/24/2013,5000000,31724284,26724284,115108.51718167173
Wolf Creek,1/1/2005,1000000,27762648,26762648,140339.00367068694
Serpico,12/5/1973,3000000,29800000,26800000,580086.58008658
Space Chimps,7/17/2008,37000000,63800345,26800345,122327.96709967774
Blue Crush,8/8/2002,25000000,51842679,26842679,148548.30658550083
Taxi Driver,2/7/1976,1300000,28262574,26962574,483200.25089605735
A Nightmare on Elm Street Part 2: Freddy's Revenge,10/31/1985,3000000,29999213,26999213,247699.20183486238
The Hurt Locker,10/10/2008,15000000,42000000,27000000,124669.28010416811
Fletch Lives,3/17/1989,8045760,35150960,27105200,220188.46466287572
The Secret Life of Bees,9/17/2008,11000000,38105395,27105395,125155.9289477451
Dancer in the Dark,5/17/2000,12800000,40031879,27231879,157957.5348027842
Texas Chainsaw 3D,1/3/2013,20000000,47241945,27241945,118299.22268542643
Porky's II: The Next Day,6/24/1983,6500000,33759266,27259266,272865.5255255255
American Psycho,4/13/2000,7000000,34266564,27266564,159174.33741973146
Did You Hear About the Morgans?,12/17/2009,58000000,85280250,27280250,125897.03120168722
Cidade de Deus,2/5/2002,3300000,30641770,27341770,153778.23397075364
Jersey Boys,6/5/2014,40000000,67347013,27347013,114738.05817666138
The Night Before,11/20/2015,25000000,52395996,27395996,115827.0626783638
The Quest,4/19/1996,30000000,57400547,27400547,174971.56449553
Oliver!,9/26/1968,10000000,37402877,27402877,776285.4674220964
The Good Son,9/24/1993,17000000,44456478,27456478,188445.28483184628
Cats & Dogs 2 : The Revenge of Kitty Galore,7/30/2010,85000000,112483764,27483764,125892.13602550478
Airlift,1/22/2016,4500000,32000000,27500000,115979.43579167563
Scoop,7/27/2006,4000000,31584901,27584901,135286.41981363413
Planet of the Apes,2/7/1968,5800000,33395426,27595426,806883.8011695906
High Anxiety,12/25/1977,3400000,31063038,27663038,442608.608
Jackie Brown,12/24/1997,12000000,39673162,27673162,171244.81435643564
Lawless,8/29/2012,26000000,53676580,27676580,119601.30851702843
Heartbreak Ridge,12/15/1986,15000000,42724017,27724017,250896.0814479638
The Nanny Diaries,8/24/2007,20000000,47738099,27738099,133042.82699410044
State of Play,4/17/2009,60000000,87784194,27784194,129920.10511746223
Ночной дозор,6/27/2004,4200000,32000000,27800000,146779.303062302
Nine Lives,8/3/2016,30000000,57814445,27814445,115484.992671757
The Last Picture Show,10/3/1971,1300000,29133000,27833000,680513.4474327628
The Pink Panther Strikes Again,12/15/1976,6000000,33833201,27833201,478233.69415807555
A Walk in the Woods,9/2/2015,8000000,35991087,27991087,117636.79421715102
Bob & Carol & Ted & Alice,9/17/1969,2000000,30000000,28000000,750670.2412868633
Death at a Funeral,4/15/2010,21000000,49050886,28050886,128668.4769894821
The Outlaw Josey Wales,6/30/1976,3700000,31800000,28100000,492119.0893169877
Boogie Nights,9/11/1997,15000000,43101594,28101594,174327.50620347395
The Fog,10/14/2005,18000000,46201432,28201432,141573.45381526105
Madea's Big Happy Family,4/22/2011,25000000,53213633,28213633,124858.97311076101
Lions for Lambs,10/22/2007,35000000,63215872,28215872,134248.14323165713
Dead Man Walking,12/29/1995,11000000,39363635,28363635,183702.2992227979
Must Love Dogs,7/21/2005,30000000,58405313,28405313,144629.9032586558
Carol,11/20/2015,11800000,40272135,28472135,120376.85234119014
Cloud Atlas,10/26/2012,102000000,130482868,28482868,123719.67804848385
Super Size Me,1/17/2004,65000,28575078,28510078,153115.34908700324
The Lovely Bones,12/26/2009,65000000,93525586,28525586,131644.1964677161
Date Movie,2/17/2006,20000000,48548426,28548426,142885.015015015
Hot Tub Time Machine,3/26/2010,36000000,64572262,28572262,131060.01128393783
Om Shanti Om,11/7/2007,9100000,37707444,28607444,136111.2015111073
Y tu mamá también,6/8/2001,5000000,33616692,28616692,160767.93258426967
My Week with Marilyn,10/17/2011,6400000,35057696,28657696,126675.04751801265
What About Bob?,5/17/1991,35000000,63710000,28710000,211102.9411764706
Absence of Malice,12/18/1981,12000000,40716963,28716963,304527.70943796396
Point Break,12/3/2015,105000000,133718711,28718711,121419.34679209386
A History of Violence,9/23/2005,32000000,60740827,28740827,144281.26004016065
A Bridge Too Far,6/15/1977,22000000,50750000,28750000,473640.8566721581
Death Race,8/22/2008,45000000,73762516,28762516,131465.95485023974
House of Wax,4/30/2005,40000000,68766121,28766121,147973.8734567901
Miami Vice,7/27/2006,135000000,163794509,28794509,141218.7788131437
Wall Street,12/10/1987,15000000,43848069,28848069,249983.26689774694
From Here to Eternity,8/28/1953,1650000,30500000,28850000,1072490.7063197026
Quarantine,10/10/2008,12000000,40855419,28855419,133236.4560679309
Jaws: The Revenge,7/17/1987,23000000,51881013,28881013,252456.40734265733
[REC],4/10/2007,1500000,30448000,28948000,140057.86555451262
Enemy at the Gates,3/13/2001,68000000,96976270,28976270,164451.02156640182
Benvenuti al nord,1/18/2012,6000000,35000000,29000000,127381.2608987846
The Longest Ride,4/9/2015,34000000,63013281,29013281,122626.38895346134
Snakes on a Plane,8/6/2006,33000000,62022014,29022014,142334.54634624816
The Evil Dead,10/15/1981,350000,29400000,29050000,311027.83725910063
Cabin Fever,8/15/2003,1500000,30553394,29053394,157385.66630552546
Passenger 57,11/5/1992,15000000,44065653,29065653,204687.6971830986
Soul Surfer,4/8/2011,18000000,47088990,29088990,129338.43472384018
The In-Laws,6/15/1979,9000000,38200000,29200000,403872.7524204703
Happy Gilmore,2/16/1996,12000000,41205099,29205099,187572.89017341041
Tommy,3/19/1975,5000000,34251525,29251525,552958.8846880908
Léon,9/14/1994,16000000,45284974,29284974,196017.22891566265
"\"도가�?\"\"Based on actual events that took place at Gwangju Inhwa School for the hearing-impaired\"",9/22/2011,2200000,31500000,29300000,129404.9580206783
Lucky Number Slevin,2/24/2006,27000000,56308881,29308881,146691.0960960961
Sudden Death,12/22/1995,35000000,64350171,29350171,190091.7810880829
Full Metal Jacket,6/26/1987,17000000,46357676,29357676,257976.0632688928
Thelma & Louise,5/24/1991,16000000,45361000,29361000,215889.70588235295
Room,10/16/2015,6000000,35401758,29401758,123882.419860451
Devil's Due,1/8/2014,7000000,36433975,29433975,125831.38819063254
Salmon Fishing in the Yemen,9/10/2011,5000000,34564651,29564651,130304.47046793807
Giant,10/10/1956,5400000,35000000,29600000,1076363.6363636365
Psycho II,6/3/1983,5000000,34725000,29725000,298743.7185929648
Casino Royale,4/13/1967,12000000,41744718,29744718,898631.9637462235
Out of Sight,6/26/1998,48000000,77745568,29745568,182264.5098039216
She's Out of My League,3/11/2010,20000000,49779728,29779728,136835.87356580634
Can't Buy Me Love,8/14/1987,1800000,31623833,29823833,260697.84090909088
Cop Land,8/15/1997,15000000,44862187,29862187,185710.11815920396
Lake Placid,7/15/1999,27000000,56870414,29870414,179186.64667066588
Night of the Living Dead,10/1/1968,114000,30000000,29886000,846628.895184136
Exit Wounds,3/13/2001,50000000,79958599,29958599,170026.1010215664
Gabbar Is Back,5/1/2015,11000000,41000000,30000000,126153.78145959925
A Walk in the Clouds,8/11/1995,20000000,50012507,30012507,196288.46958796598
The Forest,1/7/2016,10000000,40055439,30055439,126861.16176197471
Boomerang,6/30/1992,40000000,70100000,30100000,214234.87544483985
La Vérité si je Mens ! 2,2/7/2001,12560000,42700000,30140000,171444.8236632537
Pitch Black,2/18/2000,23000000,53187659,30187659,176329.78387850468
Rosemary's Baby,6/12/1968,3200000,33395426,30195426,870185.1873198847
Nightcrawler,10/23/2014,8500000,38697217,30197217,127872.49260007367
A Walk to Remember,1/25/2002,11000000,41227069,30227069,170006.0123734533
Blow,4/4/2001,53000000,83282296,30282296,171183.1317128321
Final Destination,3/16/2000,23000000,53302314,30302314,176896.1704611792
My Name Is Khan,2/12/2010,12000000,42345360,30345360,140007.4743587969
Friday the 13th: The Final Chapter,4/13/1984,2600000,32980880,30380880,294673.9088263822
Muppets Most Wanted,3/20/2014,50000000,80383290,30383290,128160.60099885266
Gifted,4/12/2017,7000000,37461045,30461045,124572.8231175672
Bill & Ted's Excellent Adventure,2/17/1989,10000000,40485039,30485039,249264.42354865087
Great Expectations,1/19/1998,25000000,55494066,30494066,188351.24150710314
Day of the Dead,7/19/1985,3500000,34000000,30500000,282407.4074074074
The Last Boy Scout,12/11/1991,29000000,59509925,30509925,221246.73676577228
The Mortal Instruments: City of Bones,8/21/2013,60000000,90565421,30565421,130538.33670013538
Memento,10/11/2000,9000000,39723096,30723096,176569.5172413793
The Texas Chain Saw Massacre,10/1/1974,85000,30859000,30774000,602230.9197651664
Do the Right Thing,6/30/1989,6500000,37295445,30795445,247551.808681672
Agent Cody Banks,3/14/2003,28000000,58795814,30795814,167186.8295331162
South Pacific,3/18/1958,6000000,36800000,30800000,1065743.9446366783
The Switch,5/11/2010,19000000,49830607,30830607,141309.42166487913
Harlem Nights,11/17/1989,30000000,60864870,30864870,244765.0277557494
Snake Eyes,8/7/1998,73000000,103891409,30891409,189053.9106487148
2016: Obama's America,7/13/2012,2500000,33400000,30900000,134873.24533836162
Doubt,11/27/2008,20000000,50907234,30907234,147017.68556043913
Crank,8/31/2006,12000000,42931041,30931041,152444.75603745686
Strictly Ballroom,8/20/1992,3000000,33946224,30946224,219010.7855626327
The Wizard of Oz,8/15/1939,2777000,33754967,30977967,2244780.217391304
Jumping the Broom,5/6/2011,6600000,37710610,31110610,137679.49761908976
50/50,9/30/2011,8000000,39187783,31187783,137742.44880112712
The Big Lebowski,3/6/1998,15000000,46189568,31189568,192290.80147965476
Psycho,6/16/1960,806948,32000000,31193052,1053819.3243243243
The Kids Are All Right,7/9/2010,3500000,34705850,31205850,143138.8783134796
Broadcast News,12/16/1987,20000000,51249404,31249404,270089.9222126188
Friday Night Lights,10/8/2004,30000000,61255921,31255921,163729.2875851231
Mars Attacks!,12/12/1996,70000000,101371017,31371017,197799.6027742749
Daybreakers,1/6/2009,20000000,51416464,31416464,148792.35399705413
Cellular,9/6/2004,25000000,56422687,31422687,165469.65244865717
Cradle 2 the Grave,2/28/2003,25000000,56489558,31489558,170953.08360477744
Harold & Kumar Escape from Guantanamo Bay,4/25/2008,12000000,43493123,31493123,145376.13556630598
Tombstone,12/25/1993,25000000,56505065,31505065,215492.92065663476
Bowling for Columbine,10/9/2002,4000000,35564473,31564473,174100.7887479316
The Salvation,5/22/2014,10500000,42070000,31570000,132456.16611354225
Biloxi Blues,3/25/1988,20000000,51684798,31684798,270578.97523484204
Young Guns,8/12/1988,13000000,44726644,31726644,266610.4537815126
Land of the Dead,6/24/2005,15000000,46770602,31770602,162592.64073694983
Hachi: A Dog's Tale,6/13/2009,16000000,47801389,31801389,147438.2061541172
Red Eye,8/4/2005,26000000,57891803,31891803,162381.88900203665
The Robe,9/16/1953,4100000,36000000,31900000,1181481.4814814816
The Object of My Affection,4/17/1998,15000000,46905889,31905889,195982.11916461916
El secreto de sus ojos,8/13/2009,2000000,33965843,31965843,148103.83442831066
Dirty Harry,12/21/1971,4000000,35976000,31976000,778004.8661800487
Carrie,11/3/1976,1800000,33800000,32000000,551724.1379310344
The Greatest Show on Earth,1/10/1952,4000000,36000000,32000000,1207547.1698113207
Single White Female,8/14/1992,16000000,48017402,32017402,227234.93257629522
Hannibal Rising,2/6/2007,50000000,82169884,32169884,158083.74488326724
The Wedding Date,2/4/2005,15000000,47175038,32175038,167753.06569343066
Earth to Echo,6/14/2014,13000000,45300000,32300000,135518.9789505041
Silent Hill: Revelation 3D,10/10/2012,20000000,52302796,32302796,139647.30651011382
The Fourth Kind,11/6/2009,10000000,42333295,32333295,149462.83455831368
Bachelor Party,6/29/1984,6000000,38435947,32435947,311584.5052833814
Crazy Heart,12/16/2009,7000000,39462438,32462438,149812.57758887243
Set It Off,11/6/1996,9000000,41590886,32590886,205491.08448928123
Runner Runner,9/24/2013,30000000,62616646,32616646,139658.33711560036
Friday the 13th Part III,8/13/1982,4000000,36690067,32690067,334596.3868986694
Kick-Ass 2,7/17/2013,28000000,60700000,32700000,139817.08333867803
Midnight Express,9/12/1978,2300000,35000000,32700000,491729.32330827066
Zoolander,9/28/2001,28000000,60780981,32780981,184473.72537985368
Darkman,8/24/1990,16000000,48878502,32878502,247765.65184626981
Fireproof,9/26/2008,500000,33456317,32956317,152171.8635286947
"\"कि�?\"\"An adrenaline junkie walks away from a whirlwind romance and embraces a new life as a thief\"",7/25/2014,22000000,55000000,33000000,138741.738560113
Three Kings,9/27/1999,75000000,108000000,33000000,196195.00594530322
Edward Scissorhands,12/5/1990,20000000,53000000,33000000,246636.7713004484
The Man from U.N.C.L.E.,8/13/2015,75000000,108145109,33145109,139080.50235821347
National Lampoon’s Van Wilder,3/29/2002,5000000,38275483,33275483,185069.42714126807
Hellboy,4/2/2004,66000000,99318987,33318987,177228.65425531915
Ghost Ship,10/25/2002,35000000,68349884,33349884,183948.61555432982
Two Weeks Notice,12/19/2002,60000000,93354918,33354918,183571.370390754
Side Effects,2/7/2013,30000000,63372757,33372757,143745.23832085662
Cats & Dogs,7/4/2001,60000000,93375151,33375151,188029.01971830986
Whale Rider,1/30/2003,8000000,41400000,33400000,182413.98143091207
Courageous,9/30/2011,1000000,34522221,33522221,148052.61437764164
Kiss the Girls,10/3/1997,27000000,60527873,33527873,207474.46163366336
The Little Prince,7/29/2015,64000000,97571250,33571250,140868.63660014435
The Grudge 3,5/12/2009,5000000,38610009,33610009,157161.87060451895
Hannah and Her Sisters,2/7/1986,6400000,40084041,33684041,308179.69807868253
The Judge,10/8/2014,50000000,83719388,33719388,142016.4341098331
Marmaduke,6/4/2010,50000000,83761844,33761844,154895.71261441056
Hanna,4/7/2011,30000000,63782078,33782078,150205.3213342463
Baby Mama,4/23/2008,30000000,63833449,33833449,156179.36869899184
Caddyshack,7/25/1980,6000000,39846344,33846344,406318.65546218486
Woodstock,3/26/1970,600000,34505110,33905110,880652.2077922078
Guess Who,3/25/2005,35000000,68915888,33915888,174285.13874614594
We Own the Night,5/25/2007,21000000,54926886,33926886,162834.46283213023
Amadeus,10/26/1984,18000000,51973029,33973029,322630.8547008547
விஸ்வரூபம்,1/25/2013,17000000,51000000,34000000,146446.9388282522
Ghoulies,11/8/1984,1000000,35000000,34000000,322886.98955365625
The Women,9/12/2008,16000000,50007546,34007546,155439.61825187516
Marked for Death,10/5/1990,12000000,46044400,34044400,255014.23220973782
Unlawful Entry,6/26/1992,23000000,57138719,34138719,242980.20640569396
Red Dawn,8/10/1984,4200000,38376497,34176497,327047.8181818182
Good Luck Chuck,9/21/2007,25000000,59192128,34192128,163648.81111919438
Magic in the Moonlight,7/25/2014,16800000,51029361,34229361,143910.3349982342
Annie Hall,4/19/1977,4000000,38251425,34251425,568016.9983416252
License to Wed,7/4/2007,35000000,69307224,34307224,164701.81805961623
The Imaginarium of Doctor Parnassus,10/1/2009,30000000,64352607,34352607,158909.62960907034
Recess: School's Out,1/27/2001,10000000,44460850,34460850,196023.03754266212
Notes on a Scandal,12/25/2006,15000000,49469904,34469904,170292.38795352145
Burlesque,11/23/2010,55000000,89519773,34519773,157495.8047988174
Allied,11/17/2016,85000000,119520023,34520023,142980.31329732595
The Godfather: Part II,12/20/1974,13000000,47542841,34542841,663010.3838771593
Milk,11/26/2008,20000000,54586584,34586584,164519.3979869475
Escape from Planet Earth,2/14/2013,40000000,74597643,34597643,149021.14435360907
The Darkest Hour,12/22/2011,30000000,64626786,34626786,152766.3556349679
Дневной дозор,1/1/2006,4200000,38862717,34662717,174799.37972768533
Shooter,3/22/2007,61000000,95696996,34696996,167872.98607549616
The Best Little Whorehouse in Texas,7/23/1982,35000000,69701637,34701637,355185.63971340837
21,3/27/2008,35000000,69823199,34823199,162101.81870656306
Ultimo tango a Parigi,10/14/1972,1250000,36144000,34894000,824917.2576832152
Pee-wee's Big Adventure,7/26/1985,6000000,40940662,34940662,323524.64814814815
Planet 51,11/19/2009,70000000,104945765,34945765,161824.15755571917
The Crazies,2/26/2010,20000000,54956140,34956140,160621.1431275875
Chef,5/8/2014,11000000,45967935,34967935,146985.85540142917
Dilwale,12/18/2015,26000000,61000000,35000000,147731.6854919043
Escape from Alcatraz,6/22/1979,8000000,43000000,35000000,478796.169630643
How the West Was Won,11/1/1962,15000000,50000000,35000000,1151315.7894736843
The Deer Hunter,12/8/1978,15000000,50000000,35000000,516986.70605612994
The DUFF,2/20/2015,8500000,43528634,35028634,148351.61084029663
Barbershop: The Next Cut,4/15/2016,20000000,55030051,35030051,146409.36466870908
21 & Over,3/1/2013,13000000,48065672,35065672,150643.21033796875
The Black Stallion,10/17/1979,2700000,37799643,35099643,462445.88932806323
The Sword and the Sorcerer,4/1/1982,4000000,39103425,35103425,369899.1043203372
Child's Play,11/8/1988,9000000,44196684,35196684,292574.26433915214
La mala educación,3/19/2004,5000000,40266982,35266982,187590.32978723405
The Lady in the Van,11/13/2015,6000000,41387687,35387687,149103.74742980415
Dhoom 2,11/24/2006,11000000,46396427,35396427,175403.50346878095
Derailed,11/11/2005,22000000,57479076,35479076,179549.97975708504
Flatliners,8/9/1990,26000000,61489265,35489265,269675.2659574468
The Last of the Mohicans,9/25/1992,40000000,75505856,35505856,250393.90691114243
எந்திரன்,10/1/2010,26400000,62000000,35600000,162771.8770432214
The Born Losers,8/18/1967,360000,36000000,35640000,1060714.2857142857
Astérix aux Jeux Olympiques,1/13/2008,97250400,132900000,35649600,168891.4155770324
Norbit,2/8/2007,60000000,95673607,35673607,175301.141528951
Broken Flowers,5/17/2005,10000000,45742101,35742101,183764.01542416454
Rear Window,8/1/1954,1000000,36764313,35764313,1329528.3643122676
Around the World in Eighty Days,10/17/1956,6000000,42000000,36000000,1309090.9090909092
Hoodwinked!,12/16/2005,15000000,51053787,36053787,181814.35703479574
Адмиралъ,6/6/2008,2000000,38135878,36135878,165143.5139272902
Paycheck,12/25/2003,60000000,96269812,36269812,195841.31749460046
Miracle,2/6/2004,28000000,64445708,36445708,195734.19978517725
The Cabin in the Woods,4/12/2012,30000000,66486080,36486080,158576.5260664537
Bajirao Mastani,12/18/2015,19500000,56000000,36500000,154063.04344155735
About Last Night,2/14/2014,12500000,49002684,36502684,155475.4601096341
Tom Jones,10/6/1963,1000000,37600000,36600000,1188311.6883116884
S.W.A.T.,8/8/2003,80000000,116643346,36643346,198501.33261105092
Mannequin,2/13/1987,6000000,42721196,36721196,329042.9749103943
Bullitt,10/17/1968,5500000,42300873,36800873,1039572.6836158192
The Return of the Pink Panther,5/21/1975,5000000,41833347,36833347,687189.3097014925
Superman III,6/17/1983,39000000,75850624,36850624,368875.11511511507
The Witch,2/19/2016,3500000,40423945,36923945,155056.62825659718
The Island,7/20/2005,126000000,162949164,36949164,188132.199592668
Doctor Who,3/31/1996,5000000,42000000,37000000,236724.248240563
Finding Forrester,12/21/2000,43000000,80049764,37049764,211592.02741290693
Takers,8/26/2010,32000000,69055695,37055695,169638.64053580177
Frequency,4/28/2000,31000000,68106245,37106245,216362.944606414
The Enforcer,12/20/1976,9000000,46236000,37236000,636512.8205128205
The Shack,3/3/2017,20000000,57330873,37330873,153120.26201697288
Kokowääh,2/2/2011,5650000,43000000,37350000,168768.5543742008
Time Bandits,7/13/1981,5000000,42365581,37365581,407921.1899563319
House at the End of the Street,9/21/2012,6900000,44287131,37387131,161627.25178002482
Hard to Kill,2/9/1990,10000000,47410000,37410000,292265.625
Des hommes et des dieux,5/18/2010,4000000,41424067,37424067,171697.59823824925
Mirrors,8/15/2008,35000000,72436439,37436439,170875.54202459307
10 Things I Hate About You,3/30/1999,16000000,53478166,37478166,225500.39711191336
Rat Race,7/30/2001,48000000,85498534,37498534,211259.34647887325
Wild,12/5/2014,15000000,52501541,37501541,159708.79256596765
RV,4/28/2006,50000000,87528173,37528173,185324.3111111111
Precious,11/6/2009,10000000,47536959,37536959,173517.12198955298
Tremors,1/19/1990,11000000,48572000,37572000,293531.25
Drumline,12/13/2002,20000000,57588485,37588485,207785.98673300166
Little Man,8/31/2006,64000000,101595121,37595121,185288.91572203056
West Side Story,10/18/1961,6000000,43656822,37656822,1255227.4
Firewall,2/10/2006,45000000,82800000,37800000,190236.53749370913
Fight Club,10/15/1999,63000000,100853753,37853753,225052.0392390012
Beyond the Valley of the Dolls,7/17/1970,2090000,40000000,37910000,972051.282051282
Agneepath,1/25/2012,11097000,49028000,37931000,166610.2967983379
Savages,7/6/2012,45000000,82966152,37966152,165715.79719254136
Big Fat Liar,2/8/2002,15000000,52970014,37970014,213554.6344206974
The Verdict,12/8/1982,16000000,53977250,37977250,389111.1680327869
Amistad,12/3/1997,36000000,74000000,38000000,235585.8648481091
Hotel for Dogs,1/16/2009,35000000,73034460,38034460,179244.64991776354
Halloween: H20,8/5/1998,17000000,55041738,38041738,232813.57405140757
Contraband,1/12/2012,25000000,63100000,38100000,168089.4712461121
Сталинград,10/9/2013,30000000,68129518,38129518,163263.4170570252
Funny Girl,9/19/1968,14000000,52223306,38223306,1082813.2011331446
Yeh Jawaani Hai Deewani,5/31/2013,7700000,46000000,38300000,164022.8861175826
Shanghai Knights,2/6/2003,50000000,88323487,38323487,209303.5882031677
The X Files: I Want to Believe,7/24/2008,30000000,68369434,38369434,175134.12084752106
The Color of Money,10/7/1986,13800000,52293982,38493982,348993.4904805077
The Lizzie McGuire Movie,4/25/2003,17000000,55534455,38534455,209997.02997275203
L'arnacoeur,3/17/2010,8700000,47355187,38655187,177310.05141989552
The Wrestler,9/7/2008,6000000,44703995,38703995,176905.86105867458
狄仁傑之通天帝國,9/18/2010,13000000,51723285,38723285,177052.29732386573
47 Meters Down,6/15/2017,5500000,44235023,38735023,158131.17919617888
Major League,2/16/1989,11000000,49797148,38797148,317229.33769419463
Message in a Bottle,2/22/1999,80000000,118880016,38880016,235636.4606060606
Still Alice,12/5/2014,5000000,43884652,38884652,165599.08352213685
Oculus,9/8/2013,5000000,44030246,39030246,166689.78300142218
The Mist,11/21/2007,18000000,57096190,39096190,186140.42354643965
New Jack City,3/8/1991,8500000,47624253,39124253,289809.2814814815
Nutty Professor II: The Klumps,7/27/2000,84000000,123307945,39307945,227476.5335648148
The French Connection,10/9/1971,1800000,41158757,39358757,962316.7970660147
Kiss of the Dragon,7/6/2001,25000000,64437847,39437847,222185.05352112677
Luftslottet som sprängdes,11/27/2009,4000000,43498108,39498108,182904.79696595029
Footloose,10/6/2011,24000000,63543328,39543328,174645.1433391779
From Hell,10/19/2001,35000000,74558115,39558115,222988.24689966178
We Were Soldiers,3/1/2002,75000000,114660784,39660784,221816.46532438477
What to Expect When You're Expecting,5/17/2012,40000000,79700000,39700000,173001.33346115967
EverAfter,7/31/1998,26000000,65705772,39705772,242997.38066095472
A Nightmare on Elm Street 3: Dream Warriors,2/27/1987,5000000,44793222,39793222,354979.67885816237
Cleopatra,6/12/1963,31115000,71000000,39885000,1303431.3725490195
The Dirty Dozen,6/15/1967,5400000,45300000,39900000,1198198.1981981983
Captain Phillips,10/10/2013,55000000,95000000,40000000,171272.46880700163
RoboCop,7/17/1987,13000000,53000000,40000000,349650.34965034964
Selena,3/21/1997,20000000,60000000,40000000,249687.89013732836
Remember Me,3/12/2010,16000000,56032889,40032889,183948.46781938235
Why Did I Get Married Too?,4/2/2010,20000000,60072596,40072596,183811.6591516864
The Longest Day,9/25/1962,10000000,50100000,40100000,1319078.9473684211
Smokin' Aces,12/9/2006,17000000,57103895,40103895,198730.89692765113
The Longest Yard,8/21/1974,2900000,43008075,40108075,792649.7035573123
Blair Witch,9/15/2016,5000000,45172994,40172994,166397.41040807197
Why Did I Get Married?,10/12/2007,15000000,55184721,40184721,192330.28774361528
Star Trek V: The Final Frontier,6/9/1989,30000000,70200000,40200000,323932.3126510878
One Hour Photo,8/21/2002,12000000,52223306,40223306,222228.20994475138
Revolutionary Road,12/19/2008,35000000,75225693,40225693,190513.97867795758
Boyhood,6/5/2014,4000000,44349000,40349000,169289.637203526
The Count of Monte Cristo,1/23/2002,35000000,75395048,40395048,227193.74578177725
Fences,12/16/2016,24000000,64414761,40414761,166426.15477744513
21 Grams,9/6/2003,20000000,60427839,40427839,218292.86717062636
Hairspray,7/13/2007,50000000,90450008,40450008,194192.04124839773
Colors,4/15/1988,6000000,46616067,40616067,346849.41929974384
No Good Deed,9/10/2014,13200000,53830415,40630415,170693.79618621102
The Age of Adaline,4/16/2015,25000000,65663276,40663276,170994.2011311789
The Mighty Ducks,10/1/1992,10000000,50752337,40752337,287393.0677009873
Under the Tuscan Sun,4/30/2003,18000000,58878723,40878723,222772.33242506813
Scarface,12/8/1983,25000000,65884703,40884703,403600.22704837116
Brick Mansions,4/22/2014,28000000,68896829,40896829,171907.64606977723
Monster's Ball,11/11/2001,4000000,44909486,40909486,230605.89627959413
赤壁 2,1/7/2009,80000000,121059225,41059225,194461.69183918007
August Rush,11/21/2007,25000000,66122026,41122026,195785.60818145462
End of Watch,9/20/2012,7000000,48126384,41126384,177792.31098449315
Joy,12/24/2015,60000000,101134059,41134059,173622.96763409817
Step Up All In,7/16/2014,45000000,86165646,41165646,173072.52409061097
Midnight Cowboy,5/25/1969,3600000,44785053,41185053,1125274.6721311475
Fool's Gold,2/7/2008,70000000,111231041,41231041,194768.08869447737
Into the Wild,9/11/2007,15000000,56255142,41255142,197875.87893903782
Papillon,12/13/1973,12000000,53267000,41267000,893225.1082251081
Misery,11/28/1990,20000000,61276872,41276872,308496.8011958146
Grand Masti,9/13/2013,5500000,47000000,41500000,177237.5709484132
Hable con ella,3/14/2002,9285469,51001550,41716081,233311.4149888143
Le Pacte des loups,1/31/2001,29000000,70752904,41752904,237502.29806598407
St. Vincent,10/9/2014,13000000,54837234,41837234,176206.48351324373
Legion,1/21/2010,26000000,67918658,41918658,193404.37665231773
The Giver,8/11/2014,25000000,66980456,41980456,176498.22578746447
Prophecy,1/1/1979,12000000,54000000,42000000,614934.1142020498
The Last King of Scotland,9/1/2006,6000000,48027970,42027970,207136.37259733857
Capote,9/30/2005,7000000,49084830,42084830,211269.22690763054
Bienvenue chez les ch'tis,1/9/2008,11000000,53191886,42191886,199885.7589539511
Be Cool,3/4/2005,53000000,95226116,42226116,218448.6083807553
Power Rangers,3/23/2017,100000000,142337240,42337240,173141.45032798417
U.S. Marshals,3/6/1998,60000000,102367405,42367405,261204.7163995068
Bedazzled,10/19/2000,48000000,90383208,42383208,243441.74612291786
Surrogates,9/24/2009,80000000,122444772,42444772,196342.68215397568
The Back-Up Plan,4/23/2010,35000000,77477008,42477008,194689.69373630706
The Goonies,6/6/1985,19000000,61503218,42503218,395011.3197026022
Life,3/22/2017,58000000,100541806,42541806,173978.0389655003
Spirit: Stallion of the Cimarron,5/24/2002,80000000,122563539,42563539,236595.54752640356
The Gallows,7/10/2015,100000,42664410,42564410,178351.96560711323
Now You See Me,5/29/2013,75000000,117698894,42698894,182861.50986706867
Sinister 2,8/19/2015,10000000,52882018,42882018,180218.19327995967
Staying Alive,7/11/1983,22000000,64892670,42892670,429356.05605605606
Death Wish 2,2/20/1982,2000000,45000000,43000000,455026.45502645505
Always,12/22/1989,31000000,74134790,43134790,338577.6295133438
Oliver & Company,11/18/1988,31000000,74151346,43151346,358102.45643153525
La Guerre du feu,12/15/1981,12000000,55260558,43260558,460218.7021276596
Abraham Lincoln: Vampire Hunter,6/20/2012,69000000,112265139,43265139,188844.97433479992
Body of Lies,10/10/2008,70000000,113280098,43280098,199840.69112954984
The BFG,6/1/2016,140000000,183345589,43345589,179843.78345185835
Dan in Real Life,10/26/2007,25000000,68377859,43377859,206387.27834158827
प्रे�?रत�?धन पायो,11/11/2015,23400000,67000000,43600000,183705.80105841506
The Time Machine,3/4/2002,80000000,123729176,43729176,244570.3355704698
Bull Durham,6/15/1988,7000000,50888000,43888000,371932.2033898305
Throw Momma from the Train,12/11/1987,14000000,57915972,43915972,380554.3500866551
Airport 1975,10/18/1974,3000000,47000000,44000000,854368.9320388349
Syriana,11/23/2005,50000000,94000000,44000000,223577.2357723577
Chennai Express,8/9/2013,18000000,62000000,44000000,188133.078498527
Charlie Wilson's War,12/19/2007,75000000,119000410,44000410,208453.71423157095
Mike and Dave Need Wedding Dates,7/7/2016,33000000,77068246,44068246,183138.47931246573
Deliverance,7/30/1972,2000000,46122355,44122355,1050532.261904762
Escape from New York,5/22/1981,6000000,50244700,44244700,488352.09713024285
Stand by Me,8/22/1986,8000000,52287414,44287414,401882.1597096189
Frida,8/29/2002,12000000,56298474,44298474,244742.9502762431
The Eye,2/1/2008,12000000,56309766,44309766,209311.43684486495
National Lampoon's Christmas Vacation,12/1/1989,27000000,71320000,44320000,351467.08961141953
Under Siege 2: Dark Territory,7/13/1995,60000000,104324083,44324083,290649.7245901639
One Day,3/2/2011,15000000,59389433,44389433,198639.76784044175
써니,5/4/2011,3550000,48000000,44450000,196712.75070365192
Silver Streak,12/3/1976,6500000,51079064,44579064,765963.2989690722
Made of Honor,5/2/2008,40000000,84601681,44601681,205886.854204365
Honey,11/24/2003,18000000,62646763,44646763,242250.4774823657
The Men Who Stare at Goats,10/17/2009,24000000,68729358,44729358,206764.47094716405
The Prince of Tides,12/25/1991,30000000,74787599,44787599,324312.8095582911
The Bank Job,2/28/2008,20000000,64822796,44822796,209915.3085309655
Just Like Heaven,9/16/2005,58000000,102854431,44854431,225172.8463855422
Dog Day Afternoon,8/11/1975,1800000,46665856,44865856,826258.8581952119
The Money Pit,3/15/1986,10000000,54999651,44999651,413599.73345588235
Valley of the Dolls,12/27/1967,5000000,50000000,45000000,1319648.0938416421
Sleeping Beauty,1/28/1959,6000000,51000000,45000000,1557093.4256055364
Swordfish,6/7/2001,102000000,147080413,45080413,253260.74719101124
Along Came a Spider,4/6/2001,60000000,105178561,45178561,255390.39570378745
Gangster Squad,1/10/2013,60000000,105200903,45200903,196286.70748653813
Any Given Sunday,12/16/1999,55000000,100230832,45230832,267955.16587677726
An Inconvenient Truth,1/24/2006,1000000,46243000,45243000,227695.01761449422
The Lincoln Lawyer,3/17/2011,40000000,85412898,45412898,201919.45968537967
The House Bunny,8/22/2008,25000000,70442940,45442940,207707.82007742833
The American,8/31/2010,20000000,65464324,45464324,208132.81511085475
30 Days of Night,10/17/2007,30000000,75505973,45505973,216512.6203152581
Street Kings,4/10/2008,20000000,65569869,45569869,212127.5142791973
The Fly,8/15/1986,15000000,60629159,45629159,415944.9316317229
Sudden Impact,12/7/1983,22000000,67642693,45642693,450569.526159921
Galaxy Quest,12/23/1999,45000000,90683916,45683916,270639.3127962085
Napoleon Dynamite,6/11/2004,400000,46118097,45718097,241002.09277807066
Son of God,2/28/2014,22000000,67800064,45800064,193827.42611926718
The China Syndrome,3/16/1979,5900000,51718367,45818367,648985.3682719547
Black Mass,9/4/2015,53000000,98837872,45837872,192640.61863035575
The American President,11/17/1995,62000000,107879496,45879496,298889.2247557003
Pet Sematary,4/21/1989,11500000,57469467,45969467,371320.41195476573
ゲド戦記,7/29/2006,22000000,68000000,46000000,225600.78469838155
The Counselor,10/25/2013,25000000,71009334,46009334,197406.49335604478
Underworld: Blood Wars,11/28/2016,35000000,81093313,46093313,190916.33669107658
Jeepers Creepers 2,8/8/2003,17000000,63102666,46102666,249743.58613217768
The Thin Red Line,12/25/1998,52000000,98126565,46126565,280745.98295800365
Think Like a Man Too,6/20/2014,24000000,70181428,46181428,193836.00419727177
Leaving Las Vegas,10/27/1995,3600000,49800000,46200000,300781.25
War Dogs,8/17/2016,40000000,86234523,46234523,191504.39468495784
Open Range,8/29/2003,22000000,68296293,46296293,249979.98380129592
National Lampoon's Vacation,7/28/1983,15000000,61399552,46399552,463069.3812375249
Bewitched,6/21/2005,85000000,131426169,46426169,237595.54247697032
Walking With Dinosaurs,12/18/2013,80000000,126546518,46546518,198988.1752423947
Krampus,11/26/2015,15000000,61548707,46548707,196802.48176725506
Coach Carter,1/14/2005,30000000,76669806,46669806,244728.9250131096
The Siege,11/6/1998,70000000,116672912,46672912,284590.9268292683
Dragnet,6/25/1987,20000000,66673516,46673516,410136.3444639719
Selma,12/25/2014,20000000,66787908,46787908,200199.00131361064
The Illusionist,8/18/2006,40000000,86915017,46915017,231222.36076885165
Hitman: Agent 47,8/20/2015,35000000,81967450,46967450,197387.84172813044
Barbershop 2:  Back in Business,1/20/2004,18000000,65070412,47070412,252794.90870032224
Home Alone 3,12/12/1997,32000000,79082515,47082515,291894.07935523865
Abduction,9/22/2011,35000000,82087155,47087155,207962.84355249733
ParaNorman,8/3/2012,60000000,107139399,47139399,204616.7359004076
Hall Pass,2/25/2011,36000000,83160734,47160734,211041.15596486282
Red Riding Hood,3/11/2011,42000000,89162162,47162162,211047.54617012801
Boogeyman,2/4/2005,20000000,67192859,47192859,246052.44525547445
Wild Things,3/20/1998,20000000,67200000,47200000,290461.53846153844
Four Brothers,8/11/2005,45000000,92374674,47374674,241215.24439918532
The Book of Life,10/1/2014,50000000,97437106,47437106,199791.54540438778
Chi bi,7/10/2008,80341000,127814609,47473609,215824.44854612573
Commando,10/3/1985,10000000,57500000,47500000,436982.52069917205
Snowpiercer,8/1/2013,39200000,86758912,47558912,203350.1028318304
The Number 23,2/23/2007,30000000,77566815,47566815,231635.50878491564
공조,1/18/2017,8520000,56100000,47580000,195317.79165281216
Silent Hill,4/21/2006,50000000,97607453,47607453,235098.53333333333
The Transporter Refueled,9/3/2015,25000000,72629670,47629670,200170.9218516884
La Bamba,7/24/1987,6500000,54215416,47715416,417092.7972027972
Spawn,7/31/1997,40000000,87840042,47840042,297512.6990049751
Fantastic Four,8/5/2015,120000000,167977596,47977596,201319.2400006714
Spartacus,10/6/1960,12000000,60000000,48000000,1610738.255033557
Star Trek: Insurrection,12/10/1998,70000000,118000000,48000000,292861.5009151922
Season of the Witch,1/7/2011,40000000,88100000,48100000,218414.97028012513
Down and Out in Beverly Hills,1/31/1986,14000000,62134225,48134225,440386.3220494053
Nacho Libre,6/16/2006,32000000,80197993,48197993,236845.17444717445
Bonnie and Clyde,7/18/1967,2500000,50700000,48200000,1438805.9701492537
The Boxtrolls,9/10/2014,60000000,108255770,48255770,202728.9302653856
The Perfect Guy,9/11/2015,12000000,60273173,48273173,202875.34094013323
The Boy Next Door,1/23/2015,4000000,52425855,48425855,206311.53023576827
Quartet,9/8/2012,11000000,59520298,48520298,209675.15243704815
Deuce Bigalow: Male Gigolo,12/10/1999,17000000,65535067,48535067,288384.23648247175
Next Friday,1/12/2000,11000000,59827328,48827328,289261.42180094786
The Skeleton Key,7/29/2005,43000000,91974818,48974818,249362.61710794296
The Newton Boys,3/26/1998,27000000,76000000,49000000,301538.46153846156
Crossroads,2/15/2002,12000000,61141030,49141030,276383.74578177725
August: Osage County,12/26/2013,25000000,74188937,49188937,210284.61926503532
The Danish Girl,11/27/2015,15000000,64191523,49191523,207975.99830884684
Jeepers Creepers,7/1/2001,10000000,59217789,49217789,277283.31830985914
28 Weeks Later,4/26/2007,15000000,64238440,49238440,236781.3261905563
Wag the Dog,12/25/1997,15000000,64256513,49256513,304805.1547029703
No Escape,8/26/2015,5000000,54418872,49418872,207690.31498875792
Dragon: The Bruce Lee Story,5/7/1993,14000000,63513743,49513743,343368.53675450763
Serendipity,10/5/2001,28000000,77516304,49516304,278651.11986494093
The Huntsman: Winter's War,4/6/2016,115000000,164602163,49602163,207314.0336285479
J. Edgar,11/9/2011,35000000,84606030,49606030,219272.55447995404
The Boss,4/7/2016,29000000,78636257,49636257,207456.53073421912
Letters from Iwo Jima,12/19/2006,19000000,68673228,49673228,245401.68761362738
Trading Places,6/7/1983,40600000,90400000,49800000,500502.51256281405
Changing Lanes,4/7/2002,45000000,94935764,49935764,277729.49944382644
Stuart Little 2,7/19/2002,120000000,169956806,49956806,276462.6784726065
Don't Say a Word,9/28/2001,50000000,100020092,50020092,281486.1676983681
Get Him to the Greek,6/4/2010,40000000,90029656,50029656,229530.68611933108
The Saint,4/3/1997,68000000,118063304,50063304,312505.0187265918
The Taking of Pelham 1 2 3,6/11/2009,100000000,150166126,50166126,232581.15006050264
Dallas Buyers Club,9/7/2013,5000000,55198285,50198285,214386.07467894375
Max Payne,10/15/2008,35000000,85416905,50416905,232794.0463492679
The Royal Tenenbaums,10/5/2001,21000000,71441250,50441250,283856.2183455262
Not Another Teen Movie,12/7/2001,16000000,66468332,50468332,285615.91397849465
The Breakfast Club,2/15/1985,1000000,51525171,50525171,476652.5566037736
Woman in Gold,4/10/2015,11000000,61619773,50619773,213947.53570387026
Without a Paddle,8/20/2004,19000000,69631118,50631118,266619.8946814113
Ирония судьбы. Продолжение,12/21/2007,5000000,55635037,50635037,239885.5268144779
The Devil's Own,3/12/1997,90000000,140807547,50807547,317547.16875
Anacondas: The Hunt for the Blood Orchid,8/26/2004,20000000,70992898,50992898,268525.0026329647
Taxi 3,1/29/2003,14500000,65497208,50997208,278521.0704533042
Mighty Morphin Power Rangers: The Movie,6/30/1995,15000000,66000000,51000000,334426.2295081967
Boyz n the Hood,7/12/1991,6500000,57504069,51004069,374479.2143906021
Spy Game,11/18/2001,92000000,143049560,51049560,288905.2631578948
A Cinderella Story,7/10/2004,19000000,70067909,51067909,269629.9313621964
Brooklyn,10/20/2015,11000000,62076141,51076141,215206.0412242559
Austin Powers: International Man of Mystery,5/2/1997,16500000,67683989,51183989,319700.11867582763
Madea's Family Reunion,2/24/2006,6000000,57231524,51231524,256414.03403403403
The Untouchables,6/2/1987,25000000,76270454,51270454,451722.0616740088
Sky High,7/29/2005,35000000,86369815,51369815,261557.1028513238
Collateral Beauty,12/6/2016,36000000,87416021,51416021,212962.74313264192
Diary of a Wimpy Kid: Rodrick Rules,3/25/2011,21000000,72417394,51417394,228617.26232292602
Fletch,5/31/1985,8000000,59612888,51612888,479673.6802973978
The Aristocats,12/23/1970,4000000,55675257,51675257,1298373.2914572866
Behind Enemy Lines,11/17/2001,40000000,91753202,51753202,292887.3910582909
When a Stranger Calls,2/3/2006,15000000,66966987,51966987,261534.91192752894
Sliding Doors,4/23/1998,6000000,58000000,52000000,319410.3194103194
Wild Wild West,6/29/1999,170000000,222104681,52104681,312565.5728854229
Elizabeth,9/13/1998,30000000,82150642,52150642,318769.2053789731
Coal Miner's Daughter,3/7/1980,15000000,67182787,52182787,651470.4993757803
鐵道飛虎,12/23/2016,50000000,102205175,52205175,214978.5454560429
There Will Be Blood,12/28/2007,25000000,77208711,52208711,247340.87075990145
Rush,9/2/2013,38000000,90247624,52247624,223138.3606165305
Eternal Sunshine of the Spotless Mind,3/19/2004,20000000,72258126,52258126,277968.75531914894
Moonrise Kingdom,5/16/2012,16000000,68263166,52263166,227748.04556428068
The Grey,1/26/2012,25000000,77278331,52278331,229630.33518841444
Last Action Hero,6/18/1993,85000000,137298489,52298489,362177.9016620499
Monster,11/16/2003,8000000,60378584,52378584,284202.84319045034
Carrie,10/16/2013,30000000,82394288,52394288,224801.61668862012
Pokémon 3: The Movie,7/8/2000,16000000,68411275,52411275,303305.9895833333
Pokémon 3: The Movie,7/8/2000,16000000,68411275,52411275,303305.9895833333
A Knight's Tale,5/11/2001,65000000,117487473,52487473,295371.2605514913
Guess Who's Coming to Dinner,12/11/1967,4000000,56666667,52666667,1553588.9970501475
Firefox,6/13/1982,18000000,70687344,52687344,543168.4948453609
Blue Streak,9/17/1999,65000000,117758500,52758500,313665.2794292509
In the Name of the Father,12/12/1993,13000000,65796862,52796862,362118.39506172837
Secret Window,3/12/2004,40000000,92913171,52913171,282354.16755602986
Big Fish,12/25/2003,70000000,122919055,52919055,285740.0377969763
Meet Joe Black,11/12/1998,90000000,142940100,52940100,322805.48780487804
Teenage Mutant Ninja Turtles II: The Secret of the Ooze,3/22/1991,25000000,78000000,53000000,392011.8343195267
This Is 40,12/20/2012,35000000,88058786,53058786,230409.8749348619
My Cousin Vinny,3/13/1992,11000000,64088552,53088552,381109.4903086863
Transporter 2,8/2/2005,32000000,85167639,53167639,270710.9928716904
(500) Days of Summer,7/17/2009,7500000,60722734,53222734,246591.05608940203
The Kite Runner,10/14/2007,20000000,73276047,53276047,254987.39805490675
Chariots of Fire,5/15/1981,5500000,58972904,53472904,595466.6369710468
Bad Santa,11/26/2003,23000000,76488889,53488889,290227.287032013
Fargo,4/5/1996,7000000,60611975,53611975,343006.87779910426
Obsessed,4/24/2009,20000000,73830340,53830340,251713.02184647613
The Gift,7/30/2015,5000000,58978653,53978653,226500.33149264002
Sicario,9/17/2015,30000000,84025816,54025816,227153.84421328804
The Cannonball Run,6/19/1981,18000000,72179579,54179579,591480.1200873363
The Boy,1/22/2016,10000000,64188367,54188367,228535.8629502638
Dawn of the Dead,9/2/1978,650000,55000000,54350000,817293.2330827068
The Blue Lagoon,7/5/1980,4500000,58853106,54353106,657232.2370012092
The Hitchhiker's Guide to the Galaxy,1/15/2005,50000000,104478416,54478416,285676.0146827478
Open Water,8/6/2004,130000,54667954,54537954,287799.22955145116
The Hills Have Eyes,3/10/2006,15000000,69623713,54623713,273391.95695695694
The Best Man Holiday,11/15/2013,17000000,71625195,54625195,234373.49025395914
Meet the Spartans,1/24/2008,30000000,84646831,54646831,258141.88943422787
The Golden Child,12/12/1986,25000000,79817939,54817939,496089.94570135744
Courage Under Fire,7/4/1996,46000000,100860818,54860818,349431.9617834395
A Fish Called Wanda,7/15/1988,7500000,62493712,54993712,464081.9578059072
Lawrence of Arabia,12/10/1962,15000000,69995385,54995385,1809058.7171052631
Free Birds,10/30/2013,55000000,110000000,55000000,235981.61917715357
The Gods Must Be Crazy,9/10/1980,5000000,60000000,55000000,654761.9047619047
42,4/12/2013,40000000,95020213,55020213,236614.52881551278
My Fair Lady,10/21/1964,17000000,72070731,55070731,1765087.532051282
Diary of a Wimpy Kid: Dog Days,8/2/2012,22000000,77112176,55112176,239223.9570446959
The Princess Diaries 2: Royal Engagement,8/6/2004,40000000,95149435,55149435,291026.0422163588
Hereafter,10/15/2010,50000000,105197635,55197635,252377.04093529817
Watchmen,3/5/2009,130000000,185258983,55258983,259786.76501699505
White House Down,6/27/2013,150000000,205366737,55366737,237019.1998150653
Chappie,3/4/2015,49000000,104399548,55399548,234625.54051135233
What Lies Beneath,7/21/2000,100000000,155464351,55464351,320974.2534722222
Begin Again,9/7/2013,8000000,63464861,55464861,236878.4876296717
The Getaway,12/13/1972,3352254,58831997,55479743,1305405.717647059
The Call,3/14/2013,13000000,68572378,55572378,238740.65291077574
The Rookie,3/25/2002,20000000,75597042,55597042,309216.02892102336
Gandhi,11/30/1982,22000000,77737889,55737889,571084.9282786886
The Cable Guy,6/10/1996,47000000,102825796,55825796,356259.068283344
Jimmy Neutron: Boy Genius,12/21/2001,25000000,80936232,55936232,315845.4658385093
Lost in Space,4/3/1998,80000000,136159423,56159423,345596.44923076924
Hard Target,8/20/1993,18000000,74189677,56189677,387247.94624396967
To Rome with Love,4/20/2012,17000000,73244881,56244881,244739.8168091726
Race to Witch Mountain,3/12/2009,50000000,106303988,56303988,264699.6036839062
Groundhog Day,2/11/1993,14600000,70906973,56306973,393479.89517819707
Underworld: Rise of the Lycans,1/22/2009,35000000,91353501,56353501,265576.625996145
天將雄師,2/19/2015,65000000,121545703,56545703,239479.68185533566
8MM,2/26/1999,40000000,96618699,56618699,343143.6303030303
Journey to the Center of the Earth,7/10/2008,45000000,101702060,56702060,257778.81835209398
Witness,2/8/1985,12000000,68706993,56706993,534971.6320754717
Dick Tracy,6/15/1990,47000000,103738726,56738726,436787.72902232484
The Wedding Ringer,1/16/2015,23000000,79799880,56799880,241987.88353882465
Skyline,11/11/2010,10000000,66821036,56821036,259690.3881573836
The Last Witch Hunter,10/21/2015,90000000,146936910,56936910,239900.01516836887
The Pacifier,3/4/2005,56000000,113006880,57006880,294914.0196585618
Scream 4,4/11/2011,40000000,97138686,57138686,254055.85444585737
The Name of the Rose,9/24/1986,20000000,77200000,57200000,518585.6754306437
Old Dogs,11/24/2009,35000000,92219310,57219310,264966.7745625124
Saw VI,10/22/2009,11000000,68233629,57233629,264566.3061064115
The Three Musketeers,8/31/2011,75000000,132274484,57274484,252433.93906271347
Risky Business,8/5/1983,6200000,63541777,57341777,572273.2235528942
The Constant Gardener,8/31/2005,25000000,82466670,57466670,289067.7565392354
Paul,2/14/2011,40000000,97552050,57552050,260052.91244368732
The Nightmare Before Christmas,10/9/1993,18000000,75634409,57634409,395569.0391214825
A Haunted House,1/11/2013,2500000,60141683,57641683,250311.28626020497
Miracles from Heaven,3/17/2016,16000000,73883359,57883359,241925.59171783115
Apocalypse Now,8/15/1979,31500000,89460381,57960381,785371.0162601626
Changeling,1/30/2008,55000000,113020255,58020255,274077.34313368885
Rings,2/1/2017,25000000,83080890,58080890,238424.36258995166
The Omen,6/6/1976,2800000,60922980,58122980,1023291.9014084508
2001: A Space Odyssey,4/10/1968,10500000,68700000,58200000,1691860.4651162792
Nanny McPhee and the Big Bang,3/26/2010,35000000,93246388,58246388,267174.23592603975
DragonHeart,5/31/1996,57000000,115267375,58267375,371840.29993618384
Beetlejuice,2/29/1988,15000000,73326666,58326666,500658.07725321886
The Pirates! In an Adventure with Scientists!,3/12/2012,60000000,118338361,58338361,254317.33015972658
Scary Movie 5,4/11/2013,20000000,78378744,58378744,251057.89765665654
Dolphin Tale,9/23/2011,37000000,95404397,58404397,257946.02532450613
Urban Legend,9/25/1998,14000000,72527595,58527595,356875.5792682927
Spy Kids: All the Time in the World,8/18/2011,27000000,85564310,58564310,258118.771734196
Dr. No,10/4/1962,950000,59600000,58650000,1929276.3157894737
The Crying Game,9/2/1992,3705538,62548947,58843409,416443.0927105449
Charlotte's Web,12/15/2006,85000000,144000000,59000000,292368.6818632309
The Rite,1/28/2011,37000000,96047633,59047633,266810.80751347664
Conan the Barbarian,4/2/1982,20000000,79114085,59114085,622909.2202318229
Piranha 3D,8/20/2010,24000000,83188165,59188165,270959.69584185974
Friday the 13th,5/9/1980,550000,59754601,59204601,723772.6283618582
Jackass: The Movie,10/21/2002,5000000,64282312,59282312,326984.6221731936
The Game,9/12/1997,50000000,109423648,59423648,368633.0521091812
13 Going on 30,4/13/2004,37000000,96455697,59455697,316253.7074468085
Point Break,7/12/1991,24000000,83531958,59531958,437092.2026431718
Never Been Kissed,4/9/1999,25000000,84565230,59565230,358394.88567990373
Todo sobre mi madre,4/19/1999,8272296,67872296,59600000,358604.09145607706
Going in Style,4/6/2017,25000000,84618541,59618541,243814.68076753203
The Wedding Planner,1/26/2001,35000000,94728529,59728529,339752.72468714445
Star Wars: The Clone Wars,8/5/2008,8500000,68282844,59782844,272873.86688332434
Ghost in the Shell,3/29/2017,110000000,169801921,59801921,244564.62760301647
Training Day,10/5/2001,45000000,104876233,59876233,336951.2267867192
Intolerable Cruelty,9/2/2003,60000000,119940815,59940815,323654.50863930886
Baahubali: The Beginning,7/10/2015,40000000,100000000,60000000,251409.99103304365
Atomic Blonde,7/26/2017,30000000,90007945,60007945,244412.63201625942
Legend of the Guardians: The Owls of Ga'Hoole,7/10/2010,80000000,140073390,60073390,275552.1051690052
Moneyball,9/22/2011,50000000,110206216,60206216,265903.8516745355
Identity,4/25/2003,30000000,90259536,60259536,328389.84196185286
Man on Fire,4/23/2004,70000000,130293714,60293714,318845.65838180855
Riddick,9/2/2013,38000000,98337295,60337295,257687.6049011527
Munich,12/22/2005,70000000,130358911,60358911,304381.80030257185
Poltergeist,5/20/2015,35000000,95437994,60437994,253262.23820179517
The Unborn,1/9/2009,16000000,76514050,60514050,286602.20798226795
Vampires Suck,8/18/2010,20000000,80547866,60547866,277184.32148105424
Diary of a Wimpy Kid,3/19/2010,15000000,75700498,60700498,278431.15651188715
The Dukes of Hazzard,8/5/2005,50000000,110803676,60803676,309591.0183299389
The Lazarus Effect,1/29/2015,3300000,64110728,60810728,259075.53616618807
Drag Me to Hell,3/15/2009,30000000,90810892,60810892,285887.7245438604
3 Idiots,12/23/2009,9000000,70000000,61000000,281512.04271599127
Moonlight,10/21/2016,4000000,65046687,61046687,252935.2732304964
Pain & Gain,4/18/2013,25000000,86175291,61175291,262616.8881066346
Purple Rain,7/27/1984,7200000,68392977,61192977,585578.7272727273
Shaft,6/15/2000,46000000,107196498,61196498,354968.08584686776
K-9,4/28/1989,17000000,78247647,61247647,494730.58966074314
United 93,4/28/2006,15000000,76286096,61286096,302647.387654321
Seabiscuit,7/22/2003,87000000,148336445,61336445,332266.7659804984
Underworld: Evolution,1/12/2006,50000000,111340801,61340801,309333.3383761977
Seven Years in Tibet,9/12/1997,70000000,131457682,61457682,381251.1290322581
Lara Croft Tomb Raider: The Cradle of Life,7/21/2003,95000000,156505388,61505388,333181.95016251353
Benvenuti al sud,10/1/2010,4000000,65584679,61584679,281580.1628633219
TMNT,3/23/2007,34000000,95608995,61608995,298080.15540481696
Southpaw,6/15/2015,30000000,91709827,61709827,258591.78756107576
Jackass Number Two,9/22/2006,11000000,72778712,61778712,306138.31516352826
Splash,3/9/1984,8000000,69821334,61821334,602547.1150097466
Unfriended,4/17/2015,1000000,62882090,61882090,260221.9886041084
Conspiracy Theory,8/7/1997,75000000,136982834,61982834,385465.3855721393
シン・ゴジラ,7/29/2016,15000000,77000000,62000000,257422.70053020775
Master and Commander: The Far Side of the World,11/14/2003,150000000,212011111,62011111,336103.5826558266
All the President's Men,4/4/1976,8500000,70600000,62100000,1106951.871657754
Dante's Peak,2/7/1997,116000000,178127760,62127760,389271.679197995
The Time Traveler's Wife,8/14/2009,39000000,101229792,62229792,288322.47004642454
Invictus,12/10/2009,60000000,122233971,62233971,288188.2805662448
Bring It On,8/25/2000,28000000,90449929,62449929,359527.5129533679
Stomp the Yard,5/16/2007,13000000,75511123,62511123,300026.50802488095
The Animal,6/1/2001,22000000,84772742,62772742,352655.8539325843
Drive,8/6/2011,15000000,78054825,63054825,278332.4505065219
Old School,2/21/2003,24000000,87055349,63055349,342320.02714440826
The Water Horse,12/25/2007,40000000,103071443,63071443,298803.50104225887
Nim's Island,4/3/2008,37000000,100076342,63076342,293620.05930463684
Step Brothers,7/25/2008,65000000,128107642,63107642,288049.6334772646
Rambo,1/24/2008,50000000,113244290,63244290,298754.7533456467
Striptease,6/28/1996,50000000,113309743,63309743,403246.77070063696
The Ides of March,9/24/2011,12500000,75993061,63493061,280420.3717853026
Racing Stripes,1/6/2005,30000000,93772522,63772522,334412.80545359204
Barbershop,4/1/2002,12000000,75781642,63781642,354736.6073414905
Space Cowboys,7/31/2000,65000000,128884132,63884132,369699.8379629629
Blade: Trinity,12/8/2004,65000000,128905366,63905366,335813.7992643195
The Naked Gun 2½: The Smell of Fear,6/28/1991,23000000,86930411,63930411,469386.2775330397
Surf's Up,6/8/2007,85000000,149044513,64044513,307386.12060359394
Casino,11/22/1995,52000000,116112375,64112375,417670.1954397394
Ferris Bueller's Day Off,6/11/1986,6000000,70136369,64136369,585720.2648401826
Premonition,2/8/2007,20000000,84146832,64146832,315219.3966555118
El laberinto del fauno,5/27/2006,19000000,83258226,64258226,316698.9945786101
Uncle Buck,8/16/1989,15000000,79258538,64258538,514068.304
Role Models,2/3/2008,28000000,92380927,64380927,304124.0239403287
Street Fighter,12/22/1994,35000000,99423521,64423521,428632.874251497
Final Destination 2,1/31/2003,26000000,90426405,64426405,351864.58219552157
Tooth Fairy,1/14/2010,48000000,112462508,64462508,297491.3492733759
The Cider House Rules,12/17/1999,24000000,88545092,64545092,382376.1374407583
Anchorman: The Legend of Ron Burgundy,7/9/2004,26000000,90574188,64574188,340940.8025343189
Coraline,2/5/2009,60000000,124596398,64596398,304422.8508951756
No Reservations,7/25/2007,28000000,92601050,64601050,310705.9547800324
Wall Street: Money Never Sleeps,9/2/2010,70000000,134748021,64748021,296412.3668392549
War Room,8/28/2015,3000000,67790117,64790117,272290.3065834542
The Whole Nine Yards,2/18/2000,41300000,106371651,65071651,380091.4193925234
Monster House,7/21/2006,75000000,140175006,65175006,319642.01078960276
Halloween,8/31/2007,15000000,80253908,65253908,312983.3948870449
The Sorcerer's Apprentice,7/13/2010,150000000,215283742,65283742,299451.5964790768
Cruel Intentions,3/5/1999,10500000,75902208,65402208,396377.0181818182
Waiting to Exhale,12/22/1995,16000000,81452156,65452156,423912.92746113986
Deep Impact,5/8/1998,75000000,140464664,65464664,402117.1007371007
A Nightmare on Elm Street 4: The Dream Master,8/19/1988,7000000,72500000,65500000,546744.5742904842
Stardust,8/9/2007,70000000,135560026,65560026,315318.2568043979
U-571,4/20/2000,62000000,127666415,65666415,382894.5481049563
Horrible Bosses 2,11/26/2014,42000000,107670357,65670357,279672.0653118239
My Sister's Keeper,6/26/2009,30000000,95714875,65714875,305152.4023570822
Lilo & Stitch,6/21/2002,80000000,145771527,65771527,365194.4863964464
Are We There Yet?,1/20/2005,32000000,97918663,65918663,343684.37434827944
The Last Exorcism,8/27/2010,1800000,67738090,65938090,301860.4278540004
Manchester by the Sea,11/18/2016,9000000,75026965,66026965,273480.5866662249
Romeo Must Die,3/20/2000,25000000,91036760,66036760,385503.5610040864
Atlantis: The Lost Empire,6/2/2001,120000000,186053725,66053725,371088.34269662923
Le Dîner de cons,4/15/1998,12500000,78599508,66099508,406766.2030769231
Nerve,7/27/2016,19000000,85241496,66241496,275033.30302388634
John Q,2/15/2002,36000000,102244770,66244770,372580.25871766027
Money Monster,5/12/2016,27000000,93282604,66282604,275914.2484879011
The Naked Gun: From the Files of Police Squad!,12/2/1988,12000000,78756177,66756177,553993.1701244813
Epic Movie,1/25/2007,20000000,86865564,66865564,328579.32471412636
48 Hrs.,12/7/1982,12000000,78868508,66868508,685128.155737705
The Hundred-Foot Journey,8/6/2014,22000000,88880821,66880821,281186.70854144596
Ghajini,12/25/2008,9100000,76000000,66900000,316846.8762876344
Easy A,9/10/2010,8000000,74952305,66952305,306503.44031972316
Executive Decision,3/15/1996,55000000,121969216,66969216,430116.9942196532
Frankenstein,11/4/1994,45000000,112006296,67006296,447603.8476953908
The A-Team,6/10/2010,110000000,177238796,67238796,308484.3713440231
The Legend of Zorro,10/24/2005,75000000,142400065,67400065,341093.4463562753
A League of Their Own,7/1/1992,40000000,107458785,67458785,480133.70106761565
Jaws 3-D,3/16/1983,20500000,87987055,67487055,684452.8904665315
WarGames,6/3/1983,12000000,79567667,67567667,679072.0301507538
Life As We Know It,10/2/2010,38000000,105610124,67610124,309129.96602822904
King Kong,9/8/1976,23000000,90614445,67614445,1173861.892361111
Insomnia,5/24/2002,46000000,113714830,67714830,376402.61256253475
The Heartbreak Kid,10/5/2007,60000000,127766650,67766650,324341.66443312785
Unstoppable,11/4/2010,100000000,167805466,67805466,309892.7619822397
If I Stay,8/21/2014,11000000,78874843,67874843,285151.2744138368
Gosford Park,11/7/2001,19800000,87754044,67954044,383055.4904171364
Michael Clayton,9/28/2007,25000000,92991835,67991835,325419.43465941725
Lobo Guerreiro,4/2/2015,12000000,80000000,68000000,287406.1175237427
Das Leben der Anderen,3/15/2006,2000000,70000000,68000000,340340.34034034034
A Perfect Murder,6/5/1998,60000000,128038368,68038368,417413.3006134969
Paranormal Activity: The Ghost Dimension,10/21/2015,10000000,78096553,68096553,286920.45454545453
Kick-Ass,3/22/2010,28000000,96188903,68188903,312780.2200826572
Confessions of a Shopaholic,2/5/2009,40000000,108332743,68332743,322031.08962124103
Spotlight,11/6/2015,20000000,88346473,68346473,287973.47642161325
Hot Fuzz,2/14/2007,12000000,80573774,68573774,336973.5182973872
The Fighter,12/17/2010,25000000,93617009,68617009,311579.66697393096
John Wick,10/22/2014,20000000,88761661,68761661,291176.66662432085
Annie,12/19/2014,65000000,133821816,68821816,294479.05283110903
Coyote Ugly,7/30/2000,45000000,113916474,68916474,398822.1875
Star Trek III: The Search for Spock,5/31/1984,18000000,87000000,69000000,665380.906460945
Lemony Snicket's A Series of Unfortunate Events,12/16/2004,140000000,209073645,69073645,362211.038280021
Unfaithful,5/10/2002,50000000,119137784,69137784,384526.05116796435
Cheaper by the Dozen 2,12/21/2005,60000000,129181830,69181830,348874.5839636914
Once Upon a Time in Mexico,9/11/2003,29000000,98185582,69185582,373572.2570194385
Beverly Hills Cop III,5/24/1994,50000000,119208989,69208989,467628.3040540541
Allegiant,3/9/2016,110000000,179246868,69246868,290791.9473233333
Act of Valor,2/24/2012,12000000,81272766,69272766,301984.2278719397
The Emperor's New Groove,12/9/2000,100000000,169327687,69327687,398434.9827586207
Office Christmas Party,11/25/2016,45000000,114501299,69501299,287871.11484807316
Safe Haven,2/7/2013,28000000,97594140,69594140,299760.25774661236
Paul Blart: Mall Cop 2,4/16/2015,38000000,107597242,69597242,292665.1752486281
The Prestige,10/19/2006,40000000,109676311,69676311,345788.1439205955
1408,7/12/2007,25000000,94679598,69679598,334517.1988343679
Halloween,10/25/1978,300000,70000000,69700000,1034124.6290801186
Jingle All the Way,11/15/1996,60000000,129832389,69832389,440305.10088272387
Star Trek VI: The Undiscovered Country,12/5/1991,27000000,96900000,69900000,506889.0500362581
Resident Evil,3/15/2002,33000000,102984862,69984862,391414.2170022371
The Rescuers,6/22/1977,1200000,71215869,70015869,1147801.1311475409
We Bought a Zoo,12/22/2011,50000000,120081841,70081841,309186.8660798977
Match Point,10/26/2005,15000000,85306374,70306374,355801.487854251
The Other Guys,8/6/2010,100000000,170432927,70432927,322625.08245080436
The Rugrats Movie,11/20/1998,30000000,100491683,70491683,430089.5851128737
I Am Sam,12/28/2001,22000000,92542418,70542418,398319.69508752116
Jack and Jill,11/11/2011,79000000,149673788,70673788,312397.94898996595
Blood Diamond,12/7/2006,100000000,170877916,70877916,351228.5232903865
My Big Fat Greek Wedding 2,3/23/2016,18000000,88923251,70923251,296426.2917901371
2 Guns,8/2/2013,61000000,131940411,70940411,303323.58889501746
Vanishing Point,1/15/1971,1300000,72266306,70966306,1783073.015075377
Das Boot,9/16/1981,14000000,85000000,71000000,760171.30620985
The Cell,8/17/2000,33000000,104155843,71155843,409647.91594703513
The Possession,8/30/2012,14000000,85446075,71446075,308746.3862372357
"\"धू�?�?\"\"To avenge his father's death\"",12/18/2013,19500000,91000000,71500000,305665.28155406215
Payback,2/5/1999,90000000,161626121,71626121,435417.1489361702
The Jewel of the Nile,12/4/1985,25000000,96773200,71773200,656662.3970722782
Get Hard,3/26/2015,40000000,111811453,71811453,303515.45441865776
Footloose,2/17/1984,8200000,80035402,71835402,700150.1169590644
The 5th Wave,1/14/2016,38000000,109906372,71906372,303509.98666193924
The Terminator,10/26/1984,6400000,78371200,71971200,683487.1794871795
The Other Woman,10/28/2010,30000000,102000000,72000000,329063.129847397
The Land Before Time,11/18/1988,12300000,84460846,72160846,598845.1950207469
The Magnificent Seven,9/14/2016,90000000,162360636,72360636,299719.32004572795
Friday the 13th,2/11/2009,19000000,91379051,72379051,341100.088127318
The Santa Clause 3: The Escape Clause,11/1/2006,12000000,84500122,72500122,359802.09429280396
First Knight,7/7/1995,55000000,127600435,72600435,476068.4262295082
The Client,7/20/1994,45000000,117615211,72615211,487350.40939597314
Primal Fear,4/3/1996,30000000,102616183,72616183,464594.90083173383
Earthquake,11/15/1974,7000000,79666653,72666653,1411002.9708737864
Volver,3/16/2006,12899867,85582407,72682540,360707.3945409429
Ouija: Origin of Evil,10/20/2016,9000000,81705746,72705746,301242.35455950414
Love & Other Drugs,11/22/2010,30000000,102820008,72820008,332239.8952454387
Captain Underpants: The First Epic Movie,6/1/2017,38000000,110824373,72824373,297296.94433671486
The Spiderwick Chronicles,2/14/2008,90000000,162839667,72839667,344081.6040209171
The Forbidden Kingdom,4/18/2008,55000000,127906624,72906624,336545.95812253037
Escape Plan,10/9/2013,50000000,122915111,72915111,312208.77685766405
Bend It Like Beckham,4/11/2002,3500159,76578641,73078482,406443.170189099
Vacation,7/28/2015,31000000,104384188,73384188,307928.07868544286
The Strangers,5/29/2008,9000000,82391145,73391145,335402.7146219409
The Fast and the Furious: Tokyo Drift,6/3/2006,85000000,158468292,73468292,362091.1384918679
Paper Towns,6/18/2015,12000000,85512300,73512300,308028.77806364023
Snatch,9/1/2000,10000000,83557872,73557872,423476.522740357
Law Abiding Citizen,10/15/2009,53000000,126690726,73690726,340881.435120295
Underworld,9/19/2003,22000000,95708457,73708457,398424.0918918919
Neighbors 2: Sorority Rising,5/4/2016,35000000,108758521,73758521,307034.20902555477
Total Recall,8/2/2012,125000000,198802074,73802074,320350.700367655
Der Untergang,9/8/2004,18339750,92180910,73841160,388842.3380726698
Fiddler on the Roof,11/3/1971,9000000,83304330,74304330,1816731.7848410758
How to Be Single,1/21/2016,38000000,112343513,74343513,313538.86154585826
Dawn of the Dead,3/19/2004,28000000,102356381,74356381,395512.66489361704
The Lucky One,4/19/2012,25000000,99357138,74357138,323552.1528185715
Pineapple Express,8/6/2008,27000000,101624843,74624843,340618.9487233324
Timecop,9/15/1994,27000000,101646581,74646581,499642.44310575636
Sinister,3/29/2012,3000000,77712439,74712439,324716.6873112111
The Nutty Professor,6/26/1996,54000000,128769345,74769345,476237.8662420382
The Lake House,6/16/2006,40000000,114830111,74830111,367715.5331695332
Spice World,12/19/1997,25000000,100000000,75000000,464108.9108910891
Sisters,12/18/2015,30000000,105011053,75011053,316614.55114893045
About Time,8/16/2013,12000000,87100449,75100449,320737.85922639
Forgetting Sarah Marshall,4/17/2008,30000000,105173115,75173115,347008.3597991063
Working Girl,12/20/1988,28000000,103173635,75173635,620756.6886870356
Stripes,6/25/1981,10000000,85300000,75300000,822052.401746725
Hellboy II: The Golden Army,7/11/2008,85000000,160388063,75388063,342729.0965794403
On Her Majesty's Secret Service,12/12/1969,6500000,81974493,75474493,2001975.9416445622
An American Tail,11/21/1986,9000000,84542002,75542002,683638.0271493213
The Forgotten,9/24/2004,42000000,117575636,75575636,395891.2310110005
Nell,12/23/1994,31000000,106683817,75683817,503551.67664670653
Hostel,1/6/2005,4800000,80578934,75778934,397372.4908232827
About Schmidt,12/13/2002,30000000,105834556,75834556,419207.05362078495
Hitman,11/21/2007,24000000,99965753,75965753,361679.67872174294
The Second Best Exotic Marigold Hotel,2/26/2015,10000000,85978266,75978266,321779.5518361504
White Chicks,6/23/2004,37000000,113086475,76086475,401723.7328405491
Prisoners,9/18/2013,46000000,122126687,76126687,325960.1406146969
Water for Elephants,3/15/2011,38000000,114156230,76156230,340794.0769778088
Sliver,5/21/1993,40000000,116300000,76300000,528393.351800554
The Thomas Crown Affair,8/6/1999,48000000,124305181,76305181,456643.81208856974
The Hand that Rocks the Cradle,1/10/1992,11700000,88036683,76336683,552763.8160753078
Bei Jing yu shang Xi Ya Tu,3/20/2013,4881000,81350000,76469000,328855.0773875311
Romancing the Stone,3/30/1984,10000000,86572238,76572238,742698.7196896218
When Harry Met Sally...,7/21/1989,16000000,92823546,76823546,616561.3643659712
From Russia with Love,10/11/1963,2000000,78898765,76898765,2496713.149350649
The Book of Eli,1/14/2010,80000000,157107755,77107755,355848.5511359703
Corpse Bride,9/9/2005,40000000,117195061,77195061,388305.13581488933
Memoirs of a Geisha,12/6/2005,85000000,162242962,77242962,392494.7256097561
Backdraft,5/24/1991,75000000,152368585,77368585,568886.6544117647
괴물,7/27/2006,11000000,88489643,77489643,380037.48406081414
Saving Mr. Banks,11/16/2013,35000000,112544580,77544580,332739.38098854746
Contagion,9/8/2011,60000000,137551594,77551594,341804.11566889536
Bridge to Terabithia,2/16/2007,60000000,137587063,77587063,377824.72534964356
The Adjustment Bureau,3/3/2011,50200000,127869379,77669379,347565.31836915517
28 Days Later,10/31/2002,5000000,82719885,77719885,428681.10865968006
Far and Away,5/22/1992,60000000,137783840,77783840,554806.2767475037
Patton,1/25/1970,12000000,89800000,77800000,2047368.4210526317
Tower Heist,11/2/2011,75000000,152930623,77930623,344475.1933872608
Rocky V,10/18/1990,42000000,119946358,77946358,582558.7294469357
Save the Last Dance,1/12/2001,13000000,91038276,78038276,445678.3323814963
M*A*S*H,1/24/1970,3500000,81600000,78100000,2055263.1578947369
Species,7/7/1995,35000000,113374103,78374103,513928.54426229506
Failure to Launch,3/10/2006,50000000,128406887,78406887,392426.86186186183
The Bone Collector,11/4/1999,73000000,151493655,78493655,466391.29530600115
V for Vendetta,3/15/2006,54000000,132511035,78511035,392948.1231231231
Sanctum,2/3/2011,30000000,108609310,78609310,355201.59595859185
Pete's Dragon,8/10/2016,65000000,143695338,78695338,326741.39398544317
Zombieland,10/7/2009,23600000,102391382,78791382,364476.2486295952
Transporter 3,11/26/2008,30000000,108979549,78979549,375685.2036836197
The Crow,5/11/1994,15000000,94000000,79000000,535593.220338983
Daylight,12/6/1996,80000000,159212469,79212469,499448.1021437579
The Poseidon Adventure,12/1/1972,5000000,84563118,79563118,1872073.3647058823
Airplane!,7/2/1980,3500000,83453539,79953539,966790.0725513905
大鱼·海棠,7/8/2016,4531653,84552250,80020597,332548.9843243513
Why Him?,12/22/2016,38000000,118034273,80034273,329577.51020223275
Apocalypto,12/7/2006,40000000,120175290,80175290,397300.7433102081
Predator,6/11/1987,18000000,98235548,80235548,706921.127753304
Eight Below,2/17/2006,40000000,120455994,80455994,402682.65265265264
Tammy,7/2/2014,20000000,100525432,80525432,337987.1227701994
Evil Dead,4/5/2013,17000000,97542952,80542952,346375.11557598773
A Nightmare on Elm Street,4/30/2010,35000000,115664037,80664037,369716.6396245268
功夫,2/10/2004,20000000,100914445,80914445,434556.63265306124
Black Hawk Down,12/28/2001,92000000,172989651,80989651,457310.2823263693
The Reader,12/10/2008,32000000,113019290,81019290,385387.721901935
Fantasia,11/13/1940,2280000,83320000,81040000,5788571.428571428
Contact,7/11/1997,90000000,171120329,81120329,505422.6105919003
White Noise,1/7/2005,10000000,91196419,81196419,425780.90718405874
Blue Jasmine,7/25/2013,18000000,99206215,81206215,347217.6186628014
Metropolis,5/26/2001,14500000,95789342,81289342,456681.69662921346
Paranormal Activity: The Marked Ones,1/1/2014,5000000,86362372,81362372,347827.3055284803
Vicky Cristina Barcelona,8/15/2008,15000000,96408652,81408652,371583.08609404525
Kingdom of Heaven,5/3/2005,130000000,211643158,81643158,419975.0925925926
Pinocchio,2/23/1940,2600000,84300000,81700000,5835714.285714285
Spy Kids 2: The Island of Lost Dreams,8/7/2002,38000000,119723358,81723358,452259.86718317657
Warm Bodies,1/31/2013,35000000,116980662,81980662,353112.2645004006
Star Trek: Generations,11/17/1994,38000000,120000000,82000000,547762.1910487643
Conan the Destroyer,6/29/1984,18000000,100000000,82000000,787704.130643612
Horrible Bosses,7/8/2011,35000000,117000000,82000000,362957.12679597386
Perfume: The Story of a Murderer,9/13/2006,50000000,132180323,82180323,405028.69886643667
Dennis the Menace,6/23/1993,35000000,117270765,82270765,569742.1398891966
Dirty Grandpa,1/21/2016,11500000,94073028,82573028,348246.2981472812
The Godfather: Part III,12/24/1990,54000000,136766062,82766062,614903.8781575038
The Karate Kid,6/22/1984,8000000,90815558,82815558,795538.5014409223
7Aum Arivu,10/26/2011,16000000,98900000,82900000,366441.23237413255
The Interpreter,4/8/2005,80000000,162944923,82944923,426232.9033915725
The Butterfly Effect,1/22/2004,13000000,96060858,83060858,446084.0923737917
Peter Pan,2/5/1953,4000000,87404651,83404651,3147345.320754717
The 40 Year Old Virgin,8/11/2005,26000000,109449237,83449237,424894.2820773931
Young Frankenstein,12/15/1974,2800000,86273333,83473333,1608349.3834296726
Blended,5/21/2014,40000000,123494610,83494610,350312.82647277246
Just Married,1/9/2003,18000000,101564935,83564935,459906.08145294443
King Arthur,7/7/2004,120000000,203567857,83567857,441224.1657866948
Four Christmases,11/26/2008,80000000,163733697,83733697,398299.45107216923
Bajrangi Bhaijaan,7/17/2015,14000000,98000000,84000000,352473.18686114234
Think Like a Man,4/16/2012,12000000,96070507,84070507,365818.18854295847
Freaky Friday,8/3/2003,26000000,110230332,84230332,456285.6554712893
Hope Springs,8/7/2012,30000000,114281051,84281051,365836.5172172811
Resident Evil: Apocalypse,9/10/2004,45000000,129394835,84394835,444417.24591890466
MouseHunt,12/19/1997,38000000,122417389,84417389,522384.8329207921
Percy Jackson: Sea of Monsters,8/7/2013,90000000,174578751,84578751,361637.7454815993
The Phantom of the Opera,12/8/2004,70000000,154648887,84648887,444818.1135049921
Bride Wars,1/9/2009,30000000,114663461,84663461,400976.8782294464
Ray,10/29/2004,40000000,124731534,84731534,443620.59685863875
Star Trek II: The Wrath of Khan,6/3/1982,12000000,96800000,84800000,874226.8041237113
Ride Along 2,1/14/2016,40000000,124827316,84827316,358048.0676695538
Phone Booth,9/9/2002,13000000,97837138,84837138,468713.46961325966
Get Shorty,10/20/1995,30250000,115101622,84851622,552419.4140625
猛龍過江,6/1/1972,130000,85000000,84870000,2035251.798561151
Freddy vs. Jason,8/15/2003,30000000,114908830,84908830,459961.15926327195
Dreamgirls,12/25/2006,70000000,154937680,84937680,419619.3976760731
The Monuments Men,1/24/2014,70000000,154984035,84984035,361971.51813817985
The Pianist,9/24/2002,35000000,120072577,85072577,469236.49751792604
Ghostbusters,7/14/2016,144000000,229147509,85147509,353855.36595907377
Birdman,8/27/2014,18000000,103215094,85215094,357999.9831954661
Justin Bieber: Never Say Never,2/11/2011,13000000,98441954,85441954,386075.3697319133
Mechanic: Resurrection,8/25/2016,40000000,125729635,85729635,355094.00318107265
My Bloody Valentine,1/16/2009,15000000,100734718,85734718,404041.2171937811
New Year's Eve,12/8/2011,56000000,142044638,86044638,381281.8515367436
Evita,12/14/1996,55000000,141047179,86047179,542542.1122320303
Sex Tape,7/17/2014,40000000,126069509,86069509,361861.615626524
Blade,8/21/1998,45000000,131183530,86183530,526794.1931540342
Predators,7/3/2010,40000000,126248813,86248813,395616.79456541187
The Purge,5/31/2013,3000000,89328627,86328627,369709.4139714952
Calendar Girls,9/2/2003,10000000,96542059,86542059,467289.73542116635
Lucy,7/14/2014,40000000,126546825,86546825,363260.5456453305
The Notebook,6/25/2004,29000000,115603229,86603229,457250.4171066526
Dilwale Dulhania Le Jayenge,10/20/1995,13200000,100000000,86800000,565104.1666666667
Anastasia,11/20/1997,53000000,139804348,86804348,538154.6683199008
風立ちぬ,7/20/2013,30000000,117932401,87932401,375977.1204522035
Project X,3/1/2012,12000000,100000000,88000000,383622.7941689335
Philomena,11/1/2013,12000000,100129872,88129872,378127.8162260961
The Blues Brothers,6/17/1980,27000000,115229890,88229890,1066866.868198307
Arthur,7/17/1981,7000000,95461682,88461682,958414.7562296859
Closer,12/1/2004,27000000,115505027,88505027,465081.59222280607
The Net,7/28/1995,22000000,110627965,88627965,579646.5990843688
The Talented Mr. Ripley,12/25/1999,40000000,128798265,88798265,526056.0722748815
Flashdance,4/14/1983,4000000,92921203,88921203,901837.7586206897
The Amityville Horror,4/15/2005,19000000,108047131,89047131,457590.60123329906
Enter the Dragon,8/17/1973,850000,90000000,89150000,1972345.1327433628
Waterworld,7/28/1995,175000000,264218220,89218220,583506.9980379333
Heaven is for Real,4/16/2014,12000000,101332962,89332962,375506.3556116015
Julie & Julia,8/6/2009,40000000,129540499,89540499,414858.1734110474
The General's Daughter,6/18/1999,60000000,149705852,89705852,538127.4865026996
Zookeeper,7/6/2011,80000000,169852759,89852759,397715.8444064766
Return to Never Land,2/14/2002,20000000,109862682,89862682,505414.4094488189
Dear John,2/4/2010,25000000,114977104,89977104,415136.5177792849
Underworld: Awakening,1/19/2012,70000000,160112671,90112671,395816.05706680485
The First Wives Club,9/20/1996,26000000,116400000,90400000,571067.593177511
Talladega Nights: The Ballad of Ricky Bobby,8/4/2006,72500000,162966177,90466177,443679.14173614513
Airport,3/5/1970,10000000,100489151,90489151,2368825.942408377
The Man with the Golden Gun,12/1/1974,7000000,97572000,90572000,1745125.2408477843
The Mexican,3/1/2001,57000000,147845033,90845033,515579.0749148695
The Butler,8/16/2013,25000000,115922175,90922175,388309.04680353106
Olympus Has Fallen,3/20/2013,70000000,161025640,91025640,391455.9349076037
L.A. Confidential,9/19/1997,35000000,126216940,91216940,564461.2623762377
Män som hatar kvinnor,2/27/2009,13000000,104345682,91345682,429439.6663986949
Sultan,7/6/2016,10400000,102000000,91600000,380670.5786525259
Sea of Love,9/15/1989,19000000,110879513,91879513,735036.104
Anaconda,4/11/1997,45000000,136885767,91885767,573569.0823970038
Crash,1/13/2004,6500000,98410061,91910061,496274.62742980564
This Means War,2/14/2012,65000000,156974557,91974557,403994.31176783226
Alien: Resurrection,11/12/1997,70000000,162000000,92000000,569659.4427244582
Ghost Rider: Spirit of Vengeance,12/10/2011,57000000,149217355,92217355,408634.4562019214
Ace Ventura: Pet Detective,2/4/1994,15000000,107217396,92217396,628612.1063394684
The Haunted Mansion,11/25/2003,90000000,182290266,92290266,500761.07433532283
Little Miss Sunshine,7/26/2006,8000000,100523181,92523181,453767.43992153014
Final Destination 3,2/10/2006,25000000,117719158,92719158,466628.87770508305
Zero Dark Thirty,12/19/2012,40000000,132820716,92820716,403077.62723640783
Pride & Prejudice,9/16/2005,28000000,121147947,93147947,467610.1757028113
She's All That,1/29/1999,10000000,103166989,93166989,566364.6747720365
10 Cloverfield Lane,3/10/2016,15000000,108286421,93286421,391742.4831606
The Visit,9/10/2015,5000000,98450062,93450062,392738.07812729833
Sideways,10/22/2004,16000000,109502303,93502303,489540.8534031414
No se Aceptan Devoluciones,7/20/2013,5500000,99067206,93567206,400070.14798376925
Gangs of New York,12/14/2002,100000000,193772504,93772504,518366.5229408513
Alien,5/25/1979,11000000,104931801,93931801,1299195.0345781466
Earth,4/22/2007,15000000,109000000,94000000,452033.91216115485
Six Days Seven Nights,6/12/1998,70000000,164000000,94000000,576687.1165644171
Cold Mountain,12/24/2003,79000000,173013509,94013509,507632.338012959
Death Becomes Her,7/30/1992,55000000,149022650,94022650,667300.5677785664
Battleship,4/11/2012,209000000,303025485,94025485,408655.4316882891
This Is the End,6/12/2013,32000000,126041322,94041322,402739.66184733453
The Omen,6/6/2006,25000000,119188334,94188334,464210.6160670281
Insidious: Chapter 3,6/4/2015,10000000,104303851,94303851,395175.33251200564
I Am Number Four,2/18/2011,50000000,144492830,94492830,422849.14551141777
Parental Guidance,12/25/2012,25000000,119772232,94772232,411552.1625846795
Hollow Man,8/4/2000,95000000,190213455,95213455,551003.7905092592
Insidious,9/13/2010,1500000,97009150,95509150,437234.88021827606
Dark Shadows,5/8/2012,150000000,245527149,95527149,415669.7735134782
The Devil's Advocate,10/17/1997,57000000,152944660,95944660,594084.5820433437
The Bounty Hunter,3/16/2010,40000000,136000000,96000000,440348.79293974105
Tropic Thunder,8/9/2008,92000000,188072649,96072649,438515.692467798
Scary Movie 2,7/4/2001,45000000,141220678,96220678,542088.3267605634
Mary Poppins,8/27/1964,6000000,102272727,96272727,3095586.0771704176
School of Rock,10/3/2003,35000000,131282949,96282949,520448.372972973
Butch Cassidy and the Sundance Kid,9/23/1969,6000000,102308889,96308889,2582007.7479892764
Analyze This,3/5/1999,80000000,176885658,96885658,587185.806060606
Eyes Wide Shut,7/14/1999,65000000,162091208,97091208,582430.7618476305
Jackass 3D,10/15/2010,20000000,117224271,97224271,444533.0641805853
Date Night,4/8/2010,55000000,152263880,97263880,446146.1682774565
Nanny McPhee,10/21/2005,25000000,122489822,97489822,493369.54453441297
Out of Africa,12/20/1985,31000000,128499205,97499205,889591.2864963504
The Texas Chainsaw Massacre,10/17/2003,9500000,107071655,97571655,528843.6585365854
Hide and Seek,1/27/2005,25000000,122644820,97644820,509097.08029197075
Disturbia,4/12/2007,20000000,117760134,97760134,472988.6591254366
Days of Thunder,6/27/1990,60000000,157920733,97920733,750925.8665644171
Flubber,11/26/1997,80000000,177977226,97977226,607422.3558586484
Mirror Mirror,3/15/2012,85000000,183018522,98018522,427297.037385785
Eagle Eye,9/25/2008,80000000,178066569,98066569,452810.68738947145
The Secret Life of Walter Mitty,12/18/2013,90000000,188133322,98133322,419523.7692162999
Big Momma's House 2,1/26/2006,40000000,138259062,98259062,494509.6225465526
Kramer vs. Kramer,12/18/1979,8000000,106260000,98260000,1262982.0051413882
Pitch Perfect,9/28/2012,17000000,115350426,98350426,425175.9533454091
Unbroken,12/25/2014,65000000,163442937,98442937,421223.74169365916
Ouija,10/24/2014,5000000,103590271,98590271,417488.26386506937
102 Dalmatians,10/7/2000,85000000,183611771,98611771,566734.316091954
The Secret of My Success,4/10/1987,12000000,110996879,98996879,878410.6388642413
Atonement,8/29/2007,30000000,129266061,99266061,476119.05127344234
The Help,8/9/2011,25000000,124272124,99272124,438200.463484076
The Jackal,11/14/1997,60000000,159330280,99330280,615048.173374613
Mad Max,4/12/1979,400000,100000000,99600000,1410764.8725212466
The Purge: Anarchy,7/17/2014,9000000,108782847,99782847,419516.5354926593
Maid in Manhattan,12/13/2002,55000000,154906693,99906693,552275.8043117744
World Trade Center,8/9/2006,63000000,162945894,99945894,490171.1329082884
Goosebumps,8/5/2015,58000000,158162788,100162788,420294.0129911546
Broken Arrow,2/9/1996,50000000,150270147,100270147,647321.80116204
The Devil Inside,1/6/2012,1000000,101758490,100758490,444526.018573666
Unknown,2/16/2011,30000000,130786397,100786397,451012.4403155723
Doctor Zhivago,12/22/1965,11000000,111858363,100858363,3171646.635220126
Road to Perdition,7/12/2002,80000000,181001478,101001478,560807.7623542476
Blade II,3/22/2002,54000000,155010032,101010032,561791.0567296996
Shallow Hal,11/1/2001,40000000,141069860,101069860,569728.6358511838
I Now Pronounce You Chuck & Larry,7/12/2007,85000000,186072214,101072214,485226.592542451
Planes: Fire & Rescue,7/17/2014,50000000,151165787,101165787,425330.8233691539
Daredevil,2/14/2003,78000000,179179718,101179718,552592.6706717641
AVP: Alien vs. Predator,8/12/2004,70000000,171183863,101183863,533951.7836411609
The League of Extraordinary Gentlemen,7/11/2003,78000000,179265204,101265204,550653.6378466558
Superbad,8/17/2007,20000000,121463226,101463226,486657.5183462036
Gothika,11/21/2003,40000000,141591324,101591324,551228.0195333695
Wayne's World,2/14/1992,20000000,121697323,101697323,733746.9191919193
Couples Retreat,9/19/2009,70000000,171844840,101844840,471117.8339971412
The Graduate,12/21/1967,3000000,104945305,101945305,2989598.3870967743
The Iron Lady,12/30/2011,13000000,114956699,101956699,449812.273619659
About a Boy,4/26/2002,27000000,129000000,102000000,567296.9966629588
Sweeney Todd: The Demon Barber of Fleet Street,12/20/2007,50000000,152000000,102000000,483229.10744741326
The Towering Inferno,12/14/1974,14000000,116000000,102000000,1965317.9190751445
Congo,6/9/1995,50000000,152022101,102022101,668997.3836065574
Fun with Dick and Jane,12/21/2005,100000000,202026112,102026112,514503.84266263235
Demolition Man,10/8/1993,57000000,159055768,102055768,700451.3932738504
You Only Live Twice,6/12/1967,9500000,111584787,102084787,3065609.2192192194
The Shallows,6/24/2016,17000000,119100758,102100758,424309.54834848817
Jack Reacher: Never Go Back,10/19/2016,60000000,162146076,102146076,423222.7318492001
Step Up,8/11/2006,12000000,114194847,102194847,501200.81902893574
명량,7/30/2014,9500000,112156811,102656811,431599.5282780889
Saw,10/1/2004,1200000,103911669,102711669,538039.1251964379
Saw V,10/23/2008,10800000,113857533,103057533,485147.85453689535
Scent of a Woman,12/23/1992,31000000,134095253,103095253,722968.1136044881
Beethoven's 2nd,12/14/1993,15000000,118243066,103243066,708114.3072702332
The Happening,6/11/2008,60000000,163403799,103403799,472562.662523136
Resident Evil: Extinction,9/20/2007,45000000,148412065,103412065,494946.13182984263
Road Trip,5/19/2000,16000000,119754278,103754278,601822.958236659
Focus,2/25/2015,50100000,153962963,103862963,439875.49921861436
"\"劇場版ポケットモンスター 幻のポケモン ルギア爆�?\"\"Ash Ketchum must put his skill to the test when he attempts to save the world from destruction. The Greedy Pokemon collector Lawrence III throws the universe into chaos after disrupting the balance of nature by capturing one of the Pokemon birds that rule the elements of fire\"",7/17/1999,30000000,133949270,103949270,622078.2166367444
Star Trek: The Motion Picture,12/6/1979,35000000,139000000,104000000,1355932.2033898304
Star Trek: First Contact,11/21/1996,46000000,150000000,104000000,655737.7049180329
The Beach,2/11/2000,40000000,144056873,104056873,612820.2179034158
Mortal Kombat,8/18/1995,18000000,122195920,104195920,680130.0261096606
Crimson Tide,5/12/1995,53000000,157387195,104387195,685855.4204993431
Daddy Day Care,5/3/2003,60000000,164433867,104433867,569121.8910081744
Billy Elliot,5/18/2000,5000000,110000000,105000000,609048.7238979118
A Perfect World,11/24/1993,30000000,135130999,105130999,721063.0932784636
Lethal Weapon,3/6/1987,15000000,120207127,105207127,938511.3916146299
The Patriot,6/28/2000,110000000,215294342,105294342,609342.2569444444
The Wedding Singer,2/13/1998,18000000,123306987,105306987,650444.638665843
The Scorpion King,4/16/2002,60000000,165333180,105333180,585835.2614015572
The Big Short,12/11/2015,28000000,133346506,105346506,445392.68999048724
Knowing,3/19/2009,50000000,155446362,105446362,494496.16394672665
Déjà Vu,11/22/2006,75000000,180557550,105557550,523080.0297324083
Trainwreck,7/17/2015,35000000,140795793,105795793,443930.7180382349
Music and Lyrics,2/9/2007,40000000,145896422,105896422,520378.09522405517
One Flew Over the Cuckoo's Nest,11/18/1975,3000000,108981275,105981275,1909572.5225225226
Sleepy Hollow,11/18/1999,100000000,206071502,106071502,630252.5371360665
Dr. Dolittle 2,6/22/2001,70000000,176104344,106104344,597770.9521126761
Last Vegas,10/31/2013,28000000,134402450,106402450,456527.6806439295
Remember the Titans,9/29/2000,30000000,136706683,106706683,613256.7988505748
PK,12/18/2014,13000000,120000000,107000000,457838.23334345996
Step Up Revolution,7/26/2012,33000000,140470746,107470746,466495.4097378668
Magic Mike XXL,7/1/2015,14800000,122513057,107713057,451335.64490852866
Clash of the Titans,4/1/2010,125000000,232713139,107713139,494076.57023333904
The Green Hornet,1/12/2011,120000000,227817248,107817248,489582.1417381472
Double Jeopardy,9/24/1999,70000000,177841558,107841558,641150.760998811
The Santa Clause 2,10/31/2002,65000000,172855065,107855065,594898.3177054605
The Longest Yard,5/19/2005,82000000,190320568,108320568,556918.0874035989
Hulk,6/19/2003,137000000,245360480,108360480,589235.8890701468
The Queen,9/15/2006,15000000,123384128,108384128,534175.1010349926
Fried Green Tomatoes,12/27/1991,11000000,119418501,108418501,785072.4185372918
借りぐらしのアリエッティ,7/16/2010,37000000,145570827,108570827,497319.5564146725
I Know What You Did Last Summer,10/17/1997,17000000,125586134,108586134,672359.9628482972
The Purge: Election Year,6/29/2016,10000000,118587880,108587880,451268.6802865835
The Theory of Everything,11/26/2014,15000000,123726688,108726688,463037.18719656573
Hot Shots! Part Deux,5/21/1993,25000000,133752825,108752825,753135.907202216
Diamonds Are Forever,12/13/1971,7200000,116019547,108819547,2647677.5425790753
Baywatch,5/12/2017,69000000,177856751,108856751,444798.00844185293
Star Trek IV: The Voyage Home,11/25/1986,24000000,133000000,109000000,986425.3393665159
The Holiday,12/8/2006,85000000,194168700,109168700,540974.7274529237
Lone Survivor,12/24/2013,40000000,149295601,109295601,467242.9461858103
The Piano,5/19/1993,7000000,116700000,109700000,759695.2908587258
The Ten Commandments,10/5/1956,13000000,122700000,109700000,3989090.909090909
Alien³,5/22/1992,50000000,159773545,109773545,782978.2097004281
The SpongeBob SquarePants Movie,11/14/2004,30000000,140161792,110161792,576763.3089005236
First Blood,10/22/1982,15000000,125212904,110212904,1124621.469387755
Starsky & Hutch,3/5/2004,60000000,170268750,110268750,588413.8207043756
Babel,9/8/2006,25000000,135330182,110330182,543766.2986692952
The Collector,7/9/2009,3400000,114000000,110600000,513580.15518850624
Into the Storm,8/6/2014,50000000,160602194,110602194,465004.2631552394
Teenage Mutant Ninja Turtles: Out of the Shadows,6/1/2016,135000000,245623848,110623848,458985.8350828569
Robin Hood,5/12/2010,200000000,310669540,110669540,507244.2684413644
Rango,3/2/2011,135000000,245724603,110724603,495485.2528561264
The Woman in Black,2/1/2012,17000000,127730736,110730736,486380.02661829104
Final Destination 5,8/12/2011,47000000,157887643,110887643,489472.9214946258
The Accountant,10/14/2016,44000000,155160045,111160045,459853.98938480695
Vantage Point,2/1/2008,40000000,151161491,111161491,525107.0701440293
The Ring Two,3/17/2005,50000000,161451538,111451538,572721.161356629
Poltergeist,6/4/1982,10700000,122200000,111500000,1149484.5360824743
War Horse,12/25/2011,66000000,177584879,111584879,492289.85066066665
You Don't Mess with the Zohan,6/5/2008,90000000,201596308,111596308,510003.0071064598
The Rocky Horror Picture Show,8/14/1975,1200000,112892319,111692319,2056948.7845303868
Monster-in-Law,5/13/2005,43000000,154749918,111749918,574845.2572016461
Antz,10/2/1998,60000000,171757863,111757863,681450.3841463415
The Hateful Eight,12/25/2015,44000000,155760117,111760117,471728.87014806934
End of Days,11/24/1999,100000000,211989043,111989043,665413.2085561497
Mean Girls,4/30/2004,17000000,129042871,112042871,592505.9280803808
A Time to Kill,7/24/1996,40000000,152266007,112266007,713706.3382072472
Open Season,9/29/2006,85000000,197309027,112309027,556536.3082259663
Storks,9/22/2016,70000000,182379278,112379278,464897.79050093284
Bringing Down the House,3/7/2003,20000000,132675402,112675402,611701.4223669925
Die Hard,7/15/1988,28000000,140767956,112767956,951628.3206751054
Spy Kids,3/18/2001,35000000,147934180,112934180,638406.8965517242
Fahrenheit 9/11,6/25/2004,6000000,119114517,113114517,597225.5385427666
Seven Pounds,12/18/2008,55000000,168167691,113167691,535976.5230199439
Batman & Robin,6/20/1997,125000000,238207122,113207122,705340.3239875389
After Earth,5/30/2013,130000000,243843127,113843127,487542.51319035224
The Dictator,5/15/2012,65000000,179379533,114379533,497702.64343058545
Johnny English Reborn,9/15/2011,45000000,160078586,115078586,507202.1384906276
Source Code,3/30/2011,32000000,147332697,115332697,512804.00256106997
Friends with Benefits,7/21/2011,35000000,150483765,115483765,509760.8201461079
Another 48 Hrs.,6/8/1990,38000000,153518974,115518974,889291.5627405696
The Heat,6/27/2013,43000000,158674180,115674180,495189.0443329509
The Jungle Book 2,2/7/2003,20000000,135680000,115680000,631785.9093391589
Assassin's Creed,12/21/2016,125000000,240697856,115697856,476438.5292313014
Lost in Translation,8/31/2003,4000000,119723856,115723856,624858.8336933046
The Italian Job,5/30/2003,60000000,176070171,116070171,631846.3309744148
Saw 3D,10/21/2010,20000000,136150434,116150434,530844.7964607432
The Expendables 3,8/4/2014,90000000,206172544,116172544,488423.65840943105
Rocky,11/21/1976,1000000,117235147,116235147,1997167.474226804
17 Again,3/11/2009,20000000,136267476,116267476,546603.4629470309
Blazing Saddles,2/7/1974,2600000,119500000,116900000,2476694.915254237
The Town,9/15/2010,37000000,154026136,117026136,535738.2884924395
Rush Hour 3,8/8/2007,140000000,258022233,118022233,567641.0923589702
The Artist,5/15/2011,15000000,133432856,118432856,524122.6744083128
Sense and Sensibility,12/13/1995,16500000,135000000,118500000,771986.970684039
Sin City,4/1/2005,40000000,158733820,118733820,610142.9599177801
Ghost Rider,2/16/2007,110000000,228738393,118738393,578218.8291324165
La Marche de l'empereur,1/26/2005,8000000,127392239,119392239,622482.9979144942
Let's Be Cops,8/13/2014,17000000,136621271,119621271,502923.1244639524
Phenomenon,7/5/1996,32000000,152036382,120036382,764562.9426751592
Shall We Dance?,10/15/2004,50000000,170128460,120128460,629274.2797276061
The Muppets,11/22/2011,45000000,165184237,120184237,532561.5805239463
Hannah Montana: The Movie,4/10/2009,35000000,155545279,120545279,565303.3155130369
Johnny English,4/6/2003,40000000,160583018,120583018,656055.5930359085
Anger Management,4/11/2003,75000000,195745823,120745823,656941.3656147986
葉問3,12/19/2015,36000000,156844753,120844753,510074.25838693883
Hop,3/30/2011,63000000,183953723,120953723,537796.7817666047
Superman Returns,6/28/2006,270000000,391081192,121081192,594993.5724815725
Midnight in Paris,5/11/2011,30000000,151119219,121119219,536011.130091519
Mr. Deeds,6/28/2002,50000000,171269535,121269535,673345.5580233204
50 First Dates,2/13/2004,75000000,196482882,121482882,652432.2341568207
Under Siege,10/8/1992,35000000,156563139,121563139,857285.8885754583
Yogi Bear,12/11/2010,80000000,201584141,121584141,554725.3204002208
Sleepers,10/18/1996,44000000,165615285,121615285,766805.075662043
Sausage Party,7/11/2016,19000000,140705322,121705322,505782.0453147597
Porky's,11/13/1981,4000000,125728258,121728258,1299127.6200640341
Scream 3,2/3/2000,40000000,161834276,121834276,717516.3486454652
Kill Bill: Vol. 2,4/16/2004,30000000,152159461,122159461,646004.5531464834
Goldfinger,9/17/1964,2500000,124881062,122381062,3935082.3794212216
Bad Boys,4/7/1995,19000000,141407024,122407024,805839.5260039499
A View to a Kill,5/24/1985,30000000,152427960,122427960,1137806.3197026022
RoboCop,1/30/2014,120000000,242688965,122688965,522567.6907415847
No Strings Attached,1/21/2011,25000000,147780440,122780440,554791.8973019624
Safe House,2/9/2012,85000000,208076205,123076205,540606.9717081827
The X Files,6/19/1998,66000000,189198313,123198313,754891.6237745099
Anchorman 2: The Legend Continues,12/18/2013,50000000,173649015,123649015,528604.3494245798
Legally Blonde,7/13/2001,18000000,141774679,123774679,697322.1352112676
Never Say Never Again,10/7/1983,36000000,160000000,124000000,1227722.7722772278
Licence to Kill,7/7/1989,32000000,156167015,124167015,998127.1302250803
The Sum of All Fears,5/31/2002,68000000,193000000,125000000,694830.4613674263
The Exorcism of Emily Rose,9/9/2005,19000000,144216468,125216468,629861.5090543259
A Christmas Carol,11/4/2009,200000000,325233863,125233863,578901.9692137012
Valkyrie,12/25/2008,75000000,200276000,125276000,593323.0085771255
The Specialist,10/7/1994,45000000,170362582,125362582,838545.6989966555
Gulliver's Travels,12/25/2010,112000000,237382724,125382724,569344.3645759071
Bridge of Spies,10/15/2015,40000000,165478348,125478348,527579.0580142786
Beowulf,11/5/2007,70000000,195735876,125735876,598238.0374636616
The Game Plan,9/28/2007,22000000,147880543,125880543,602483.7414327832
Rambo III,5/24/1988,63000000,189015611,126015611,1067928.906779661
Moulin Rouge!,3/9/2001,52500000,179213434,126713434,719145.4824063565
Burn After Reading,9/5/2008,37000000,163720069,126720069,579204.3668840815
P.S. I Love You,11/15/2007,30000000,156835339,126835339,603469.1664644561
The Best Exotic Marigold Hotel,11/28/2011,10000000,136836156,126836156,562037.62983445
The Horse Whisperer,5/14/1998,60000000,186883563,126883563,779383.065110565
How to Lose a Guy in 10 Days,2/7/2003,50000000,177371441,127371441,695638.6728563627
Heat,12/15/1995,60000000,187436818,127436818,830207.2833876221
G.I. Joe: The Rise of Cobra,8/4/2009,175000000,302469017,127469017,590588.2159437345
Chocolat,12/14/2000,25000000,152500343,127500343,732760.591954023
Step Up 2: The Streets,2/14/2008,23000000,150816700,127816700,603783.3088481905
Mr. Peabody & Sherman,2/7/2014,145000000,272912430,127912430,544815.934849924
Exodus: Gods and Kings,12/3/2014,140000000,268031828,128031828,545252.491354786
The Girl on the Train,10/5/2016,45000000,173185859,128185859,530287.4665431123
Lion,11/24/2016,12000000,140302754,128302754,531423.9785943868
The Princess Diaries,8/3/2001,37000000,165335153,128335153,723014.9464788733
Ride Along,1/7/2014,25000000,153997819,128997819,551470.694608321
Beverly Hills Chihuahua,10/3/2008,20000000,149281606,129281606,596942.3981752112
Step Up 3D,8/4/2010,30000000,159291809,129291809,592234.09157536
Saw IV,10/25/2007,10000000,139352633,129352633,615446.1858338448
Alice Through the Looking Glass,5/25/2016,170000000,299370084,129370084,536765.2374511447
Dumb and Dumber To,11/12/2014,40000000,169837010,129837010,549805.039995596
Along Came Polly,1/16/2004,42000000,171963386,129963386,697977.3684210527
Chronicle,2/1/2012,15000000,145000000,130000000,571019.4454083447
27 Dresses,1/10/2008,30000000,160259319,130259319,617108.7691870381
The Bucket List,12/25/2007,45000000,175372502,130372502,617644.9782073147
Legends of the Fall,12/16/1994,30000000,160638883,130638883,869187.5116433798
Flight,11/2/2012,31000000,161772375,130772375,568029.7409880072
Constantine,2/8/2005,100000000,230884728,130884728,682402.1272158498
Red Dragon,9/29/2002,78000000,209196298,131196298,723642.0187534473
The Color Purple,12/18/1985,15000000,146292009,131292009,1197919.7901459855
Percy Jackson & the Olympians: The Lightning Thief,2/1/2010,95000000,226497209,131497209,606702.0499121071
Mama,1/17/2013,15000000,146497771,131497771,566395.4713437799
John Wick: Chapter 2,2/8/2017,40000000,171539887,131539887,539976.4658070713
Rocky Balboa,12/20/2006,24000000,155721132,131721132,650744.6644534029
Mystic River,10/7/2003,25000000,156822020,131822020,712551.4594594594
Ben-Hur,12/26/1959,15000000,146900000,131900000,4501706.484641638
Mr. Popper's Penguins,6/17/2011,55000000,187361754,132361754,585873.6820672621
Battle: Los Angeles,3/8/2011,70000000,202466756,132466756,592779.9451373133
Platoon,12/18/1986,6000000,138530565,132530565,1191821.6276978417
Romeo + Juliet,10/31/1996,14500000,147298761,132798761,837318.7957124843
Bedtime Stories,12/24/2008,80000000,212874442,132874442,629310.192618273
Patriot Games,6/4/1992,45000000,178051587,133051587,949012.7460770329
Scary Movie 4,4/13/2006,45000000,178262620,133262620,661352.952853598
劇場版ポケットモンスター ミュウツーの逆襲,7/18/1998,30000000,163644662,133644662,817898.7882496939
Big,6/3/1988,18000000,151668774,133668774,1132786.220338983
Free Willy,7/16/1993,20000000,153698625,133698625,923333.0455801104
In Time,10/27/2011,40000000,173930596,133930596,592010.7678026787
It's Complicated,12/23/2009,85000000,219103655,134103655,618881.8664709927
Public Enemies,7/1/2009,80000000,214104620,134104620,622725.7825596352
Love Story,12/16/1970,2200000,136400000,134200000,3371859.296482412
Limitless,3/8/2011,27000000,161849455,134849455,603442.3650919375
Just Go with It,2/10/2011,80000000,214918407,134918407,609638.1394340041
What Happens in Vegas,5/7/2008,35000000,170000000,135000000,623176.6313379371
Hacksaw Ridge,10/7/2016,40000000,175302354,135302354,559727.4385779116
Alien: Covenant,5/9/2017,97000000,232380243,135380243,553175.2685579795
Vanilla Sky,12/10/2001,68000000,203388341,135388341,766204.533106961
Thunderball,12/16/1965,5500000,141195658,135695658,4267159.0566037735
A.I. Artificial Intelligence,6/29/2001,100000000,235926552,135926552,765783.3915492957
Superman II,12/4/1980,54000000,190458706,136458706,1581213.279258401
Creed,11/25/2015,37000000,173567581,136567581,577391.7387168375
Jackass Presents: Bad Grandpa,10/22/2013,15000000,151831537,136831537,587085.957377429
In the Line of Fire,7/8/1993,40000000,176997168,136997168,948733.8504155125
Smurfs: The Lost Village,3/23/2017,60000000,197183546,137183546,561022.8280250609
Jumper,2/10/2008,85000000,222231186,137231186,648255.6626813357
He's Just Not That Into You,2/6/2009,40000000,177259441,137259441,646861.3055096067
Need for Speed,3/13/2014,66000000,203277636,137277636,580963.6172040644
The Equalizer,9/24/2014,55000000,192330738,137330738,578397.8553949957
Bee Movie,10/28/2007,150000000,287594577,137594577,654660.4861616638
Paranormal Activity 4,10/17/2012,5000000,142817992,137817992,598633.4522046208
Braveheart,5/24/1995,72000000,210000000,138000000,904918.0327868853
Lo imposible,9/9/2012,42000000,180274123,138274123,597536.4746960982
Driving Miss Daisy,12/13/1989,7500000,145793296,138293296,1096695.4480570976
Animal House,7/27/1978,2700000,141000000,138300000,2095454.5454545454
22 Jump Street,6/5/2014,50000000,188441614,138441614,580850.3459300252
Up in the Air,9/5/2009,25000000,163670000,138670000,642082.8915260987
Identity Thief,2/7/2013,35000000,173965010,138965010,598558.8329040428
Charlie's Angels: Full Throttle,6/27/2003,120000000,259175788,139175788,756801.4573137575
American Graffiti,8/1/1973,777000,140000000,139223000,3086984.4789356985
Twelve Monkeys,12/29/1995,29500000,168840000,139340000,902461.139896373
Inside Man,3/23/2006,45000000,184376254,139376254,691693.5682382134
Outbreak,3/10/1995,50000000,189859560,139859560,923775.1651254953
西游记之大圣归来,7/10/2015,10000000,150000000,140000000,586623.3124104352
Van Helsing,5/5/2004,160000000,300257475,140257475,741710.602855632
Vertical Limit,12/8/2000,75000000,215663859,140663859,808412.9827586206
Cool Runnings,9/30/1993,14000000,154864401,140864401,966811.2628689088
The Polar Express,11/10/2004,165000000,305875730,140875730,737569.2670157069
Elf,10/9/2003,32000000,173398518,141398518,764316.3135135135
Stargate,10/27/1994,55000000,196567262,141567262,945673.0928523715
Police Academy,3/22/1984,4500000,146198896,141698896,1374383.0843840933
Gremlins,6/7/1984,11000000,153083102,142083102,1370135.9884281582
Eraser,6/21/1996,100000000,242295562,142295562,906341.1592356688
The Girl with the Dragon Tattoo,12/14/2011,90000000,232617430,142617430,631967.7673792052
G-Force,7/21/2009,150000000,292817841,142817841,661702.2387575636
Cloudy with a Chance of Meatballs,9/17/2009,100000000,242988466,142988466,661441.6242245937
Bad Boys II,7/18/2003,130000000,273339556,143339556,776487.3022751897
Hercules,7/23/2014,100000000,243400000,143400000,602895.9184703092
City of Angels,4/10/1998,55000000,198685114,143685114,884216.0861538461
Fury,10/15/2014,68000000,211817906,143817906,605719.9546819524
Big Momma's House,5/31/2000,30000000,173959438,143959438,835031.5429234338
Lights Out,7/21/2016,4900000,148868835,143968835,597755.5854498047
Eat Pray Love,8/12/2010,60000000,204594016,144594016,662327.3846604859
The Grand Budapest Hotel,2/26/2014,30000000,174600318,144600318,611953.4560905317
Knight and Day,6/15/2010,117000000,261930431,144930431,664925.244878765
Inferno,10/13/2016,75000000,220021259,145021259,599933.2268780328
Unforgiven,8/7/1992,14000000,159157447,145157447,1030216.0894251241
Lethal Weapon 4,7/10/1998,140000000,285444603,145444603,891204.6752450981
Dracula Untold,10/1/2014,70000000,215529201,145529201,612927.4405832383
London Has Fallen,3/2/2016,60000000,205754447,145754447,612074.173147666
Cloverfield,1/15/2008,25000000,170764026,145764026,690562.9429600151
The Final Destination,8/26/2009,40000000,186167139,146167139,676796.8504739106
英雄,12/19/2002,31000000,177394432,146394432,805693.0764997249
Entrapment,4/29/1999,66000000,212404396,146404396,880892.8760529483
The Bourne Legacy,8/8/2012,130000000,276572938,146572938,636225.2549060462
No Country for Old Men,11/8/2007,25000000,171600000,146600000,697507.3390523226
Due Date,11/4/2010,65000000,211780824,146780824,670835.5187086101
Love's Deadly Triangle: The Texas Cadet Murder,2/20/1997,14000000,161001698,147001698,918760.6125
Born on the Fourth of July,12/20/1989,14000000,161001698,147001698,1153859.4819466248
Don't Breathe,8/25/2016,9900000,157100845,147200845,609709.0851102606
Gone in Sixty Seconds,6/9/2000,90000000,237202299,147202299,853841.6415313225
The Peanuts Movie,11/5/2015,99000000,246233113,147233113,620357.2698621363
Cape Fear,11/15/1991,35000000,182300000,147300000,1068940.4934687952
Turbo,7/11/2013,135000000,282570682,147570682,631734.627305262
DodgeBall: A True Underdog Story,6/18/2004,20000000,167722310,147722310,779948.83843717
Scream 2,12/9/1997,24000000,172363301,148363301,919797.2783632982
Panic Room,3/29/2002,48000000,196397415,148397415,825347.1357063403
Everest,9/10/2015,55000000,203427584,148427584,623789.4639517536
The Prince of Egypt,12/15/1998,70000000,218613188,148613188,906730.8602806589
Saw II,10/28/2005,4000000,152925093,148925093,753669.4989878542
Con Air,6/1/1997,75000000,224012234,149012234,929583.4934497816
Ted 2,6/25/2015,68000000,217022588,149022588,624429.4585466826
Eragon,12/14/2006,100000000,249288105,149288105,739782.4826560951
Cheaper by the Dozen,12/24/2003,40000000,190212113,150212113,811080.5237580994
The Pelican Brief,12/16/1993,45000000,195268056,150268056,1027825.2804377566
Sweet Home Alabama,9/26/2002,30000000,180622424,150622424,830791.0865968008
Get Smart,6/19/2008,80000000,230685453,150685453,685045.9757051154
Garfield,6/10/2004,50000000,200804534,150804534,794963.27886136
Kill Bill: Vol. 1,10/10/2003,30000000,180949000,150949000,815940.5405405406
Wrath of the Titans,3/27/2012,150000000,301000000,151000000,656279.2011647869
The Living Daylights,6/29/1987,40000000,191185897,151185897,1328522.820738137
Cocktail,7/29/1988,20000000,171504781,151504781,1273149.4201680673
Immortals,11/10/2011,75000000,226904017,151904017,671458.3255978429
City Slickers,6/7/1991,27000000,179033791,152033791,1117895.5220588236
Patch Adams,12/25/1998,50000000,202292902,152292902,926919.6713329275
Collateral,8/4/2004,65000000,217764291,152764291,806144.0158311345
The Break-Up,6/1/2006,52000000,204999686,152999686,754064.494825037
The Day the Earth Stood Still,12/10/2008,80000000,233093859,153093859,728227.7289419107
Gnomeo & Juliet,1/13/2011,36000000,189712432,153712432,697985.3693755874
Saw III,10/27/2006,10000000,163876815,153876815,763656.6501240695
Clear and Present Danger,8/3/1994,62000000,215887717,153887717,1032803.4697986577
The Bourne Identity,6/14/2002,60000000,214034224,154034224,856221.3674263479
The Sting,12/25/1973,5500000,159616327,154116327,3307217.3175965664
The Birdcage,3/8/1996,31000000,185260553,154260553,990754.9967886963
Live and Let Die,7/5/1973,7000000,161777836,154777836,3493856.3431151244
A Star Is Born,12/16/1976,6000000,161000000,155000000,2649572.6495726495
Hot Shots!,7/31/1991,26000000,181096164,155096164,1135403.8360175695
Click,6/22/2006,82500000,237681299,155181299,762561.6658476659
The Mask of Zorro,7/16/1998,95000000,250288523,155288523,950358.1578947369
Pixels,7/16/2015,88000000,243637091,155637091,653070.2554591383
Yes Man,12/9/2008,70000000,225990978,155990978,742008.5716460224
Sleeping with the Enemy,2/8/1991,19000000,174999005,155999005,1157262.6483679523
The Lost World: Jurassic Park,5/23/1997,73000000,229074524,156074524,973640.1996257018
Tootsie,12/16/1982,21000000,177200000,156200000,1597137.0143149286
Arrival,11/10/2016,47000000,203388186,156388186,647964.5415636018
The Other Woman,4/16/2014,40000000,196781193,156781193,659021.4081546868
The Good Dinosaur,11/14/2015,175000000,331926147,156926147,661198.2463680183
The Descendants,9/9/2011,20000000,177243185,157243185,693040.142977403
Paul Blart: Mall Cop,1/15/2009,26000000,183293131,157293131,744960.197591206
The Bridges of Madison County,5/28/1995,24000000,182016617,158016617,1036174.5377049181
Jack Reacher,12/20/2012,60000000,218340595,158340595,687600.2909501477
Walk the Line,9/13/2005,28000000,186438883,158438883,796976.2726358149
Star Trek Beyond,7/7/2016,185000000,343471816,158471816,658575.9595724521
Spy Kids 3-D: Game Over,7/25/2003,38000000,197011982,159011982,861386.684723727
Disclosure,12/9/1994,55000000,214015089,159015089,1062225.0434201737
Scream,12/20/1996,14000000,173046663,159046663,999664.7580138278
4: Rise of the Silver Surfer,6/13/2007,130000000,289047763,159047763,763360.8652664721
The Terminal,6/17/2004,60000000,219417255,159417255,841696.1721224921
Traffic,12/27/2000,48000000,207515725,159515725,910997.8583666476
The Intern,9/24/2015,35000000,194564672,159564672,670896.4589342326
21 Jump Street,3/12/2012,42000000,201585328,159585328,695688.289042338
Lara Croft: Tomb Raider,6/11/2001,115000000,274703340,159703340,897209.7752808989
Bolt,11/21/2008,150000000,309979994,159979994,760983.2848145822
Octopussy,6/5/1983,27500000,187500000,160000000,1608040.201005025
Magic Mike,6/28/2012,7000000,167221571,160221571,699339.9111320622
2 Fast 2 Furious,6/5/2003,76000000,236350661,160350661,872894.1807294502
Enemy of the State,11/20/1998,90000000,250649836,160649836,980169.8352654057
The Addams Family,11/22/1991,30000000,191502426,161502426,1171156.0986221898
Rise of the Guardians,11/21/2012,145000000,306941670,161941670,705317.7904277421
The Princess and the Frog,12/8/2009,105000000,267045765,162045765,750389.0501924065
The Curse of the Were-Rabbit,9/4/2005,30000000,192452832,162452832,817167.1629778672
Into the Woods,12/25/2014,50000000,212902372,162902372,697036.7682611133
The Waterboy,11/6/1998,23000000,185991646,162991646,993851.5
Interview with the Vampire,11/11/1994,60000000,223664608,163664608,1093283.9545758185
Le fabuleux destin d'Amélie Poulain,4/25/2001,10000000,173921954,163921954,922464.569499156
Bad Moms,7/28/2016,20000000,183936074,163936074,680659.1432806448
Brokeback Mountain,9/2/2005,14000000,178043761,164043761,825169.8239436619
Chicken Little,11/4/2005,150000000,314432665,164432665,832149.1143724697
Valentine's Day,2/10/2010,52000000,216485654,164485654,758904.1944071495
Aliens,7/18/1986,18500000,183316455,164816455,1502428.9425706472
While You Were Sleeping,4/21/1995,17000000,182057016,165057016,1084474.4809461236
JFK,12/20/1991,40000000,205405498,165405498,1197722.6502534396
Face/Off,6/27/1997,80000000,245676146,165676146,1032250.1308411215
The Vow,2/5/2012,30000000,196114570,166114570,729651.1510434282
Oblivion,4/10/2013,120000000,286168572,166168572,714608.2543832865
American Gangster,11/2/2007,100000000,266465037,166465037,792023.0900621857
Central Intelligence,6/15/2016,50000000,216972543,166972543,692780.3856973338
Grown Ups 2,7/11/2013,80000000,246984278,166984278,714842.1976403706
12 Years a Slave,10/18/2013,20000000,187000000,167000000,716526.0073197208
Miss Congeniality,12/14/2000,45000000,212000000,167000000,959770.1149425288
Stuart Little,12/17/1999,133000000,300135367,167135367,990138.4300947867
The Ugly Truth,7/24/2009,38000000,205298907,167298907,775127.6768257086
For Your Eyes Only,6/23/1981,28000000,195312802,167312802,1826558.9737991267
Hercules,6/26/1997,85000000,252712101,167712101,1044935.2087227415
The Santa Clause,11/10/1994,22000000,189833357,167833357,1121131.3092852372
Jaws 2,6/16/1978,20000000,187884007,167884007,2555312.130898021
Flightplan,9/22/2005,55000000,223387299,168387299,845317.7660642571
Epic,5/15/2013,100000000,268426634,168426634,723031.7628624783
The Last Airbender,6/30/2010,150000000,318502923,168502923,772910.1880180358
The Hunt for Red October,3/2/1990,30000000,199200000,169200000,1314685.314685315
The Fast and the Furious,6/22/2001,38000000,207283925,169283925,953712.2535211268
Planes,8/9/2013,50000000,219788712,169788712,725974.3882468134
Die Hard 2,7/2/1990,70000000,240031094,170031094,1303919.4325153374
Space Jam,11/15/1996,80000000,250200000,170200000,1073139.974779319
Cloudy with a Chance of Meatballs 2,9/26/2013,78000000,248384621,170384621,729554.8671353824
Spy,5/6/2015,65000000,235666219,170666219,717672.9631420702
Elysium,8/7/2013,115000000,286140700,171140700,731755.1533498378
Terminator Salvation,5/20/2009,200000000,371353001,171353001,794430.0510447719
The Spy Who Loved Me,7/7/1977,14000000,185438673,171438673,2810470.049180328
Charlie's Angels,11/2/2000,92000000,264105545,172105545,988544.1987363584
A Dog's Purpose,1/19/2017,22000000,194647323,172647323,708724.1249081497
Scary Movie 3,10/24/2003,48000000,220673217,172673217,935898.1951219512
Non-Stop,1/26/2014,50000000,222809600,172809600,736045.9321665722
Unbreakable,11/13/2000,75000000,248118121,173118121,994360.2584721425
The Grudge,10/22/2004,10000000,183474602,173474602,908243.9895287958
Straight Outta Compton,8/13/2015,28000000,201634991,173634991,728591.4122425687
Wind River,8/3/2017,11000000,184770205,173770205,707766.8327094847
The Fifth Element,5/7/1997,90000000,263920180,173920180,1086322.1736414742
8 Mile,11/8/2002,41000000,215000000,174000000,959735.2454495311
The Hangover Part II,5/25/2011,80000000,254455986,174455986,772879.8522075828
Paranormal Activity 2,10/20/2010,3000000,177512032,174512032,797576.0478604041
Hansel & Gretel: Witch Hunters,1/17/2013,50000000,224803475,174803475,752924.5238320857
Resident Evil: Retribution,9/12/2012,65000000,240159255,175159255,756931.5318897008
Cars 3,6/15/2017,175000000,350170057,175170057,715111.1714396521
Grease,7/7/1978,6000000,181813770,175813770,2676008.6757990867
Dracula,11/13/1992,40000000,215862692,175862692,1238469.661971831
Moonraker,6/26/1979,34000000,210308099,176308099,2411875.4993160055
American Wedding,8/1/2003,55000000,231449203,176449203,955846.1700975081
The Legend of Tarzan,6/29/2016,180000000,356743061,176743061,734507.4596472564
Bridget Jones's Baby,9/14/2016,35000000,211952420,176952420,732940.7525224912
Ghostbusters II,6/15/1989,37000000,215394738,178394738,1437507.961321515
Sully,9/7/2016,60000000,238470033,178470033,739226.7384064815
The Tourist,12/8/2010,100000000,278731369,178731369,815458.4563302142
Chicken Run,6/21/2000,45000000,224834564,179834564,1040709.2824074073
Philadelphia,12/22/1993,26000000,206678440,180678440,1235830.6429548564
District 9,8/5/2009,30000000,210819611,180819611,837771.6717477321
The Great Wall,12/16/2016,150000000,331957105,181957105,749291.1146891562
The Little Mermaid,11/17/1989,40000000,222300000,182300000,1445678.0333068992
Ace Ventura: When Nature Calls,11/10/1995,30000000,212385533,182385533,1187405.8138020835
Wanted,6/19/2008,75000000,258270008,183270008,833181.8297539598
Salt,7/21/2010,110000000,293329073,183329073,839757.1961229799
Snow White and the Seven Dwarfs,12/20/1937,1488423,184925486,183437063,1.2918103028169015E7
The Curious Case of Benjamin Button,11/24/2008,150000000,333932083,183932083,874917.1518541774
Marley & Me,12/25/2008,60000000,244082376,184082376,871837.4561316264
Silver Linings Playbook,9/8/2012,21000000,205738714,184738714,798328.1145341324
The Social Network,9/30/2010,40000000,224920315,184920315,845500.7521340947
American Reunion,4/4/2012,50000000,234989584,184989584,804005.4066975248
Cliffhanger,5/28/1993,70000000,255000211,185000211,1281164.8961218835
Prince of Persia: The Sands of Time,5/19/2010,150000000,335154643,185154643,849469.6075057922
Insurgent,3/18/2015,110000000,295238201,185238201,782920.473036657
Robots,3/10/2005,75000000,260696994,185696994,960667.3254009312
You've Got Mail,12/17/1998,65000000,250821495,185821495,1130989.0139987827
Miss Peregrine's Home for Peculiar Children,9/28/2016,110000000,296485719,186485719,771466.0590992392
Something's Gotta Give,12/12/2003,80000000,266728738,186728738,1013178.1768855127
Million Dollar Baby,12/15/2004,30000000,216763646,186763646,981416.9521807672
Kindergarten Cop,12/21/1990,15000000,201957688,186957688,1388987.280832095
Argo,10/11/2012,44500000,232324128,187824128,811977.1914731732
Me Before You,6/2/2016,20000000,207945075,187945075,779796.8408998498
Sex and the City 2,5/26/2010,100000000,288347692,188347692,864118.9732296469
Teenage Mutant Ninja Turtles,3/30/1990,13500000,202000000,188500000,1462373.9332816135
Knocked Up,6/1/2007,30000000,219076518,189076518,907485.9756565811
功夫瑜伽,1/27/2017,65000000,254212245,189212245,776723.7882948896
Real Steel,9/28/2011,110000000,299268508,189268508,835914.1069070449
Baby Driver,6/28/2017,34000000,224511319,190511319,778277.0215616906
Grown Ups,6/24/2010,80000000,271430189,191430189,878075.8264491241
Scooby-Doo,6/14/2002,84000000,275650703,191650703,1065317.9710950528
Megamind,10/28/2010,130000000,321887208,191887208,876986.1839188677
The Golden Compass,12/4/2007,180000000,372234864,192234864,915247.2147631835
Edge of Tomorrow,5/27/2014,178000000,370541256,192541256,807832.6445500812
Daddy's Home,12/25/2015,50000000,242786137,192786137,813732.0273852336
Passengers,12/21/2016,110000000,303144152,193144152,795358.867397741
Rocky II,6/15/1979,7000000,200182160,193182160,2671952.420470263
Paranormal Activity,9/14/2007,15000,193355800,193340800,927338.4814619406
X-Men: First Class,5/24/2011,160000000,353624124,193624124,857799.0802845978
The Expendables,8/3/2010,80000000,274470394,194470394,890791.1337901718
The Chronicles of Narnia: Prince Caspian,5/15/2008,225000000,419651413,194651413,898534.9025074781
Bad Teacher,5/16/2011,20000000,216197492,196197492,869199.6881119253
Total Recall,6/1/1990,65000000,261317921,196317921,1511300.3926096996
卧虎藏龙,10/1/2000,17000000,213525736,196525736,1129458.2528735632
The Village,7/30/2004,60000000,256697520,196697520,1037981.635883905
Jumanji,12/15/1995,65000000,262797249,197797249,1288581.4267100978
Presumed Innocent,7/26/1990,22000000,221303188,199303188,1514461.9148936172
The Departed,10/5/2006,90000000,289847354,199847354,990323.8553022795
Batman Returns,6/19/1992,80000000,280000000,200000000,1423487.5444839858
Big Daddy,6/25/1999,34200000,234801895,200601895,1203370.6958608278
Sister Act,5/28/1992,31000000,231605150,200605150,1430849.8573466477
Paranormal Activity 3,10/19/2011,5000000,205703818,200703818,887167.121955532
The Ring,10/18/2002,48000000,249348933,201348933,1110584.2967457252
Twins,12/9/1988,15000000,216614388,201614388,1673148.4481327801
Taken,2/18/2008,25000000,226830568,201830568,945218.2758233113
The Jungle Book,10/17/1967,4000000,205843612,201843612,5971704.497041421
Lethal Weapon 2,7/7/1989,25000000,227853986,202853986,1630659.0514469452
A Few Good Men,12/11/1992,40000000,243240178,203240178,1432277.5052854123
Divergent,3/14/2014,85000000,288747895,203747895,862268.0104785161
The Truman Show,6/4/1998,60000000,264118201,204118201,1252258.9018404908
Paddington,11/27/2014,55000000,259207227,204207227,869662.6535270769
Erin Brockovich,3/17/2000,52000000,256271286,204271286,1192476.85931115
Back to the Future Part III,5/25/1990,40000000,244527583,204527583,1574500.2540415705
Mr. Bean's Holiday,3/22/2007,25000000,229736344,204736344,990567.0630811956
Love Actually,9/7/2003,40000000,244931766,204931766,1106543.0129589634
The English Patient,11/14/1996,27000000,231976425,204976425,1292411.2547288777
Hidden Figures,12/10/2016,25000000,230698791,205698791,851994.7272938136
The Perfect Storm,3/15/2000,120000000,325756637,205756637,1201849.5151869159
人再囧途之泰囧,12/12/2012,2200000,208000000,205800000,896337.5595054028
Pulp Fiction,9/10/1994,8000000,213928762,205928762,1378371.9009370815
Monsters vs Aliens,3/19/2009,175000000,381509870,206509870,968438.7075595573
Angels & Demons,5/13/2009,150000000,356613439,206613439,966133.468315128
Sleepless in Seattle,6/24/1993,21000000,227799884,206799884,1432132.1606648199
xXx,8/9/2002,70000000,277448382,207448382,1148026.4637520753
Dirty Dancing,8/21/1987,6000000,213954274,207954274,1808298.0347826087
La vita è bella,12/20/1997,20000000,229400000,209400000,1295792.079207921
Sherlock Holmes: A Game of Shadows,11/22/2011,125000000,334615000,209615000,928848.0626750328
Super 8,6/8/2011,50000000,260095987,210095987,930773.1944604424
Lincoln,11/9/2012,65000000,275293450,210293450,913441.6495454367
Little Fockers,12/21/2010,100000000,310650585,210650585,956533.082375592
American Hustle,12/12/2013,40000000,251171807,211171807,906126.2095095881
Rush Hour,9/18/1998,33000000,244386864,211386864,1288944.2926829269
One Hundred and One Dalmatians,1/25/1961,4000000,215880014,211880014,7110067.583892617
Baahubali 2: The Conclusion,4/27/2017,18000000,230000000,212000000,866250.158335819
Horton Hears a Who!,3/3/2008,85000000,297138014,212138014,993490.3806526545
The Expendables 2,8/8/2012,100000000,312573423,212573423,922711.8053294788
A Good Day to Die Hard,2/6/2013,92000000,304654182,212654182,915957.4700860591
The Bourne Supremacy,7/23/2004,75000000,288500217,213500217,1126650.221635884
True Grit,12/22/2010,38000000,252276927,214276927,972999.7638757078
Mulan,6/18/1998,90000000,304320254,214320254,1313236.8504901961
Shutter Island,2/18/2010,80000000,294804195,214804195,987011.0186508356
Good Will Hunting,12/5/1997,10000000,225933435,215933435,1338706.974581525
War for the Planet of the Apes,7/11/2017,152000000,369907963,217907963,890197.817685652
Dead Poets Society,6/2/1989,16400000,235860116,219460116,1768413.5052377116
The Imitation Game,11/14/2014,14000000,233555708,219555708,929725.9295958941
X-Men,7/13/2000,75000000,296339527,221339527,1280900.040509259
Trolls,10/13/2016,125000000,346864462,221864462,917823.1076949807
How the Grinch Stole Christmas,11/17/2000,123000000,345141403,222141403,1276674.7298850575
Night at the Museum: Secret of the Tomb,12/17/2014,127000000,349424282,222424282,951722.8067623135
Tomorrow Never Dies,12/11/1997,110000000,333011068,223011068,1382585.6664600123
X-Men Origins: Wolverine,4/28/2009,150000000,373062864,223062864,1043051.6983390693
Doctor Dolittle,6/22/1998,71000000,294456605,223456605,1369219.393382353
Jerry Maguire,12/6/1996,50000000,273552592,223552592,1409537.1500630518
Juno,12/5/2007,7500000,231411584,223911584,1066062.8844579025
Babe,7/18/1995,30000000,254134910,224134910,1465892.1517331589
Batman Begins,6/10/2005,150000000,374218673,224218673,1152795.233933162
American Pie,7/9/1999,11000000,235483004,224483004,1346628.698260348
The Green Mile,12/10/1999,60000000,284600000,224600000,1334521.6874628637
Independence Day: Resurgence,6/22/2016,165000000,389681935,224681935,933731.4651661486
Ocean's Thirteen,6/7/2007,85000000,311312624,226312624,1086203.2713868837
Snow White and the Huntsman,5/30/2012,170000000,396600000,226600000,987458.4927531179
Dinosaur,5/19/2000,127500000,354248063,226748063,1315243.9849187934
The World Is Not Enough,11/8/1999,135000000,361832400,226832400,1347786.0962566845
300: Rise of an Empire,3/5/2014,110000000,337580051,227580051,963126.5039590677
Pacific Rim,7/11/2013,180000000,407602906,227602906,974344.1925375435
The Firm,6/30/1993,42000000,270248367,228248367,1580667.3614958448
Indecent Proposal,4/7/1993,38000000,266614059,228614059,1587597.6319444445
Mad Max: Fury Road,5/13/2015,150000000,378858340,228858340,962378.1669855553
Ransom,11/8/1996,80000000,309492681,229492681,1446990.4224464062
TRON: Legacy,12/10/2010,170000000,400062763,230062763,1049656.9607489768
Air Force One,7/25/1997,85000000,315156409,230156409,1431320.9514925373
Captain America: The First Avenger,7/22/2011,140000000,370569774,230569774,1017765.8919861397
Fantastic Four,6/29/2005,100000000,330579719,230579719,1180039.5035823951
Hook,12/11/1991,70000000,300854823,230854823,1674074.1334300216
Dumb and Dumber,12/16/1994,16000000,247275374,231275374,1538758.3100465734
The Lego Batman Movie,2/8/2017,80000000,311950384,231950384,952165.5480433328
We're the Millers,8/7/2013,37000000,269994119,232994119,996225.0199891395
Bean,7/3/1997,18000000,251212670,233212670,1453038.4423676012
Saturday Night Fever,12/16/1977,3500000,237113184,233613184,3737810.944
Austin Powers in Goldmember,7/26/2002,63000000,296655431,233655431,1293057.1721084672
Home,3/18/2015,135000000,368871007,233871007,988469.9724005597
Terminator 3: Rise of the Machines,7/2/2003,200000000,435000000,235000000,1277868.406742795
Star Trek,5/6/2009,150000000,385680446,235680446,1102052.0630704775
Batman Forever,6/16/1995,100000000,336529144,236529144,1551010.7803278689
Gran Torino,12/9/2008,33000000,269958228,236958228,1127148.7527826931
The SpongeBob Movie: Sponge Out of Water,2/5/2015,74000000,311594032,237594032,1012235.8875606036
Noah,3/20/2014,125000000,362637473,237637473,1002385.2373962341
Casper,5/26/1995,50000000,287928194,237928194,1560184.8786885245
The Godfather,3/14/1972,6000000,245066411,239066411,5774550.990338164
Runaway Bride,7/30/1999,70000000,309457509,239457509,1433019.2040694195
Resident Evil: Afterlife,9/9/2010,60000000,300228084,240228084,1099749.0558004752
寻龙诀,12/18/2015,37000000,278300000,241300000,1018504.448834186
Penguins of Madagascar,11/22/2014,132000000,373552094,241552094,1028704.2144353781
G.I. Joe: Retaliation,3/26/2013,130000000,371876278,241876278,1040189.385501288
The Adventures of Tintin,10/25/2011,130000000,371940071,241940071,1069442.9165009062
The Smurfs 2,7/30/2013,105000000,347434178,242434178,1036588.369099997
A Bug's Life,11/25/1998,120000000,363258859,243258859,1484190.7199511896
Borat: Cultural Learnings of America for Make Benefit Glorious Nation of Kazakhstan,11/1/2006,18000000,261572744,243572744,1208797.7369727048
Now You See Me 2,6/2/2016,90000000,334901337,244901337,1016112.2281323386
Wedding Crashers,7/14/2005,40000000,285176741,245176741,1254742.7891504606
Superman,12/13/1978,55000000,300218018,245218018,3622127.2968980796
The Great Gatsby,5/10/2013,105000000,351040419,246040419,1056216.7850780226
Get Out,2/24/2017,5000000,252434250,247434250,1014902.5229592988
National Treasure,11/19/2004,100000000,347451894,247451894,1300325.2443510245
Mission: Impossible III,5/3/2006,150000000,397850012,247850012,1223950.67654321
The Blair Witch Project,7/14/1999,60000,248000000,247940000,1487342.5314937013
The Prince,8/22/2014,18000000,266586800,248586800,1044346.3246383874
Four Weddings and a Funeral,3/9/1994,6000000,254700832,248700832,1689543.695652174
Annabelle,10/2/2014,6500000,255273813,248773813,1047764.2661298135
Godzilla,5/20/1998,130000000,379014294,249014294,1527695.055214724
Inglourious Basterds,8/18/2009,70000000,319131050,249131050,1153550.0465344563
X-Men: The Last Stand,5/24/2006,210000000,459359555,249359555,1228977.5998028584
Coming to America,6/28/1988,39000000,288752301,249752301,2107614.35443038
Neighbors,5/8/2014,18000000,268157400,250157400,1051523.3291298866
Maze Runner: The Scorch Trials,9/9/2015,61000000,311256926,250256926,1051742.7388682258
The Pursuit of Happyness,12/14/2006,55000000,307077295,252077295,1249144.1774033697
Ocean's Twelve,12/9/2004,110000000,362744280,252744280,1328135.9957961114
Rocky III,5/28/1982,17000000,270000000,253000000,2608247.4226804124
A Beautiful Mind,12/11/2001,60000000,313542341,253542341,1434874.5953593662
The Silence of the Lambs,2/1/1991,19000000,272742922,253742922,1882365.8902077149
The Full Monty,8/13/1997,3500000,257850122,254350122,1581779.3656716417
Enchanted,11/20/2007,85000000,340487652,255487652,1216399.3410653411
Bridesmaids,4/28/2011,32500000,288383523,255883523,1132408.3615089129
The Mummy: Tomb of the Dragon Emperor,7/1/2008,145000000,401128639,256128639,1164411.6264479642
Minority Report,6/20/2002,102000000,358372926,256372926,1423503.1982232095
Rambo: First Blood Part II,5/21/1985,44000000,300400432,256400432,2382903.6431226768
Bridget Jones's Diary,4/13/2001,25000000,281929795,256929795,1452401.3284341434
Rush Hour 2,8/3/2001,90000000,347325802,257325802,1449722.828169014
American Pie 2,8/10/2001,30000000,287553595,257553595,1451006.1690140846
Liar Liar,3/21/1997,45000000,302710615,257710615,1608680.493133583
Pitch Perfect 2,5/7/2015,29000000,287506194,258506194,1087051.1301276255
The Hangover Part III,5/23/2013,103000000,362000072,259000072,1109189.0160339866
Scary Movie,7/7/2000,19000000,278019771,259019771,1498957.0081018517
Who Framed Roger Rabbit,6/21/1988,70000000,329803958,259803958,2192438.464135021
千と千尋の神隠し,7/20/2001,15000000,274925095,259925095,1464366.7323943663
The Rock,6/6/1996,75000000,335062621,260062621,1659621.0657306956
The Chronicles of Narnia: The Voyage of the Dawn Treader,8/13/2010,155000000,415686217,260686217,1194099.3486386456
Cinderella,3/4/1950,2900000,263591415,260691415,1.1046246398305085E7
xXx: Return of Xander Cage,1/13/2017,85000000,346147658,261147658,1075394.224156746
My Best Friend's Wedding,6/19/1997,38000000,299288605,261288605,1627966.386292835
Chicago,12/26/2002,45000000,306776732,261776732,1440708.4865162356
Planet of the Apes,7/25/2001,100000000,362211740,262211740,1477249.2394366197
Night at the Museum: Battle of the Smithsonian,5/20/2009,150000000,413106170,263106170,1219817.8429527152
Over the Hedge,4/22/2006,80000000,343397247,263397247,1300727.1456790124
True Lies,7/14/1994,115000000,378882411,263882411,1778183.3625336927
As Good as It Gets,12/19/1997,50000000,314178011,264178011,1634764.9195544554
Shakespeare in Love,12/11/1998,25000000,289317794,264317794,1612677.2056131787
Hannibal,2/8/2001,87000000,351692268,264692268,1505644.300341297
Ghostbusters,6/7/1984,30000000,295212467,265212467,2557497.270973963
Bambi,8/14/1942,858000,267447150,266589150,1.6156918181818182E7
101 Dalmatians,11/17/1996,54000000,320689294,266689294,1681521.3997477933
Alvin and the Chipmunks: Chipwrecked,12/14/2011,75000000,342695435,267695435,1186214.661101067
Split,11/15/2016,9000000,276921998,267921998,1110083.5622511425
Rocky IV,11/21/1985,31000000,300473716,269473716,2465450.283623056
Resident Evil: The Final Chapter,12/23/2016,40000000,312242626,272242626,1121082.7997150375
Prometheus,5/30/2012,130000000,403170142,273170142,1190397.955359555
Hotel Transylvania,9/20/2012,85000000,358375603,273375603,1181822.360656588
Live Free or Die Hard,6/20/2007,110000000,383531464,273531464,1313167.4371936496
Warcraft,5/25/2016,160000000,433677183,273677183,1135505.1614402244
The Matrix Revolutions,11/5/2003,150000000,424988211,274988211,1490451.0081300812
Meet the Parents,10/6/2000,55000000,330444045,275444045,1583011.7528735632
Jurassic Park III,7/18/2001,93000000,368780809,275780809,1553694.6985915492
Die Hard: With a Vengeance,5/19/1995,90000000,366101666,276101666,1810502.7278688524
Journey 2: The Mysterious Island,1/19/2012,79000000,355692760,276692760,1215361.125874648
The Angry Birds Movie,5/11/2016,73000000,349779543,276779543,1152148.7538973228
Star Trek Into Darkness,5/5/2013,190000000,467365246,277365246,1190689.8452424393
The Proposal,6/1/2009,40000000,317375031,277375031,1285971.4084369915
Taken 3,12/16/2014,48000000,325771424,277771424,1188545.5891351136
Austin Powers: The Spy Who Shagged Me,6/8/1999,33000000,310940086,277940086,1672323.0204572806
The Sound of Music,3/2/1965,8200000,286214286,278014286,8882245.559105432
Fast & Furious,4/2/2009,85000000,363164265,278164265,1304465.695929469
The Lorax,3/1/2012,70000000,348840316,278840316,1215562.5130780498
Beverly Hills Cop II,5/18/1987,20000000,299965036,279965036,2466652.299559471
The Conjuring 2,5/13/2016,40000000,320170008,280170008,1166262.2247938425
The Blind Side,11/20/2009,29000000,309208309,280208309,1297567.059815049
The Mummy,6/6/2017,125000000,407778013,282778013,1154408.0055520402
Close Encounters of the Third Kind,11/16/1977,20000000,303788635,283788635,4569865.297906602
Happy Feet,11/16/2006,100000000,384335608,284335608,1408997.0664023785
Terminator Genisys,6/23/2015,155000000,440603537,285603537,1196726.3779362591
Lethal Weapon 3,5/15/1992,35000000,321731527,286731527,2052480.5082319258
Look Who's Talking,10/12/1989,7500000,296000000,288500000,2296974.522292994
Pocahontas,6/14/1995,55000000,346079773,291079773,1908719.8229508197
The Devil Wears Prada,6/30/2006,35000000,326551094,291551094,1432683.5085995086
Oz: The Great and Powerful,3/7/2013,200000000,491868548,291868548,1253876.3000863502
Die Another Day,11/17/2002,140000000,431971116,291971116,1613991.796572692
Back to the Future Part II,11/20/1989,40000000,332000000,292000000,2315622.5218080888
The Wolf of Wall Street,12/25/2013,100000000,392000694,292000694,1248314.3265103712
Shark Tale,9/20/2004,75000000,367275019,292275019,1531037.291775799
GoldenEye,11/16/1995,58000000,352194034,294194034,1916573.5114006514
Se7en,9/22/1995,33000000,327311859,294311859,1914846.1873780093
The Fault in Our Stars,5/16/2014,12000000,307166834,295166834,1238412.0112610818
The Wolverine,7/23/2013,120000000,415440673,295440673,1263230.9846628783
Jason Bourne,7/27/2016,120000000,415484914,295484914,1226847.169803487
The Flintstones,5/26/1994,46000000,341631208,295631208,1997508.1621621621
X2,4/24/2003,110000000,407711549,297711549,1622406.2615803815
Tarzan,6/18/1999,150000000,448000000,298000000,1787642.471505699
Hitch,2/10/2005,70000000,368100420,298100420,1554225.3388946818
Thor,4/21/2011,150000000,449326618,299326618,1324665.0705422102
Schindler's List,11/29/1993,22000000,321365567,299365567,2053261.7764060355
दंगल,12/23/2016,10400000,310000000,299600000,1233739.2264010313
Catch Me If You Can,12/25/2002,52000000,352114312,300114312,1651702.3225096313
Beverly Hills Cop,11/29/1984,15000000,316360478,301360478,2861922.8679962014
Alvin and the Chipmunks,12/13/2007,60000000,361366633,301366633,1434833.2333504732
Men in Black II,7/3/2002,140000000,441818803,301818803,1675840.1054969463
Apollo 13,6/30/1995,52000000,355237933,303237933,1988445.462295082
Ice Age: Collision Course,6/23/2016,105000000,408579038,303579038,1261611.44172748
Basic Instinct,3/20/1992,49000000,352927224,303927224,2178689.777777778
What Women Want,12/15/2000,70000000,374111707,304111707,1747768.4310344828
Indiana Jones and the Temple of Doom,5/23/1984,28000000,333000000,305000000,2941176.470588235
The Conjuring,7/18/2013,13000000,318000141,305000141,1304104.8970185183
Fatal Attraction,9/11/1987,14000000,320145693,306145693,2662136.460869565
Wreck-It Ralph,11/1/2012,165000000,471222889,306222889,1330125.7878299546
Gone Girl,10/1/2014,61000000,369330363,308330363,1298599.4491077482
Pearl Harbor,5/21/2001,140000000,449220945,309220945,1737196.3202247191
The Maze Runner,9/10/2014,34000000,348319861,314319861,1320499.6870155567
Black Swan,12/2/2010,13000000,327803731,314803731,1436286.0082398404
The Last Samurai,12/5/2003,140000000,456758981,316758981,1718713.950081389
The Karate Kid,6/10/2010,40000000,357852395,317852395,1458272.635514876
Speed,6/9/1994,30000000,350448145,320448145,2165190.168918919
Notting Hill,5/13/1999,42000000,363889678,321889678,1936760.9987966307
Troy,5/13/2004,175000000,497409852,322409852,1704970.1322051825
Crocodile Dundee,9/26/1986,5000000,328203506,323203506,2930222.175883953
Fifty Shades Darker,2/8/2017,55000000,378827494,323827494,1329324.7373800816
Ice Age,3/10/2002,59000000,383257136,324257136,1813518.6577181206
The Fugitive,8/6/1993,44000000,368875760,324875760,2243617.127071823
Charlie and the Chocolate Factory,7/13/2005,150000000,474968763,324968763,1663095.0
Django Unchained,12/25/2012,100000000,425368238,325368238,1412924.4311273233
National Treasure: Book of Secrets,12/13/2007,130000000,457363168,327363168,1558605.039136148
The Mask,7/29/1994,23000000,351583407,328583407,2205257.765100671
How to Train Your Dragon,3/5/2010,165000000,494878759,329878759,1515771.002292872
Taken 2,9/27/2012,45000000,376141306,331141306,1431547.642412793
Tangled,11/24/2010,260000000,591794936,331794936,1513808.0564287638
World War Z,6/20/2013,200000000,531865000,331865000,1420679.2924536378
Kingsman: The Secret Service,1/29/2015,81000000,414351546,333351546,1420197.280186774
The Mummy Returns,4/28/2001,98000000,433013274,335013274,1885274.4738323018
The Mummy,4/16/1999,80000000,415885488,335885488,2020971.6486161253
Signs,8/2/2002,72000000,408247917,336247917,1860807.5096845601
Cast Away,12/22/2000,90000000,429632142,339632142,1939646.7275842377
Home Alone 2: Lost in New York,11/19/1992,18000000,358991681,340991681,2403042.1494009867
American Beauty,9/15/1999,15000000,356296601,341296601,2032737.3496128647
WALL·E,6/22/2008,180000000,521311860,341311860,1551671.4553290538
Top Gun,5/16/1986,15000000,356830601,341830601,3121740.6484018266
Cars,6/8/2006,120000000,461983149,341983149,1685476.338097585
Robin Hood: Prince of Thieves,6/14/1991,48000000,390493908,342493908,2518337.5588235296
King Kong,12/14/2005,207000000,550000000,343000000,1742886.1788617885
Toy Story,10/30/1995,30000000,373554033,343554033,2236679.90234375
Transformers: The Last Knight,6/21/2017,260000000,604942143,344942143,1409157.9706355755
There's Something About Mary,7/15/1998,23000000,369884651,346884651,2125518.694852941
Sex and the City,5/12/2008,65000000,415252786,350252786,1616810.0096015362
Teenage Mutant Ninja Turtles,8/7/2014,125000000,477200000,352200000,1480752.7369961152
Beauty and the Beast,11/13/1991,25000000,377350553,352350553,2556970.631349782
Brave,6/21/2012,185000000,538983207,353983207,1545076.5023744674
Gladiator,5/1/2000,103000000,457640427,354640427,2067874.2099125364
Twilight,11/20/2008,37000000,392616625,355616625,1691575.931845425
300,12/9/2006,65000000,422610419,357610419,1772103.1665014864
Cars 2,6/11/2011,200000000,559852396,359852396,1594228.2808055927
San Andreas,5/27/2015,110000000,470490832,360490832,1510617.8898582791
Back to the Future,7/3/1985,19000000,381109762,362109762,3359088.7012987016
Slumdog Millionaire,5/12/2008,15000000,377910544,362910544,1675239.779903246
My Big Fat Greek Wedding,2/22/2002,5000000,368744044,363744044,2034362.6621923936
Ocean's Eleven,12/7/2001,85000000,450717150,365717150,2069706.5647990946
X-Men: Apocalypse,5/18/2016,178000000,543934787,365934787,1518288.2066899568
Alvin and the Chipmunks: The Squeakquel,12/21/2009,75000000,443140005,368140005,1698948.2756233644
Mr. & Mrs. Smith,6/7/2005,110000000,478207520,368207520,1893097.7892030848
Godzilla,5/14/2014,160000000,529076069,369076069,1551391.6309373686
Raiders of the Lost Ark,6/12/1981,18000000,389925971,371925971,4105143.1677704197
The Bourne Ultimatum,8/3/2007,70000000,442824138,372824138,1793139.271921007
The Boss Baby,3/23/2017,125000000,498814908,373814908,1528745.2683581163
Kung Fu Panda 3,1/23/2016,145000000,521170825,376170825,1586475.6379923327
Batman,6/23/1989,35000000,411348924,376348924,3025312.893890675
Mission: Impossible,5/22/1996,80000000,457696359,377696359,2410314.9904275686
Les Misérables,12/18/2012,61000000,441809770,380809770,1653681.47472642
Kong: Skull Island,3/8/2017,185000000,566652812,381652812,1565427.5905349036
The Bodyguard,11/25/1992,25000000,411006740,386006740,2720273.009161381
Quantum of Solace,10/30/2008,200000000,586090727,386090727,1817539.0231846534
Rain Man,12/11/1988,25000000,412800000,387800000,3218257.261410788
Ant-Man,7/14/2015,130000000,519311965,389311965,1631281.9604951101
Rise of the Planet of the Apes,8/3/2011,93000000,482860185,389860185,1720895.1201747998
Hotel Transylvania 2,9/21/2015,80000000,473226958,393226958,1653339.4915867103
Rio,4/3/2011,90000000,484635760,394635760,1754669.7731496713
Gone with the Wind,12/15/1939,4000000,400176459,396176459,2.82983185E7
Rio 2,3/19/2014,103000000,500188435,397188435,1675391.5898967402
The Revenant,12/25/2015,135000000,532950503,397950503,1679711.3871583177
Men in Black 3,5/23/2012,225000000,624026776,399026776,1738845.4492369639
The King's Speech,9/6/2010,15000000,414211549,399211549,1827565.3569188653
The Matrix,3/30/1999,63000000,463517383,400517383,2409851.883273165
Dances with Wolves,11/9/1990,22000000,424208848,402208848,3006045.201793722
Twister,5/10/1996,92000000,494471524,402471524,2570060.817369093
Bruce Almighty,5/23/2003,80000000,484572835,404572835,2202356.205770278
Toy Story 2,10/30/1999,90000000,497366869,407366869,2420480.505050505
The Lego Movie,2/6/2014,60000000,469160692,409160692,1742733.4068770471
Saving Private Ryan,7/24/1998,70000000,481840909,411840909,2520446.199510404
Intouchables,11/2/2011,13000000,426480871,413480871,1827701.3260840739
Armageddon,7/1/1998,140000000,553799566,413799566,2535536.5563725494
La La Land,11/29/2016,30000000,445435700,415435700,1720715.149607343
Mrs. Doubtfire,11/24/1993,25000000,441286195,416286195,2855186.5226337444
The Day After Tomorrow,5/26/2004,125000000,544272402,419272402,2210186.6209804956
Dunkirk,7/19/2017,100000000,519876949,419876949,1710160.7166858776
Terminator 2: Judgment Day,7/1/1991,100000000,520000000,420000000,3083700.4405286345
Mission: Impossible II,5/24/2000,125000000,546388105,421388105,2444246.548723898
Iron Man 2,4/28/2010,200000000,623933331,423933331,1943061.77066432
The Hangover,6/5/2009,35000000,459270619,424270619,1967011.5349130477
Shrek,5/16/2001,60000000,484409218,424409218,2384321.449438202
Indiana Jones and the Last Crusade,5/24/1989,48000000,474171806,426171806,3434099.967767929
The Exorcist,12/26/1973,8000000,441306145,433306145,9298415.128755365
Sherlock Holmes,12/23/2009,90000000,524028679,434028679,2003021.311846119
I Am Legend,12/14/2007,150000000,585349010,435349010,2072735.1977756193
Meet the Fockers,12/22/2004,80000000,516642939,436642939,2289685.049816466
Man of Steel,6/12/2013,225000000,662845518,437845518,1875109.2829244896
Iron Man,4/30/2008,140000000,585174222,445174222,2054979.0520329406
Cinderella,3/12/2015,95000000,543514353,448514353,1899526.7344008742
Pretty Woman,3/23/1990,14000000,463000000,449000000,3483320.403413499
Casino Royale,11/14/2006,150000000,599045960,449045960,2228515.930521092
The Croods,3/20/2013,135000000,585178928,450178928,1935995.3210539669
The Simpsons Movie,7/25/2007,75000000,527068851,452068851,2174275.557073255
The Smurfs,7/29/2011,110000000,563749323,453749323,2002910.3401090293
Madagascar: Escape 2 Africa,10/30/2008,150000000,603900354,453900354,2136755.814993527
Madagascar,5/25/2005,75000000,532680671,457680671,2353113.9897172237
Home Alone,11/9/1990,18000000,476684675,458684675,3428136.5844544093
War of the Worlds,6/28/2005,132000000,591739379,459739379,2352811.5609007166
Jaws,6/18/1975,7000000,470654000,463654000,8554501.84501845
How to Train Your Dragon 2,6/12/2014,145000000,609123048,464123048,1947290.4511565266
Night at the Museum,10/20/2006,110000000,574480841,464480841,2305115.836228288
Ratatouille,6/22/2007,150000000,623722818,473722818,2274244.321864243
Hancock,7/1/2008,150000000,624029371,474029371,2155031.600625557
Despicable Me,7/8/2010,69000000,543513985,474513985,2176559.8295498854
Thor: The Dark World,10/29/2013,170000000,644571402,474571402,2036184.1428933064
Aladdin,11/25/1992,28000000,504050219,476050219,3354828.886539817
Ghost,7/12/1990,22000000,505000000,483000000,3703987.7300613495
American Sniper,12/11/2014,58800000,542307423,483507423,2059125.6963017222
Big Hero 6,10/24/2014,165000000,652105443,487105443,2062686.344753992
Life of Pi,11/20/2012,120000000,609016565,489016565,2129853.8116123187
Moana,11/23/2016,150000000,643034466,493034466,2042125.5922992812
The Hunger Games: Mockingjay - Part 2,11/18/2015,160000000,653428261,493428261,2086156.9009618433
X-Men: Days of Future Past,5/15/2014,250000000,747862775,497862775,2092739.7015552754
Ted,6/29/2012,50000000,549368315,499368315,2179657.775508066
Men in Black,7/2/1997,90000000,589390539,499390539,3111467.5327102803
Fast Five,4/20/2011,125000000,626137675,501137675,2217776.614859004
Kung Fu Panda,6/4/2008,130000000,631744560,501744560,2293008.0661746226
The Amazing Spider-Man 2,4/16/2014,200000000,705717432,505717432,2125756.3345943675
Interstellar,11/5/2014,165000000,675120017,510120017,2160143.3701318223
Doctor Strange,10/25/2016,165000000,677718395,512718395,2124350.6192174945
Pirates of the Caribbean: The Curse of the Black Pearl,7/9/2003,140000000,655011224,515011224,2800496.052202284
Kung Fu Panda 2,5/25/2011,150000000,665692281,515692281,2284634.554894959
Logan,2/28/2017,97000000,616801808,519801808,2132074.1424358394
The Empire Strikes Back,5/17/1980,18000000,538400000,520400000,6292623.9419588875
The Martian,9/30/2015,108000000,630161890,522161890,2195451.904237338
Star Wars: Episode II - Attack of the Clones,5/15/2002,120000000,649398328,529398328,2944373.3481646273
Fifty Shades of Grey,2/11/2015,40000000,571006128,531006128,2262276.7699661725
Mission: Impossible - Rogue Nation,7/23/2015,150000000,682330139,532330139,2233715.4828043436
The Amazing Spider-Man,6/27/2012,215000000,752215857,537215857,2344855.8602206856
The Incredibles,11/5/2004,92000000,631442092,539442092,2824304.1465968587
Return of the Jedi,5/23/1983,32350000,572700000,540350000,5430653.266331659
Dawn of the Planet of the Apes,6/26/2014,170000000,710644566,540644566,2269232.1762854145
Monsters University,6/20/2013,200000000,743559607,543559607,2326921.7238308876
Captain America: The Winter Soldier,3/20/2014,170000000,714766572,544766572,2297895.036107174
Mission: Impossible - Ghost Protocol,12/7/2011,145000000,694713380,549713380,2435895.3702718993
Sing,11/23/2016,75000000,632443719,557443719,2308905.6918718317
Mamma Mia!,7/3/2008,52000000,609841637,557841637,2536058.7959847976
Transformers,6/27/2007,150000000,709709780,559709780,2687049.7698020632
Up,5/13/2009,175000000,735099082,560099082,2619047.7798144547
Pirates of the Caribbean: Dead Men Tell No Tales,5/23/2017,230000000,794191988,564191988,2303247.486272989
Alice in Wonderland,7/3/1951,3000000,572000000,569000000,2.196911196911197E7
2012,10/10/2009,200000000,769653595,569653595,2635125.822821114
Suicide Squad,8/2/2016,175000000,745600054,570600054,2369119.4648929415
Maleficent,5/28/2014,180000000,758539785,578539785,2427341.205741306
Ice Age: The Meltdown,3/23/2006,80000000,660940780,580940780,2883080.794044665
The Passion of the Christ,2/25/2004,30000000,611899420,581899420,3105119.637139808
Spider-Man 2,6/25/2004,200000000,783766341,583766341,3082187.650475185
Shrek Forever After,5/16/2010,165000000,752600867,587600867,2695849.640997408
The Matrix Reloaded,5/15/2003,150000000,738599701,588599701,3207627.7983651226
Indiana Jones and the Kingdom of the Crystal Skull,5/21/2008,185000000,786636033,601636033,2749519.150880881
Madagascar 3: Europe's Most Wanted,6/6/2012,145000000,746921274,601921274,2623002.09170378
The Twilight Saga: Breaking Dawn - Part 1,3/15/2011,110000000,712171856,602171856,2694679.106982239
Guardians of the Galaxy,7/30/2014,170000000,773328629,603328629,2536571.6033499823
Gravity,9/27/2013,105000000,716392705,611392705,2617868.449898521
The Hunger Games,3/12/2012,75000000,691210692,616210692,2686278.039338774
Forrest Gump,7/6/1994,55000000,677945399,622945399,4197745.276280323
Batman v Superman: Dawn of Justice,3/23/2016,250000000,873260194,623260194,2604938.5148436227
The Hunger Games: Mockingjay - Part 1,11/18/2014,125000000,752100229,627100229,2670648.131270974
Fast & Furious 6,5/6/2013,160000000,788679850,628679850,2698833.8448990104
Fantastic Beasts and Where to Find Them,11/16/2016,180000000,809342332,629342332,2606706.368666954
The Twilight Saga: Eclipse,6/23/2010,68000000,698491347,630491347,2892016.214778153
The Sixth Sense,8/6/1999,40000000,672806292,632806292,3786991.5739078396
Spider-Man 3,5/1/2007,258000000,890871626,632871626,3043398.265920971
Spectre,10/26/2015,245000000,880674609,635674609,2678374.157312839
Shrek the Third,5/17/2007,160000000,798958165,638958165,3066724.413492551
The Da Vinci Code,5/17/2006,125000000,767820459,642820459,3168163.9181862986
Harry Potter and the Prisoner of Azkaban,5/31/2004,130000000,789804554,659804554,3478147.3589878757
The Twilight Saga: New Moon,3/15/2009,50000000,709827462,659827462,3102019.4820153355
Pirates of the Caribbean: At World's End,5/19/2007,300000000,961000000,661000000,3172515.742589464
Guardians of the Galaxy Vol. 2,4/19/2017,200000000,863416141,663416141,2710775.1753952266
Inception,7/14/2010,160000000,825532764,665532764,3052748.549385123
Pirates of the Caribbean: On Stranger Tides,5/14/2011,380000000,1045713802,665713802,2946105.5831902428
Wonder Woman,5/30/2017,149000000,820580447,671580447,2741648.249678512
Inside Out,6/9/2015,175000000,857611174,682611174,2860446.257511377
Spider-Man,5/1/2002,139000000,821708551,682708551,3797044.2213570634
Harry Potter and the Half-Blood Prince,7/7/2009,250000000,933959197,683959197,3176020.529275462
Transformers: Revenge of the Fallen,6/19/2009,150000000,836297228,686297228,3186877.3676463077
Harry Potter and the Deathly Hallows: Part 1,10/17/2010,250000000,954305868,704305868,3218904.073527328
The Hobbit: The Battle of the Five Armies,12/10/2014,250000000,956019788,706019788,3006744.919339727
The Hobbit: The Desolation of Smaug,12/11/2013,250000000,958400000,708400000,3039704.0965633835
The Twilight Saga: Breaking Dawn - Part 2,11/13/2012,120000000,829000000,709000000,3079649.5541240806
The Hunger Games: Catching Fire,11/15/2013,130000000,847423452,717423452,3078159.0516113257
Deadpool,2/9/2016,58000000,783112979,725112979,3058116.152350587
Star Wars: Episode III - Revenge of the Sith,5/17/2005,113000000,850000000,737000000,3789203.084832905
Independence Day,6/25/1996,75000000,816969268,741969268,4725918.904458599
The Lion King,6/23/1994,45000000,788241776,743241776,5008367.762803234
Harry Potter and the Goblet of Fire,11/5/2005,150000000,895921036,745921036,3774904.028340081
Star Wars,5/25/1977,11000000,775398007,764398007,1.2593047891268533E7
Shrek 2,5/19/2004,150000000,919838758,769838758,4058190.6062203483
The Hobbit: An Unexpected Journey,11/26/2012,250000000,1021103568,771103568,3358450.390024434
Harry Potter and the Chamber of Secrets,11/13/2002,100000000,876688482,776688482,4283996.0397131825
The Lord of the Rings: The Fellowship of the Ring,12/18/2001,93000000,871368364,778368364,4395078.283455675
Ice Age: Continental Drift,6/26/2012,95000000,877244782,782244782,3414365.4497520775
E.T. the Extra-Terrestrial,4/3/1982,10500000,792965326,782465326,8245156.227608008
Harry Potter and the Order of the Phoenix,6/28/2007,150000000,938212738,788212738,3784044.75297529
The Jungle Book,4/7/2016,175000000,966550600,791550600,3308314.351273296
Ice Age: Dawn of the Dinosaurs,6/29/2009,90000000,886686817,796686817,3699480.462129268
The Secret Life of Pets,6/18/2016,75000000,875457937,800457937,3326536.9657728947
Star Wars: Episode I - The Phantom Menace,5/19/1999,115000000,924317558,809317558,4869540.060168472
The Dark Knight,7/16/2008,185000000,1004558444,819558444,3740807.007293939
Alice in Wonderland,3/3/2010,200000000,1025491110,825491110,3793076.859454765
Finding Dory,6/16/2016,200000000,1028570889,828570889,3443368.5564439716
The Dark Knight Rises,7/16/2012,250000000,1084939099,834939099,3624197.947729611
Finding Nemo,5/30/2003,94000000,940335536,846335536,4607161.328252586
The Lord of the Rings: The Two Towers,12/18/2002,79000000,926287400,847287400,4663111.722619703
Harry Potter and the Philosopher's Stone,11/16/2001,125000000,976475550,851475550,4818763.723825693
Rogue One: A Star Wars Story,12/14/2016,200000000,1056057273,856057273,3545749.001789324
Jurassic Park,6/11/1993,63000000,920100000,857100000,5935595.567867036
Pirates of the Caribbean: Dead Man's Chest,6/20/2006,200000000,1065659812,865659812,4253856.57002457
Toy Story 3,6/16/2010,200000000,1066969703,866969703,3976724.5827045427
Zootopia,2/11/2016,150000000,1023784195,873784195,3685127.1978103085
Transformers: Age of Extinction,6/25/2014,210000000,1091405097,881405097,3699496.73452256
Despicable Me 2,6/25/2013,76000000,970761885,894761885,3830381.8772581723
Captain America: Civil War,4/27/2016,250000000,1153304495,903304495,3760180.889900886
Skyfall,10/25/2012,200000000,1108561013,908561013,3946473.2278984105
Transformers: Dark of the Moon,6/28/2011,195000000,1123746996,928746996,4110918.7949823393
Despicable Me 3,6/15/2017,80000000,1020063384,940063384,3837698.28744055
The Fate of the Furious,4/12/2017,250000000,1238764765,988764765,4043630.7479020464
Iron Man 3,4/18/2013,200000000,1215439994,1015439994,4359140.5439052135
The Lord of the Rings: The Return of the King,12/1/2003,94000000,1118888979,1024888979,5560981.98046663
Minions,6/17/2015,74000000,1156730962,1082730962,4536823.024126979
Beauty and the Beast,3/16/2017,160000000,1262886337,1102886337,4510339.831672965
Frozen,11/27/2013,150000000,1274219009,1124219009,4823959.806735923
Avengers: Age of Ultron,4/22/2015,280000000,1405403694,1125403694,4732464.388890057
Harry Potter and the Deathly Hallows: Part 2,7/7/2011,125000000,1342000000,1217000000,5386814.918423173
The Avengers,4/25/2012,220000000,1519557910,1299557910,5654800.208863651
Furious 7,4/1/2015,190000000,1506249360,1316249360,5563207.621333987
Jurassic World,6/9/2015,150000000,1513528810,1363528810,5713795.83301905
Titanic,11/18/1997,200000000,1845034188,1645034188,1.0198600049597023E7
Star Wars: The Force Awakens,12/15/2015,245000000,2068223624,1823223624,7708375.960257901
