Star Wars: The Force Awakens,12/15/2015,245000000,2068223624,1823223624,8744207.267730683
Titanic,11/18/1997,200000000,1845034188,1645034188,1.1438525654060755E7
The Avengers,4/25/2012,220000000,1519557910,1299557910,6612091.943519788
Jurassic World,6/9/2015,150000000,1513528810,1363528810,6342362.951415952
Furious 7,4/1/2015,190000000,1506249360,1316249360,6366254.126179739
Avengers: Age of Ultron,4/22/2015,280000000,1405403694,1125403694,5909899.682512983
Harry Potter and the Deathly Hallows: Part 2,7/7/2011,125000000,1342000000,1217000000,5940103.221465816
Frozen,11/27/2013,150000000,1274219009,1124219009,5467601.272693725
Beauty and the Beast,3/16/2017,160000000,1262886337,1102886337,5164672.330732361
The Fate of the Furious,4/12/2017,250000000,1238764765,988764765,5066025.277682355
Iron Man 3,4/18/2013,200000000,1215439994,1015439994,5217712.309772694
Minions,6/17/2015,74000000,1156730962,1082730962,4846895.346401066
Captain America: Civil War,4/27/2016,250000000,1153304495,903304495,4800854.580421181
Transformers: Dark of the Moon,6/28/2011,195000000,1123746996,928746996,4974048.547728863
The Lord of the Rings: The Return of the King,12/1/2003,94000000,1118888979,1024888979,6071019.962018448
Skyfall,10/25/2012,200000000,1108561013,908561013,4815203.708610422
Transformers: Age of Extinction,6/25/2014,210000000,1091405097,881405097,4580923.806925499
The Dark Knight Rises,7/16/2012,250000000,1084939099,834939099,4709366.300747898
Toy Story 3,6/16/2010,200000000,1066969703,866969703,4894109.4853012
Pirates of the Caribbean: Dead Man's Chest,6/20/2006,200000000,1065659812,865659812,5236657.552825552
Rogue One: A Star Wars Story,12/14/2016,200000000,1056057273,856057273,4374139.604526326
Pirates of the Caribbean: On Stranger Tides,5/14/2011,380000000,1045713802,665713802,4627789.391230461
Finding Dory,6/16/2016,200000000,1028570889,828570889,4274527.025117609
Alice in Wonderland,3/3/2010,200000000,1025491110,825491110,4712063.584691519
Zootopia,2/11/2016,150000000,1023784195,873784195,4317742.302128539
The Hobbit: An Unexpected Journey,11/26/2012,250000000,1021103568,771103568,4447295.821882308
Despicable Me 3,6/15/2017,80000000,1020063384,940063384,4164288.8857137025
The Dark Knight,7/16/2008,185000000,1004558444,819558444,4585224.268095633
Harry Potter and the Philosopher's Stone,11/16/2001,125000000,976475550,851475550,5526177.419354839
Despicable Me 2,6/25/2013,76000000,970761885,894761885,4155729.914039624
The Jungle Book,4/7/2016,175000000,966550600,791550600,4039733.17841186
Pirates of the Caribbean: At World's End,5/19/2007,300000000,961000000,661000000,4612386.7301489785
The Hobbit: The Desolation of Smaug,12/11/2013,250000000,958400000,708400000,4112439.8731597215
The Hobbit: The Battle of the Five Armies,12/10/2014,250000000,956019788,706019788,4071426.4517997373
Harry Potter and the Deathly Hallows: Part 1,10/17/2010,250000000,954305868,704305868,4361484.385497456
Finding Nemo,5/30/2003,94000000,940335536,846335536,5118865.1932498645
Harry Potter and the Order of the Phoenix,6/28/2007,150000000,938212738,788212738,4504163.428533022
Harry Potter and the Half-Blood Prince,7/7/2009,250000000,933959197,683959197,4336915.997603912
The Lord of the Rings: The Two Towers,12/18/2002,79000000,926287400,847287400,5097894.331315355
Star Wars: Episode I - The Phantom Menace,5/19/1999,115000000,924317558,809317558,5561477.484957882
Jurassic Park,6/11/1993,63000000,920100000,857100000,6371883.656509695
Shrek 2,5/19/2004,150000000,919838758,769838758,4848912.799156563
Harry Potter and the Goblet of Fire,11/5/2005,150000000,895921036,745921036,4534013.340080972
Spider-Man 3,5/1/2007,258000000,890871626,632871626,4284087.088661162
Ice Age: Dawn of the Dinosaurs,6/29/2009,90000000,886686817,796686817,4117402.83072751
Spectre,10/26/2015,245000000,880674609,635674609,3710665.929315401
Ice Age: Continental Drift,6/26/2012,95000000,877244782,782244782,3829024.2946434803
Harry Potter and the Chamber of Secrets,11/13/2002,100000000,876688482,776688482,4835568.019856591
The Secret Life of Pets,6/18/2016,75000000,875457937,800457937,3638221.3915255084
Batman v Superman: Dawn of Justice,3/23/2016,250000000,873260194,623260194,3649822.553613
The Lord of the Rings: The Fellowship of the Ring,12/18/2001,93000000,871368364,778368364,4920205.330321852
Guardians of the Galaxy Vol. 2,4/19/2017,200000000,863416141,663416141,3527992.305900716
Inside Out,6/9/2015,175000000,857611174,682611174,3593774.562307763
Star Wars: Episode III - Revenge of the Sith,5/17/2005,113000000,850000000,737000000,4370179.948586118
The Hunger Games: Catching Fire,11/15/2013,130000000,847423452,717423452,3635933.787848234
Transformers: Revenge of the Fallen,6/19/2009,150000000,836297228,686297228,3883414.6486433777
The Twilight Saga: Breaking Dawn - Part 2,11/13/2012,120000000,829000000,709000000,3600887.8425512877
Inception,7/14/2010,160000000,825532764,665532764,3786656.471462449
Spider-Man,5/1/2002,139000000,821708551,682708551,4570125.42269188
Wonder Woman,5/30/2017,149000000,820580447,671580447,3349923.238962258
Independence Day,6/25/1996,75000000,816969268,741969268,5203625.910828025
Fantastic Beasts and Where to Find Them,11/16/2016,180000000,809342332,629342332,3352257.9111302565
Shrek the Third,5/17/2007,160000000,798958165,638958165,3834655.6068576253
Pirates of the Caribbean: Dead Men Tell No Tales,5/23/2017,230000000,794191988,564191988,3242195.4563083015
E.T. the Extra-Terrestrial,4/3/1982,10500000,792965326,782465326,8355799.009483666
Harry Potter and the Prisoner of Azkaban,5/31/2004,130000000,789804554,659804554,4163439.926199262
Fast & Furious 6,5/6/2013,160000000,788679850,628679850,3385691.2575929943
The Lion King,6/23/1994,45000000,788241776,743241776,5311602.264150944
Indiana Jones and the Kingdom of the Crystal Skull,5/21/2008,185000000,786636033,601636033,3594982.213285195
Spider-Man 2,6/25/2004,200000000,783766341,583766341,4138153.8595564943
Deadpool,2/9/2016,58000000,783112979,725112979,3302727.3260203027
Star Wars,5/25/1977,11000000,775398007,764398007,1.2774267001647446E7
Guardians of the Galaxy,7/30/2014,170000000,773328629,603328629,3251301.7716899584
2012,10/10/2009,200000000,769653595,569653595,3560293.6251312583
The Da Vinci Code,5/17/2006,125000000,767820459,642820459,3784230.946278955
Maleficent,5/28/2014,180000000,758539785,578539785,3182555.3299236814
Shrek Forever After,5/16/2010,165000000,752600867,587600867,3452851.9120042208
The Amazing Spider-Man,6/27/2012,215000000,752215857,537215857,3283294.298659124
The Hunger Games: Mockingjay - Part 1,11/18/2014,125000000,752100229,627100229,3202988.8975009792
X-Men: Days of Future Past,5/15/2014,250000000,747862775,497862775,3143601.408154687
Madagascar 3: Europe's Most Wanted,6/6/2012,145000000,746921274,601921274,3254870.941876781
Suicide Squad,8/2/2016,175000000,745600054,570600054,3095715.7970346566
Monsters University,6/20/2013,200000000,743559607,543559607,3183100.7679926027
The Matrix Reloaded,5/15/2003,150000000,738599701,588599701,4025066.4904632154
Up,5/13/2009,175000000,735099082,560099082,3437355.4260811014
Gravity,9/27/2013,105000000,716392705,611392705,3067458.6805169005
Captain America: The Winter Soldier,3/20/2014,170000000,714766572,544766572,3014976.7665519337
The Twilight Saga: Breaking Dawn - Part 1,3/15/2011,110000000,712171856,602171856,3186921.809484174
Dawn of the Planet of the Apes,6/26/2014,170000000,710644566,540644566,2982768.3777544596
The Twilight Saga: New Moon,3/15/2009,50000000,709827462,659827462,3337082.4083607183
Transformers,6/27/2007,150000000,709709780,559709780,3407168.4453597954
The Amazing Spider-Man 2,4/16/2014,200000000,705717432,505717432,2966445.6998738963
The Twilight Saga: Eclipse,6/23/2010,68000000,698491347,630491347,3203927.081661017
Mission: Impossible - Ghost Protocol,12/7/2011,145000000,694713380,549713380,3078420.805416711
The Hunger Games,3/12/2012,75000000,691210692,616210692,3013229.284369115
Mission: Impossible - Rogue Nation,7/23/2015,150000000,682330139,532330139,2863131.8879135265
Forrest Gump,7/6/1994,55000000,677945399,622945399,4568365.2223719675
Doctor Strange,10/25/2016,165000000,677718395,512718395,2807996.5651970347
Interstellar,11/5/2014,165000000,675120017,510120017,2858848.859416221
The Sixth Sense,8/6/1999,40000000,672806292,632806292,4026369.192100539
Kung Fu Panda 2,5/25/2011,150000000,665692281,515692281,2949168.804990209
Man of Steel,6/12/2013,225000000,662845518,437845518,2838690.20659175
Ice Age: The Meltdown,3/23/2006,80000000,660940780,580940780,3280103.1265508686
Pirates of the Caribbean: The Curse of the Black Pearl,7/9/2003,140000000,655011224,515011224,3561779.3583469274
The Hunger Games: Mockingjay - Part 2,11/18/2015,160000000,653428261,493428261,2762618.1629848853
Big Hero 6,10/24/2014,165000000,652105443,487105443,2761391.834038391
Star Wars: Episode II - Attack of the Clones,5/15/2002,120000000,649398328,529398328,3611781.579532814
Thor: The Dark World,10/29/2013,170000000,644571402,474571402,2765581.8748954176
Moana,11/23/2016,150000000,643034466,493034466,2663418.544352033
Sing,11/23/2016,75000000,632443719,557443719,2619552.1678982074
Kung Fu Panda,6/4/2008,130000000,631744560,501744560,2887117.245161438
The Incredibles,11/5/2004,92000000,631442092,539442092,3305979.5392670156
The Martian,9/30/2015,108000000,630161890,522161890,2649542.50372102
Fast Five,4/20/2011,125000000,626137675,501137675,2770962.0780301285
Hancock,7/1/2008,150000000,624029371,474029371,2836961.37095161
Men in Black 3,5/23/2012,225000000,624026776,399026776,2719331.5960571384
Iron Man 2,4/28/2010,200000000,623933331,423933331,2859744.4792783875
Ratatouille,6/22/2007,150000000,623722818,473722818,2994362.9974219752
Logan,2/28/2017,97000000,616801808,519801808,2529939.614685748
The Passion of the Christ,2/25/2004,30000000,611899420,581899420,3265205.0160085377
Mamma Mia!,7/3/2008,52000000,609841637,557841637,2772461.116364496
How to Train Your Dragon 2,6/12/2014,145000000,609123048,464123048,2555657.3845256628
Life of Pi,11/20/2012,120000000,609016565,489016565,2652499.618904099
Transformers: The Last Knight,6/21/2017,260000000,604942143,344942143,2471310.217904619
Madagascar: Escape 2 Africa,10/30/2008,150000000,603900354,453900354,2842887.3908438273
Casino Royale,11/14/2006,150000000,599045960,449045960,2972932.8039702233
Tangled,11/24/2010,260000000,591794936,331794936,2700053.08902769
War of the Worlds,6/28/2005,132000000,591739379,459739379,3028348.9201637665
Men in Black,7/2/1997,90000000,589390539,499390539,3672215.196261682
Quantum of Solace,10/30/2008,200000000,586090727,386090727,2759047.7909850534
I Am Legend,12/14/2007,150000000,585349010,435349010,2786898.4840693977
The Croods,3/20/2013,135000000,585178928,450178928,2516563.073310655
Iron Man,4/30/2008,140000000,585174222,445174222,2701236.299346357
Night at the Museum,10/20/2006,110000000,574480841,464480841,2851021.5434243176
Return of the Jedi,5/23/1983,32350000,572700000,540350000,5755778.894472362
Alice in Wonderland,7/3/1951,3000000,572000000,569000000,2.2084942084942088E7
Fifty Shades of Grey,2/11/2015,40000000,571006128,531006128,2432691.132488646
Kong: Skull Island,3/8/2017,185000000,566652812,381652812,2324243.1819393686
The Smurfs,7/29/2011,110000000,563749323,453749323,2488465.0864066742
Cars 2,6/11/2011,200000000,559852396,359852396,2480273.947599259
Armageddon,7/1/1998,140000000,553799566,413799566,3393379.693627451
King Kong,12/14/2005,207000000,550000000,343000000,2794715.447154471
Ted,6/29/2012,50000000,549368315,499368315,2397899.272819331
Mission: Impossible II,5/24/2000,125000000,546388105,421388105,3169304.553364269
The Day After Tomorrow,5/26/2004,125000000,544272402,419272402,2869121.781760675
X-Men: Apocalypse,5/18/2016,178000000,543934787,365934787,2256822.2580886073
Cinderella,3/12/2015,95000000,543514353,448514353,2301866.2327046953
Despicable Me,7/8/2010,69000000,543513985,474513985,2493057.620945732
American Sniper,12/11/2014,58800000,542307423,483507423,2309538.7927363166
Brave,6/21/2012,185000000,538983207,353983207,2352570.042426147
The Empire Strikes Back,5/17/1980,18000000,538400000,520400000,6510278.113663845
The Revenant,12/25/2015,135000000,532950503,397950503,2249533.6026270916
Madagascar,5/25/2005,75000000,532680671,457680671,2738718.1028277637
World War Z,6/20/2013,200000000,531865000,331865000,2276858.336615353
Godzilla,5/14/2014,160000000,529076069,369076069,2223943.123160992
The Simpsons Movie,7/25/2007,75000000,527068851,452068851,2534996.4216490234
Sherlock Holmes,12/23/2009,90000000,524028679,434028679,2418366.9486402045
WALL·E,6/22/2008,180000000,521311860,341311860,2369987.179720318
Kung Fu Panda 3,1/23/2016,145000000,521170825,376170825,2198003.5721666226
Terminator 2: Judgment Day,7/1/1991,100000000,520000000,420000000,3817914.8311306904
Dunkirk,7/19/2017,100000000,519876949,419876949,2117461.170011282
Ant-Man,7/14/2015,130000000,519311965,389311965,2176003.607733371
Meet the Fockers,12/22/2004,80000000,516642939,436642939,2709192.128998427
Ghost,7/12/1990,22000000,505000000,483000000,3872699.3865030673
Aladdin,11/25/1992,28000000,504050219,476050219,3552150.9443269907
Rio 2,3/19/2014,103000000,500188435,397188435,2109858.7559897415
The Boss Baby,3/23/2017,125000000,498814908,373814908,2039942.5332482702
Troy,5/13/2004,175000000,497409852,322409852,2630406.4093072447
Toy Story 2,10/30/1999,90000000,497366869,407366869,2955239.863339275
How to Train Your Dragon,3/5/2010,165000000,494878759,329878759,2273935.050613194
Twister,5/10/1996,92000000,494471524,402471524,3157544.853128991
Oz: The Great and Powerful,3/7/2013,200000000,491868548,291868548,2113082.4794971924
Rio,4/3/2011,90000000,484635760,394635760,2154836.9541052706
Bruce Almighty,5/23/2003,80000000,484572835,404572835,2637848.8568317913
Shrek,5/16/2001,60000000,484409218,424409218,2721400.1011235956
Rise of the Planet of the Apes,8/3/2011,93000000,482860185,389860185,2131409.5874991724
Saving Private Ryan,7/24/1998,70000000,481840909,411840909,2948842.7723378213
Mr. & Mrs. Smith,6/7/2005,110000000,478207520,368207520,2458650.4884318765
Teenage Mutant Ninja Turtles,8/7/2014,125000000,477200000,352200000,2006289.6254813918
Home Alone,11/9/1990,18000000,476684675,458684675,3562665.732436472
Charlie and the Chocolate Factory,7/13/2005,150000000,474968763,324968763,2430751.090071648
Indiana Jones and the Last Crusade,5/24/1989,48000000,474171806,426171806,3820884.8186946013
Hotel Transylvania 2,9/21/2015,80000000,473226958,393226958,1989702.89861166
Wreck-It Ralph,11/1/2012,165000000,471222889,306222889,2046828.4344173642
Jaws,6/18/1975,7000000,470654000,463654000,8683653.136531364
San Andreas,5/27/2015,110000000,470490832,360490832,1971567.1100160074
The Lego Movie,2/6/2014,60000000,469160692,409160692,1998290.713473407
Star Trek Into Darkness,5/5/2013,190000000,467365246,277365246,2006333.0228165446
The Matrix,3/30/1999,63000000,463517383,400517383,2788913.25511432
Pretty Woman,3/23/1990,14000000,463000000,449000000,3591931.7300232737
Cars,6/8/2006,120000000,461983149,341983149,2276900.685066535
X-Men: The Last Stand,5/24/2006,210000000,459359555,249359555,2263970.2069985215
The Hangover,6/5/2009,35000000,459270619,424270619,2129279.202384871
Mission: Impossible,5/22/1996,80000000,457696359,377696359,2920844.6649649013
Gladiator,5/1/2000,103000000,457640427,354640427,2668457.300291545
National Treasure: Book of Secrets,12/13/2007,130000000,457363168,327363168,2177546.5539240893
The Last Samurai,12/5/2003,140000000,456758981,316758981,2478344.98643516
Ocean's Eleven,12/7/2001,85000000,450717150,365717150,2550747.8777589137
Thor,4/21/2011,150000000,449326618,299326618,1988487.6263475597
Pearl Harbor,5/21/2001,140000000,449220945,309220945,2523713.1741573033
Tarzan,6/18/1999,150000000,448000000,298000000,2687462.5074985004
La La Land,11/29/2016,30000000,445435700,415435700,1844973.7400178933
Alvin and the Chipmunks: The Squeakquel,12/21/2009,75000000,443140005,368140005,2045069.6396184356
The Bourne Ultimatum,8/3/2007,70000000,442824138,372824138,2129812.0788583905
Men in Black II,7/3/2002,140000000,441818803,301818803,2453186.024430872
Les Misérables,12/18/2012,61000000,441809770,380809770,1918576.385270106
The Exorcist,12/26/1973,8000000,441306145,433306145,9470088.948497854
Mrs. Doubtfire,11/24/1993,25000000,441286195,416286195,3026654.286694101
Terminator Genisys,6/23/2015,155000000,440603537,285603537,1846202.1881049552
Terminator 3: Rise of the Machines,7/2/2003,200000000,435000000,235000000,2365415.986949429
Warcraft,5/25/2016,160000000,433677183,273677183,1799355.9941581127
The Mummy Returns,4/28/2001,98000000,433013274,335013274,2436765.751266179
Die Another Day,11/17/2002,140000000,431971116,291971116,2387900.033167496
Cast Away,12/22/2000,90000000,429632142,339632142,2453638.7321530553
Intouchables,11/2/2011,13000000,426480871,413480871,1885164.9692790525
Django Unchained,12/25/2012,100000000,425368238,325368238,1847178.382838284
The Matrix Revolutions,11/5/2003,150000000,424988211,274988211,2303459.138211382
Dances with Wolves,11/9/1990,22000000,424208848,402208848,3170469.7159940205
300,12/9/2006,65000000,422610419,357610419,2094204.2566897918
The Chronicles of Narnia: Prince Caspian,5/15/2008,225000000,419651413,194651413,1937162.62140404
The Mummy,4/16/1999,80000000,415885488,335885488,2502319.422382672
The Chronicles of Narnia: The Voyage of the Dawn Treader,8/13/2010,155000000,415686217,260686217,1904092.386126278
Jason Bourne,7/27/2016,120000000,415484914,295484914,1725084.6547006632
The Wolverine,7/23/2013,120000000,415440673,295440673,1776321.1987497702
Sex and the City,5/12/2008,65000000,415252786,350252786,1916858.0172827651
Kingsman: The Secret Service,1/29/2015,81000000,414351546,333351546,1765286.3642947827
The King's Speech,9/6/2010,15000000,414211549,399211549,1896234.413268693
Night at the Museum: Battle of the Smithsonian,5/20/2009,150000000,413106170,263106170,1915250.703546244
Rain Man,12/11/1988,25000000,412800000,387800000,3425726.141078838
Batman,6/23/1989,35000000,411348924,376348924,3306663.3762057875
The Bodyguard,11/25/1992,25000000,411006740,386006740,2896453.4178999295
Ice Age: Collision Course,6/23/2016,105000000,408579038,303579038,1697969.6377811395
Signs,8/2/2002,72000000,408247917,336247917,2259257.9800774767
The Mummy,6/6/2017,125000000,407778013,282778013,1664705.8153538404
X2,4/24/2003,110000000,407711549,297711549,2221861.302452316
Pacific Rim,7/11/2013,180000000,407602906,227602906,1744905.332283087
Prometheus,5/30/2012,130000000,403170142,273170142,1756901.0624112114
The Mummy: Tomb of the Dragon Emperor,7/1/2008,145000000,401128639,256128639,1823610.4044298157
Gone with the Wind,12/15/1939,4000000,400176459,396176459,2.8584032785714287E7
TRON: Legacy,12/10/2010,170000000,400062763,230062763,1825278.71283289
Mission: Impossible III,5/3/2006,150000000,397850012,247850012,1964691.4172839506
Snow White and the Huntsman,5/30/2012,170000000,396600000,226600000,1728270.2481283608
Twilight,11/20/2008,37000000,392616625,355616625,1867575.3229826663
The Wolf of Wall Street,12/25/2013,100000000,392000694,292000694,1675818.2167957728
Superman Returns,6/28/2006,270000000,391081192,121081192,1921774.8992628993
Robin Hood: Prince of Thieves,6/14/1991,48000000,390493908,342493908,2871278.7352941176
Raiders of the Lost Ark,6/12/1981,18000000,389925971,371925971,4303818.664459161
Independence Day: Resurgence,6/22/2016,165000000,389681935,224681935,1619437.2018218995
Star Trek,5/6/2009,150000000,385680446,235680446,1803458.6170133175
Happy Feet,11/16/2006,100000000,384335608,284335608,1904537.2051536173
Live Free or Die Hard,6/20/2007,110000000,383531464,273531464,1841254.4659359863
Ice Age,3/10/2002,59000000,383257136,324257136,2143496.2863534675
Monsters vs Aliens,3/19/2009,175000000,381509870,206509870,1789110.2513599698
Back to the Future,7/3/1985,19000000,381109762,362109762,3535341.0204081633
Godzilla,5/20/1998,130000000,379014294,249014294,2325241.0674846624
True Lies,7/14/1994,115000000,378882411,263882411,2553115.9770889487
Mad Max: Fury Road,5/13/2015,150000000,378858340,228858340,1593147.0742835517
Fifty Shades Darker,2/8/2017,55000000,378827494,323827494,1555101.9240321342
Slumdog Millionaire,5/12/2008,15000000,377910544,362910544,1744481.6278296835
Beauty and the Beast,11/13/1991,25000000,377350553,352350553,2738392.982583454
Taken 2,9/27/2012,45000000,376141306,331141306,1626085.8734982728
Batman Begins,6/10/2005,150000000,374218673,224218673,1924003.4601542416
What Women Want,12/15/2000,70000000,374111707,304111707,2150067.2816091953
Toy Story,10/30/1995,30000000,373554033,343554033,2431992.40234375
Penguins of Madagascar,11/22/2014,132000000,373552094,241552094,1590856.0635742636
X-Men Origins: Wolverine,4/28/2009,150000000,373062864,223062864,1744458.2522819093
The Golden Compass,12/4/2007,180000000,372234864,192234864,1772243.1583157172
The Adventures of Tintin,10/25/2011,130000000,371940071,241940071,1644079.348450692
G.I. Joe: Retaliation,3/26/2013,130000000,371876278,241876278,1599254.628415136
Terminator Salvation,5/20/2009,200000000,371353001,171353001,1721673.865169477
Captain America: The First Avenger,7/22/2011,140000000,370569774,230569774,1635744.6600013243
Edge of Tomorrow,5/27/2014,178000000,370541256,192541256,1554655.5006859861
War for the Planet of the Apes,7/11/2017,152000000,369907963,217907963,1511148.3622429387
There's Something About Mary,7/15/1998,23000000,369884651,346884651,2266450.067401961
Gone Girl,10/1/2014,61000000,369330363,308330363,1555514.0313267321
The Fugitive,8/6/1993,44000000,368875760,324875760,2547484.5303867403
Home,3/18/2015,135000000,368871007,233871007,1559055.6468962254
Jurassic Park III,7/18/2001,93000000,368780809,275780809,2077638.3605633802
My Big Fat Greek Wedding,2/22/2002,5000000,368744044,363744044,2062326.8680089484
Hitch,2/10/2005,70000000,368100420,298100420,1919188.8425443168
Shark Tale,9/20/2004,75000000,367275019,292275019,1923913.1430068098
Die Hard: With a Vengeance,5/19/1995,90000000,366101666,276101666,2400666.662295082
Notting Hill,5/13/1999,42000000,363889678,321889678,2189468.5800240673
A Bug's Life,11/25/1998,120000000,363258859,243258859,2216344.47223917
Fast & Furious,4/2/2009,85000000,363164265,278164265,1703077.5886325266
Ocean's Twelve,12/9/2004,110000000,362744280,252744280,1906170.6778770362
Noah,3/20/2014,125000000,362637473,237637473,1529651.2156644394
Planet of the Apes,7/25/2001,100000000,362211740,262211740,2040629.5211267606
The Hangover Part III,5/23/2013,103000000,362000072,259000072,1550294.9499794436
The World Is Not Enough,11/8/1999,135000000,361832400,226832400,2149925.1336898394
Alvin and the Chipmunks,12/13/2007,60000000,361366633,301366633,1720498.5478679845
Home Alone 2: Lost in New York,11/19/1992,18000000,358991681,340991681,2529892.043692741
Hotel Transylvania,9/20/2012,85000000,358375603,273375603,1549283.4638180505
Minority Report,6/20/2002,102000000,358372926,256372926,1989855.2248750695
The Karate Kid,6/10/2010,40000000,357852395,317852395,1641788.337577134
Top Gun,5/16/1986,15000000,356830601,341830601,3258726.9497716897
The Legend of Tarzan,6/29/2016,180000000,356743061,176743061,1482550.0814535301
Angels & Demons,5/13/2009,150000000,356613439,206613439,1667540.022257968
American Beauty,9/15/1999,15000000,356296601,341296601,2122076.2418106017
Journey 2: The Mysterious Island,1/19/2012,79000000,355692760,276692760,1562365.2503920267
Apollo 13,6/30/1995,52000000,355237933,303237933,2329429.068852459
Dinosaur,5/19/2000,127500000,354248063,226748063,2054803.149651972
X-Men: First Class,5/24/2011,160000000,353624124,193624124,1566635.613719531
Basic Instinct,3/20/1992,49000000,352927224,303927224,2529944.2580645164
GoldenEye,11/16/1995,58000000,352194034,294194034,2294423.674267101
Catch Me If You Can,12/25/2002,52000000,352114312,300114312,1937888.3434232252
Hannibal,2/8/2001,87000000,351692268,264692268,2000524.8464163821
The Mask,7/29/1994,23000000,351583407,328583407,2359620.1812080536
The Great Gatsby,5/10/2013,105000000,351040419,246040419,1506966.9621584495
Speed,6/9/1994,30000000,350448145,320448145,2367892.871621622
Cars 3,6/15/2017,175000000,350170057,175170057,1429528.1051621726
The Angry Birds Movie,5/11/2016,73000000,349779543,276779543,1456025.471529249
Night at the Museum: Secret of the Tomb,12/17/2014,127000000,349424282,222424282,1495138.2799830558
The Lorax,3/1/2012,70000000,348840316,278840316,1520717.0084397015
The Maze Runner,9/10/2014,34000000,348319861,314319861,1463338.2248530653
National Treasure,11/19/2004,100000000,347451894,247451894,1825811.3189700472
The Smurfs 2,7/30/2013,105000000,347434178,242434178,1485542.3064260273
Rush Hour 2,8/3/2001,90000000,347325802,257325802,1956765.0816901408
Trolls,10/13/2016,125000000,346864462,221864462,1434931.1088036601
xXx: Return of Xander Cage,1/13/2017,85000000,346147658,261147658,1425420.3731690545
Pocahontas,6/14/1995,55000000,346079773,291079773,2269375.5606557378
How the Grinch Stole Christmas,11/17/2000,123000000,345141403,222141403,1983571.2816091955
Star Trek Beyond,7/7/2016,185000000,343471816,158471816,1427397.5430955668
Over the Hedge,4/22/2006,80000000,343397247,263397247,1695788.874074074
Alvin and the Chipmunks: Chipwrecked,12/14/2011,75000000,342695435,267695435,1518555.403417349
The Flintstones,5/26/1994,46000000,341631208,295631208,2308318.972972973
Enchanted,11/20/2007,85000000,340487652,255487652,1621091.8699651489
300: Rise of an Empire,3/5/2014,110000000,337580051,227580051,1428650.2393215203
Batman Forever,6/16/1995,100000000,336529144,236529144,2206748.4852459016
Prince of Persia: The Sands of Time,5/19/2010,150000000,335154643,185154643,1537653.4902392586
The Rock,6/6/1996,75000000,335062621,260062621,2138242.635609445
Now You See Me 2,6/2/2016,90000000,334901337,244901337,1389528.3215361508
Sherlock Holmes: A Game of Shadows,11/22/2011,125000000,334615000,209615000,1482749.2998688363
The Curious Case of Benjamin Button,11/24/2008,150000000,333932083,183932083,1588428.1970051562
Tomorrow Never Dies,12/11/1997,110000000,333011068,223011068,2064544.7489150648
Indiana Jones and the Temple of Doom,5/23/1984,28000000,333000000,305000000,3211186.113789778
Back to the Future Part II,11/20/1989,40000000,332000000,292000000,2632831.086439334
The Great Wall,12/16/2016,150000000,331957105,181957105,1366984.3188285243
The Good Dinosaur,11/14/2015,175000000,331926147,156926147,1398549.512084134
Fantastic Four,6/29/2005,100000000,330579719,230579719,1691810.230296827
Meet the Parents,10/6/2000,55000000,330444045,275444045,1899103.7068965517
Who Framed Roger Rabbit,6/21/1988,70000000,329803958,259803958,2783155.76371308
Crocodile Dundee,9/26/1986,5000000,328203506,323203506,2975553.09156845
Black Swan,12/2/2010,13000000,327803731,314803731,1495598.2598697867
Se7en,9/22/1995,33000000,327311859,294311859,2129550.156148341
The Devil Wears Prada,6/30/2006,35000000,326551094,291551094,1604673.6805896806
Taken 3,12/16/2014,48000000,325771424,277771424,1393930.964840591
The Perfect Storm,3/15/2000,120000000,325756637,205756637,1902784.0946261683
A Christmas Carol,11/4/2009,200000000,325233863,125233863,1503415.4439975962
Megamind,10/28/2010,130000000,321887208,191887208,1471127.9461433345
Lethal Weapon 3,5/15/1992,35000000,321731527,286731527,2303017.372942019
Schindler's List,11/29/1993,22000000,321365567,299365567,2204153.4087791494
101 Dalmatians,11/17/1996,54000000,320689294,266689294,2022000.5926860026
The Conjuring 2,5/13/2016,40000000,320170008,280170008,1332770.0152770898
Fatal Attraction,9/11/1987,14000000,320145693,306145693,2783875.591304348
Inglourious Basterds,8/18/2009,70000000,319131050,249131050,1477670.6379156269
The Last Airbender,6/30/2010,150000000,318502923,168502923,1460948.8649655292
The Conjuring,7/18/2013,13000000,318000141,305000141,1359689.6702112649
The Proposal,6/1/2009,40000000,317375031,277375031,1471420.1712619325
Beverly Hills Cop,11/29/1984,15000000,316360478,301360478,3004373.010446344
Air Force One,7/25/1997,85000000,315156409,230156409,1959927.9166666665
Chicken Little,11/4/2005,150000000,314432665,164432665,1591258.4261133603
As Good as It Gets,12/19/1997,50000000,314178011,264178011,1944170.8601485149
A Beautiful Mind,12/11/2001,60000000,313542341,253542341,1774433.169213356
The Expendables 2,8/8/2012,100000000,312573423,212573423,1356779.1465367938
Resident Evil: The Final Chapter,12/23/2016,40000000,312242626,272242626,1285800.9874855357
The Lego Batman Movie,2/8/2017,80000000,311950384,231950384,1280568.7286281367
The SpongeBob Movie: Sponge Out of Water,2/5/2015,74000000,311594032,237594032,1327502.4582271792
Ocean's Thirteen,6/7/2007,85000000,311312624,226312624,1494166.7178620796
Maze Runner: The Scorch Trials,9/9/2015,61000000,311256926,250256926,1308104.5031414824
Austin Powers: The Spy Who Shagged Me,6/8/1999,33000000,310940086,277940086,1870878.977135981
Robin Hood,5/12/2010,200000000,310669540,110669540,1423926.9770554318
Little Fockers,12/21/2010,100000000,310650585,210650585,1410618.2596731493
दंगल,12/23/2016,10400000,310000000,299600000,1276565.9552213605
Bolt,11/21/2008,150000000,309979994,159979994,1474494.3299655612
Ransom,11/8/1996,80000000,309492681,229492681,1951404.0416141236
Runaway Bride,7/30/1999,70000000,309457509,239457509,1851930.035906643
The Blind Side,11/20/2009,29000000,309208309,280208309,1431858.026663703
The Fault in Our Stars,5/16/2014,12000000,307166834,295166834,1288759.6195399067
The Pursuit of Happyness,12/14/2006,55000000,307077295,252077295,1521691.253716551
Rise of the Guardians,11/21/2012,145000000,306941670,161941670,1336848.1409053097
Chicago,12/26/2002,45000000,306776732,261776732,1688369.4661529996
The Polar Express,11/10/2004,165000000,305875730,140875730,1601443.612565445
A Good Day to Die Hard,2/6/2013,92000000,304654182,212654182,1312225.6575036827
Mulan,6/18/1998,90000000,304320254,214320254,1864707.4387254904
Close Encounters of the Third Kind,11/16/1977,20000000,303788635,283788635,4891926.489533011
Passengers,12/21/2016,110000000,303144152,193144152,1248333.8837666109
Battleship,4/11/2012,209000000,303025485,94025485,1317015.3856183584
Liar Liar,3/21/1997,45000000,302710615,257710615,1889579.3695380776
G.I. Joe: The Rise of Cobra,8/4/2009,175000000,302469017,127469017,1401396.5223273442
Wrath of the Titans,3/27/2012,150000000,301000000,151000000,1308212.1824543104
Hook,12/11/1991,70000000,300854823,230854823,2181688.346627991
Rocky IV,11/21/1985,31000000,300473716,269473716,2749073.339432754
Rambo: First Blood Part II,5/21/1985,44000000,300400432,256400432,2791825.5762081784
Van Helsing,5/5/2004,160000000,300257475,140257475,1587823.7704918033
Resident Evil: Afterlife,9/9/2010,60000000,300228084,240228084,1374425.2811997859
Superman,12/13/1978,55000000,300218018,245218018,4434534.977843427
Stuart Little,12/17/1999,133000000,300135367,167135367,1778053.1220379146
Beverly Hills Cop II,5/18/1987,20000000,299965036,279965036,2642863.7533039646
Alice Through the Looking Glass,5/25/2016,170000000,299370084,129370084,1242106.747213901
My Best Friend's Wedding,6/19/1997,38000000,299288605,261288605,1864726.5109034267
Real Steel,9/28/2011,110000000,299268508,189268508,1321734.7684181237
Horton Hears a Who!,3/3/2008,85000000,297138014,212138014,1391564.6378929229
Austin Powers in Goldmember,7/26/2002,63000000,296655431,233655431,1641701.333702269
Miss Peregrine's Home for Peculiar Children,9/28/2016,110000000,296485719,186485719,1226521.1000748773
X-Men,7/13/2000,75000000,296339527,221339527,1714927.8182870368
Look Who's Talking,10/12/1989,7500000,296000000,288500000,2356687.898089172
Insurgent,3/18/2015,110000000,295238201,185238201,1247842.133736829
Ghostbusters,6/7/1984,30000000,295212467,265212467,2846793.317261331
Shutter Island,2/18/2010,80000000,294804195,214804195,1354605.708745537
Doctor Dolittle,6/22/1998,71000000,294456605,223456605,1804268.4129901961
Salt,7/21/2010,110000000,293329073,183329073,1343623.2227271062
G-Force,7/21/2009,150000000,292817841,142817841,1356680.7870863718
The Departed,10/5/2006,90000000,289847354,199847354,1436309.9801783944
Shakespeare in Love,12/11/1998,25000000,289317794,264317794,1765209.2373398412
4: Rise of the Silver Surfer,6/13/2007,130000000,289047763,159047763,1387304.959875595
Coming to America,6/28/1988,39000000,288752301,249752301,2436728.2784810127
Divergent,3/14/2014,85000000,288747895,203747895,1221990.8968949567
The Bourne Supremacy,7/23/2004,75000000,288500217,213500217,1522428.585751979
Bridesmaids,4/28/2011,32500000,288383523,255883523,1276236.5819334053
Sex and the City 2,5/26/2010,100000000,288347692,188347692,1322908.2283852913
Casper,5/26/1995,50000000,287928194,237928194,1888053.731147541
Bee Movie,10/28/2007,150000000,287594577,137594577,1368344.6666381194
American Pie 2,8/10/2001,30000000,287553595,257553595,1620020.2535211267
Pitch Perfect 2,5/7/2015,29000000,287506194,258506194,1208999.7855385714
The Sound of Music,3/2/1965,8200000,286214286,278014286,9144226.389776358
Oblivion,4/10/2013,120000000,286168572,166168572,1230668.478611454
Elysium,8/7/2013,115000000,286140700,171140700,1223466.6085164424
Lethal Weapon 4,7/10/1998,140000000,285444603,145444603,1749047.8125000002
Wedding Crashers,7/14/2005,40000000,285176741,245176741,1459451.0798362333
The Green Mile,12/10/1999,60000000,284600000,224600000,1691027.9263220439
John Carter,3/7/2012,260000000,284139100,24139100,1238661.766757341
Turbo,7/11/2013,135000000,282570682,147570682,1209655.4821144198
Bridget Jones's Diary,4/13/2001,25000000,281929795,256929795,1593724.1096664781
Batman Returns,6/19/1992,80000000,280000000,200000000,1992882.5622775801
The Tourist,12/8/2010,100000000,278731369,178731369,1271706.5457913396
寻龙诀,12/18/2015,37000000,278300000,241300000,1174677.9449256277
Scary Movie,7/7/2000,19000000,278019771,259019771,1608910.7118055555
xXx,8/9/2002,70000000,277448382,207448382,1535408.8655229663
Split,11/15/2016,9000000,276921998,267921998,1147373.3411227537
The Bourne Legacy,8/8/2012,130000000,276572938,146572938,1200512.7984755556
Scooby-Doo,6/14/2002,84000000,275650703,191650703,1532244.0411339633
Lincoln,11/9/2012,65000000,275293450,210293450,1195779.0557768405
千と千尋の神隠し,7/20/2001,15000000,274925095,259925095,1548873.7746478873
Lara Croft: Tomb Raider,6/11/2001,115000000,274703340,159703340,1543277.191011236
The Expendables,8/3/2010,80000000,274470394,194470394,1257239.1531386273
Jerry Maguire,12/6/1996,50000000,273552592,223552592,1724795.6620428753
Bad Boys II,7/18/2003,130000000,273339556,143339556,1480712.6543878657
Mr. Peabody & Sherman,2/7/2014,145000000,272912430,127912430,1162412.7591244606
The Silence of the Lambs,2/1/1991,19000000,272742922,253742922,2023315.4451038574
Grown Ups,6/24/2010,80000000,271430189,191430189,1245029.7874877874
The Firm,6/30/1993,42000000,270248367,228248367,1871526.0872576176
Rocky III,5/28/1982,17000000,270000000,253000000,2783505.154639175
We're the Millers,8/7/2013,37000000,269994119,232994119,1154427.8359992646
Gran Torino,12/9/2008,33000000,269958228,236958228,1284121.1827159084
Epic,5/15/2013,100000000,268426634,168426634,1152317.645796218
Neighbors,5/8/2014,18000000,268157400,250157400,1127185.372005044
Exodus: Gods and Kings,12/3/2014,140000000,268031828,128031828,1141474.149532392
Bambi,8/14/1942,858000,267447150,266589150,1.6208918181818182E7
The Princess and the Frog,12/8/2009,105000000,267045765,162045765,1236614.96464443
Something's Gotta Give,12/12/2003,80000000,266728738,186728738,1447253.0548019533
Indecent Proposal,4/7/1993,38000000,266614059,228614059,1851486.5208333333
The Prince,8/22/2014,18000000,266586800,248586800,1119966.7270229508
American Gangster,11/2/2007,100000000,266465037,166465037,1267812.5437131561
Waterworld,7/28/1995,175000000,264218220,89218220,1728045.9123610202
The Truman Show,6/4/1998,60000000,264118201,204118201,1620357.0613496932
Charlie's Angels,11/2/2000,92000000,264105545,172105545,1516976.1344055142
The Fifth Element,5/7/1997,90000000,263920180,173920180,1648470.8307307933
Cinderella,3/4/1950,2900000,263591415,260691415,1.1169127754237287E7
Jumanji,12/15/1995,65000000,262797249,197797249,1712034.1954397394
Knight and Day,6/15/2010,117000000,261930431,144930431,1201708.6734108687
Borat: Cultural Learnings of America for Make Benefit Glorious Nation of Kazakhstan,11/1/2006,18000000,261572744,243572744,1298127.7617866006
Total Recall,6/1/1990,65000000,261317921,196317921,2011685.3040800614
Robots,3/10/2005,75000000,260696994,185696994,1348665.2560786342
Super 8,6/8/2011,50000000,260095987,210095987,1152284.611158859
Paddington,11/27/2014,55000000,259207227,204207227,1103892.5906682792
Charlie's Angels: Full Throttle,6/27/2003,120000000,259175788,139175788,1409330.0054377378
Wanted,6/19/2008,75000000,258270008,183270008,1174146.7149169864
Rush Hour 3,8/8/2007,140000000,258022233,118022233,1240986.7062337375
The Full Monty,8/13/1997,3500000,257850122,254350122,1603545.5348258705
The Village,7/30/2004,60000000,256697520,196697520,1354604.327176781
Erin Brockovich,3/17/2000,52000000,256271286,204271286,1496037.863397548
Annabelle,10/2/2014,6500000,255273813,248773813,1075140.4101367544
Cliffhanger,5/28/1993,70000000,255000211,185000211,1765929.4390581716
Four Weddings and a Funeral,3/9/1994,6000000,254700832,248700832,1730304.5652173914
The Hangover Part II,5/25/2011,80000000,254455986,174455986,1127298.1189250494
功夫瑜伽,1/27/2017,65000000,254212245,189212245,1043551.3725200428
Babe,7/18/1995,30000000,254134910,224134910,1662098.8227599738
Hercules,6/26/1997,85000000,252712101,167712101,1574530.2242990655
Get Out,2/24/2017,5000000,252434250,247434250,1035411.0524567168
True Grit,12/22/2010,38000000,252276927,214276927,1145552.1312487796
Bean,7/3/1997,18000000,251212670,233212670,1565187.9750778817
American Hustle,12/12/2013,40000000,251171807,211171807,1077763.9337650023
You've Got Mail,12/17/1998,65000000,250821495,185821495,1526606.7863664029
Enemy of the State,11/20/1998,90000000,250649836,160649836,1529285.149481391
The Mask of Zorro,7/16/1998,95000000,250288523,155288523,1531753.506731946
Space Jam,11/15/1996,80000000,250200000,170200000,1577553.5939470367
The Ring,10/18/2002,48000000,249348933,201348933,1375338.8472145614
Eragon,12/14/2006,100000000,249288105,149288105,1235322.621407334
Cloudy with a Chance of Meatballs 2,9/26/2013,78000000,248384621,170384621,1063536.1813090355
Unbreakable,11/13/2000,75000000,248118121,173118121,1425147.1625502585
The Blair Witch Project,7/14/1999,60000,248000000,247940000,1487702.4595080984
Dumb and Dumber,12/16/1994,16000000,247275374,231275374,1645212.0691949434
Grown Ups 2,7/11/2013,80000000,246984278,166984278,1057313.8153050565
The Peanuts Movie,11/5/2015,99000000,246233113,147233113,1037487.4144672531
Rango,3/2/2011,135000000,245724603,110724603,1099601.2968357743
Face/Off,6/27/1997,80000000,245676146,165676146,1530692.4984423677
Teenage Mutant Ninja Turtles: Out of the Shadows,6/1/2016,135000000,245623848,110623848,1019109.9751885751
Dark Shadows,5/8/2012,150000000,245527149,95527149,1068368.6835062986
Hulk,6/19/2003,137000000,245360480,108360480,1334205.9815116911
The Godfather,3/14/1972,6000000,245066411,239066411,5919478.526570048
Love Actually,9/7/2003,40000000,244931766,204931766,1322525.7343412528
Back to the Future Part III,5/25/1990,40000000,244527583,204527583,1882429.4303310239
Rush Hour,9/18/1998,33000000,244386864,211386864,1490163.8048780488
Marley & Me,12/25/2008,60000000,244082376,184082376,1156005.0581833166
After Earth,5/30/2013,130000000,243843127,113843127,1044278.1579758805
Pixels,7/16/2015,88000000,243637091,155637091,1022327.8797898588
Hercules,7/23/2014,100000000,243400000,143400000,1023325.4292585305
A Few Good Men,12/11/1992,40000000,243240178,203240178,1714166.1592670893
Cloudy with a Chance of Meatballs,9/17/2009,100000000,242988466,142988466,1124025.5253796657
Daddy's Home,12/25/2015,50000000,242786137,192786137,1024777.2923736683
RoboCop,1/30/2014,120000000,242688965,122688965,1033682.3039343047
Eraser,6/21/1996,100000000,242295562,142295562,1543283.8343949046
Assassin's Creed,12/21/2016,125000000,240697856,115697856,991182.8660141081
Resident Evil: Retribution,9/12/2012,65000000,240159255,175159255,1037821.9111781407
Die Hard 2,7/2/1990,70000000,240031094,170031094,1840729.2484662577
Sully,9/7/2016,60000000,238470033,178470033,987748.0366817437
Batman & Robin,6/20/1997,125000000,238207122,113207122,1484156.523364486
Click,6/22/2006,82500000,237681299,155181299,1167967.0712530713
Gulliver's Travels,12/25/2010,112000000,237382724,125382724,1077919.7631491714
Gone in Sixty Seconds,6/9/2000,90000000,237202299,147202299,1375883.4048723897
Saturday Night Fever,12/16/1977,3500000,237113184,233613184,3793810.944
2 Fast 2 Furious,6/5/2003,76000000,236350661,160350661,1286612.199237888
A.I. Artificial Intelligence,6/29/2001,100000000,235926552,135926552,1329163.6732394367
Dead Poets Society,6/2/1989,16400000,235860116,219460116,1900564.9959709912
Spy,5/6/2015,65000000,235666219,170666219,991006.1563045352
American Pie,7/9/1999,11000000,235483004,224483004,1412615.5008998201
American Reunion,4/4/2012,50000000,234989584,184989584,1021316.4004606992
Big Daddy,6/25/1999,34200000,234801895,200601895,1408529.6640671866
The Imitation Game,11/14/2014,14000000,233555708,219555708,989010.0317169946
The Day the Earth Stood Still,12/10/2008,80000000,233093859,153093859,1108766.9530224327
Clash of the Titans,4/1/2010,125000000,232713139,107713139,1067447.394373627
The Girl with the Dragon Tattoo,12/14/2011,90000000,232617430,142617430,1030776.6581587436
Alien: Covenant,5/9/2017,97000000,232380243,135380243,949525.576853142
Argo,10/11/2012,44500000,232324128,187824128,1004353.8866577034
The English Patient,11/14/1996,27000000,231976425,204976425,1462650.8511979824
Sister Act,5/28/1992,31000000,231605150,200605150,1651962.5534950073
American Wedding,8/1/2003,55000000,231449203,176449203,1253787.6652221018
Juno,12/5/2007,7500000,231411584,223911584,1101771.0487725914
Constantine,2/8/2005,100000000,230884728,130884728,1203778.5610010426
Hidden Figures,12/10/2016,25000000,230698791,205698791,955543.552635939
Get Smart,6/19/2008,80000000,230685453,150685453,1048741.8532123438
Baahubali 2: The Conclusion,4/27/2017,18000000,230000000,212000000,939799.7000813131
Mr. Bean's Holiday,3/22/2007,25000000,229736344,204736344,1111523.4897380567
La vita è bella,12/20/1997,20000000,229400000,209400000,1419554.4554455446
Ghostbusters,7/14/2016,144000000,229147509,85147509,952289.4634040927
The Lost World: Jurassic Park,5/23/1997,73000000,229074524,156074524,1429036.3318777292
Ghost Rider,2/16/2007,110000000,228738393,118738393,1113884.4179749892
Lethal Weapon 2,7/7/1989,25000000,227853986,202853986,1831623.6816720257
The Green Hornet,1/12/2011,120000000,227817248,107817248,1034484.3544952162
Sleepless in Seattle,6/24/1993,21000000,227799884,206799884,1577561.5235457064
Immortals,11/10/2011,75000000,226904017,151904017,1002979.3440304116
Taken,2/18/2008,25000000,226830568,201830568,1062298.939717508
Percy Jackson & the Olympians: The Lightning Thief,2/1/2010,95000000,226497209,131497209,1045013.2139281445
Yes Man,12/9/2008,70000000,225990978,155990978,1074980.3927164793
Good Will Hunting,12/5/1997,10000000,225933435,215933435,1400703.2548047116
The Social Network,9/30/2010,40000000,224920315,184920315,1028390.5016208603
Chicken Run,6/21/2000,45000000,224834564,179834564,1301125.949074074
Hansel & Gretel: Witch Hunters,1/17/2013,50000000,224803475,174803475,968287.6691677506
Baby Driver,6/28/2017,34000000,224511319,190511319,917173.8538968732
Con Air,6/1/1997,75000000,224012234,149012234,1397456.2320648783
Interview with the Vampire,11/11/1994,60000000,223664608,163664608,1494085.5577822311
Flightplan,9/22/2005,55000000,223387299,168387299,1121422.18373494
Non-Stop,1/26/2014,50000000,222809600,172809600,949010.3543302056
The Little Mermaid,11/17/1989,40000000,222300000,182300000,1762886.5979381443
Jumper,2/10/2008,85000000,222231186,137231186,1049780.5123457082
Wild Wild West,6/29/1999,170000000,222104681,52104681,1332361.6136772647
Presumed Innocent,7/26/1990,22000000,221303188,199303188,1681635.1671732524
Scary Movie 3,10/24/2003,48000000,220673217,172673217,1196060.7967479674
Inferno,10/13/2016,75000000,220021259,145021259,910198.0275432406
Green Lantern,6/16/2011,200000000,219851172,19851172,973128.6550225299
Planes,8/9/2013,50000000,219788712,169788712,939761.9774496851
The Terminal,6/17/2004,60000000,219417255,159417255,1158486.034846885
It's Complicated,12/23/2009,85000000,219103655,134103655,1011152.7456654067
Knocked Up,6/1/2007,30000000,219076518,189076518,1051473.0744125326
The Prince of Egypt,12/15/1998,70000000,218613188,148613188,1333820.5491153141
Jack Reacher,12/20/2012,60000000,218340595,158340595,948152.6619767239
Collateral,8/4/2004,65000000,217764291,152764291,1149151.9313984169
Ted 2,6/25/2015,68000000,217022588,149022588,909360.7817174655
Central Intelligence,6/15/2016,50000000,216972543,166972543,900233.7709216739
Million Dollar Baby,12/15/2004,30000000,216763646,186763646,1139062.774566474
Twins,12/9/1988,15000000,216614388,201614388,1797629.77593361
Valentine's Day,2/10/2010,52000000,216485654,164485654,998821.884184349
Bad Teacher,5/16/2011,20000000,216197492,196197492,957804.2547912919
Clear and Present Danger,8/3/1994,62000000,215887717,153887717,1448910.8523489933
One Hundred and One Dalmatians,1/25/1961,4000000,215880014,211880014,7244295.77181208
Dracula,11/13/1992,40000000,215862692,175862692,1520159.8028169014
Vertical Limit,12/8/2000,75000000,215663859,140663859,1239447.4655172413
Dracula Untold,10/1/2014,70000000,215529201,145529201,907747.4529656788
Ghostbusters II,6/15/1989,37000000,215394738,178394738,1735654.617244158
The Patriot,6/28/2000,110000000,215294342,105294342,1245916.3310185184
The Sorcerer's Apprentice,7/13/2010,150000000,215283742,65283742,987490.2734265702
8 Mile,11/8/2002,41000000,215000000,174000000,1185879.7573083288
Just Go with It,2/10/2011,80000000,214918407,134918407,971123.6641980218
Public Enemies,7/1/2009,80000000,214104620,134104620,994212.3324247391
The Bourne Identity,6/14/2002,60000000,214034224,154034224,1189739.9888827126
Disclosure,12/9/1994,55000000,214015089,159015089,1429626.5130260522
Dirty Dancing,8/21/1987,6000000,213954274,207954274,1860471.947826087
Pulp Fiction,9/10/1994,8000000,213928762,205928762,1431919.424364123
卧虎藏龙,10/1/2000,17000000,213525736,196525736,1227159.4022988505
Into the Woods,12/25/2014,50000000,212902372,162902372,910979.8679543189
Bedtime Stories,12/24/2008,80000000,212874442,132874442,1008200.328687193
Entrapment,4/29/1999,66000000,212404396,146404396,1278004.789410349
Ace Ventura: When Nature Calls,11/10/1995,30000000,212385533,182385533,1382718.3138020835
Master and Commander: The Far Side of the World,11/14/2003,150000000,212011111,62011111,1149111.7127371274
Miss Congeniality,12/14/2000,45000000,212000000,167000000,1218390.8045977012
End of Days,11/24/1999,100000000,211989043,111989043,1259590.2733214498
Bridget Jones's Baby,9/14/2016,35000000,211952420,176952420,877911.5098497275
Fury,10/15/2014,68000000,211817906,143817906,892116.5381391804
Due Date,11/4/2010,65000000,211780824,146780824,967906.3998208434
Kingdom of Heaven,5/3/2005,130000000,211643158,81643158,1088699.3724279834
District 9,8/5/2009,30000000,210819611,180819611,976767.3814134937
Moonraker,6/26/1979,34000000,210308099,176308099,2876991.7783857733
Braveheart,5/24/1995,72000000,210000000,138000000,1377049.1803278688
Red Dragon,9/29/2002,78000000,209196298,131196298,1153868.163265306
Tomorrowland,5/19/2015,190000000,209154322,19154322,876450.1965319857
Lemony Snicket's A Series of Unfortunate Events,12/16/2004,140000000,209073645,69073645,1096348.4268484532
Safe House,2/9/2012,85000000,208076205,123076205,913965.8398597927
人再囧途之泰囧,12/12/2012,2200000,208000000,205800000,905919.3993057521
Me Before You,6/2/2016,20000000,207945075,187945075,862778.1949895858
Traffic,12/27/2000,48000000,207515725,159515725,1185126.9274700172
The Fast and the Furious,6/22/2001,38000000,207283925,169283925,1167796.7605633803
Philadelphia,12/22/1993,26000000,206678440,180678440,1413669.2202462382
The Expendables 3,8/4/2014,90000000,206172544,116172544,866810.2181188302
Sleepy Hollow,11/18/1999,100000000,206071502,106071502,1224429.6019013666
The Jungle Book,10/17/1967,4000000,205843612,201843612,6090047.692307693
London Has Fallen,3/2/2016,60000000,205754447,145754447,864035.2703542573
Silver Linings Playbook,9/8/2012,21000000,205738714,184738714,889077.3139965514
Paranormal Activity 3,10/19/2011,5000000,205703818,200703818,909268.5231843699
JFK,12/20/1991,40000000,205405498,165405498,1487367.8349022449
White House Down,6/27/2013,150000000,205366737,55366737,879153.4829363517
The Ugly Truth,7/24/2009,38000000,205298907,167298907,951188.9090690067
The Break-Up,6/1/2006,52000000,204999686,152999686,1010348.378511582
Eat Pray Love,8/12/2010,60000000,204594016,144594016,937163.3991718275
King Arthur,7/7/2004,120000000,203567857,83567857,1074803.8912354803
Everest,9/10/2015,55000000,203427584,148427584,854935.3169850176
Vanilla Sky,12/10/2001,68000000,203388341,135388341,1151037.583474816
Arrival,11/10/2016,47000000,203388186,156388186,842700.053448683
Need for Speed,3/13/2014,66000000,203277636,137277636,860277.8584215359
Battle: Los Angeles,3/8/2011,70000000,202466756,132466756,906025.3012749086
Patch Adams,12/25/1998,50000000,202292902,152292902,1231241.0346926353
Fun with Dick and Jane,12/21/2005,100000000,202026112,102026112,1018790.277357539
Teenage Mutant Ninja Turtles,3/30/1990,13500000,202000000,188500000,1567106.2839410396
Kindergarten Cop,12/21/1990,15000000,201957688,186957688,1500428.5884101042
Straight Outta Compton,8/13/2015,28000000,201634991,173634991,846082.4745296162
You Don't Mess with the Zohan,6/5/2008,90000000,201596308,111596308,921309.3617896397
21 Jump Street,3/12/2012,42000000,201585328,159585328,878780.986259329
Yogi Bear,12/11/2010,80000000,201584141,121584141,919723.7919691211
Garfield,6/10/2004,50000000,200804534,150804534,1058537.3431734317
Valkyrie,12/25/2008,75000000,200276000,125276000,948532.511141738
Rocky II,6/15/1979,7000000,200182160,193182160,2768771.2309820196
The Hunt for Red October,3/2/1990,30000000,199200000,169200000,1547785.547785548
Total Recall,8/2/2012,125000000,198802074,73802074,862934.8768767987
City of Angels,4/10/1998,55000000,198685114,143685114,1222677.6246153847
Jack the Giant Slayer,2/27/2013,195000000,197687603,2687603,849272.0504525868
Open Season,9/29/2006,85000000,197309027,112309027,977745.4261645193
Smurfs: The Lost Village,3/23/2017,60000000,197183546,137183546,806397.5151723349
Spy Kids 3-D: Game Over,7/25/2003,38000000,197011982,159011982,1067237.1722643555
The Other Woman,4/16/2014,40000000,196781193,156781193,827159.2812105927
Stargate,10/27/1994,55000000,196567262,141567262,1313074.56245825
50 First Dates,2/13/2004,75000000,196482882,121482882,1055224.9301825995
Panic Room,3/29/2002,48000000,196397415,148397415,1092310.428253615
The Vow,2/5/2012,30000000,196114570,166114570,861424.8692145847
Anger Management,4/11/2003,75000000,195745823,120745823,1064993.5963003263
Beowulf,11/5/2007,70000000,195735876,125735876,931290.6550193409
For Your Eyes Only,6/23/1981,28000000,195312802,167312802,2132235.8296943232
The Pelican Brief,12/16/1993,45000000,195268056,150268056,1335622.8180574556
A Dog's Purpose,1/19/2017,22000000,194647323,172647323,799034.9995689708
The Intern,9/24/2015,35000000,194564672,159564672,818055.4495076481
The Holiday,12/8/2006,85000000,194168700,109168700,962183.8453914766
Gangs of New York,12/14/2002,100000000,193772504,93772504,1071158.1205085681
Paranormal Activity,9/14/2007,15000,193355800,193340800,927410.4273586263
The Sum of All Fears,5/31/2002,68000000,193000000,125000000,1072818.2323513064
The Curse of the Were-Rabbit,9/4/2005,30000000,192452832,162452832,968072.5955734405
The Equalizer,9/24/2014,55000000,192330738,137330738,810042.1508383418
The Addams Family,11/22/1991,30000000,191502426,161502426,1388705.0471356055
The Living Daylights,6/29/1987,40000000,191185897,151185897,1680016.6695957822
Superman II,12/4/1980,54000000,190458706,136458706,2206937.4971031286
The Longest Yard,5/19/2005,82000000,190320568,108320568,978511.9177377892
Hollow Man,8/4/2000,95000000,190213455,95213455,1100772.3090277778
Cheaper by the Dozen,12/24/2003,40000000,190212113,150212113,1027063.2451403888
Outbreak,3/10/1995,50000000,189859560,139859560,1254026.1558784675
The Santa Clause,11/10/1994,22000000,189833357,167833357,1268091.8971275885
Gnomeo & Juliet,1/13/2011,36000000,189712432,153712432,861456.0332027081
The X Files,6/19/1998,66000000,189198313,123198313,1159303.3884803923
Rambo III,5/24/1988,63000000,189015611,126015611,1601827.2118644067
22 Jump Street,6/5/2014,50000000,188441614,138441614,790632.0470917963
The Secret Life of Walter Mitty,12/18/2013,90000000,188133322,98133322,804277.2704731614
Tropic Thunder,8/9/2008,92000000,188072649,96072649,858442.1140556675
Jaws 2,6/16/1978,20000000,187884007,167884007,2859726.133942161
Octopussy,6/5/1983,27500000,187500000,160000000,1884422.1105527638
Heat,12/15/1995,60000000,187436818,127436818,1221086.7622149838
Mr. Popper's Penguins,6/17/2011,55000000,187361754,132361754,829320.5354060251
12 Years a Slave,10/18/2013,20000000,187000000,167000000,802337.5052023222
The Horse Whisperer,5/14/1998,60000000,186883563,126883563,1147933.4336609335
Walk the Line,9/13/2005,28000000,186438883,158438883,937821.34305835
The Final Destination,8/26/2009,40000000,186167139,146167139,862008.6169774366
I Now Pronounce You Chuck & Larry,7/12/2007,85000000,186072214,101072214,893293.8420251657
Atlantis: The Lost Empire,6/2/2001,120000000,186053725,66053725,1045245.6460674157
The Waterboy,11/6/1998,23000000,185991646,162991646,1134095.4024390243
Hugo,11/22/2011,170000000,185770160,15770160,823186.5716615265
The Spy Who Loved Me,7/7/1977,14000000,185438673,171438673,3039978.2459016396
The Birdcage,3/8/1996,31000000,185260553,154260553,1189855.8317276814
Watchmen,3/5/2009,130000000,185258983,55258983,870950.37351499
Snow White and the Seven Dwarfs,12/20/1937,1488423,184925486,183437063,1.3022921549295776E7
Wind River,8/3/2017,11000000,184770205,173770205,752569.8825752793
Inside Man,3/23/2006,45000000,184376254,139376254,915018.6302729528
Hop,3/30/2011,63000000,183953723,120953723,817913.8084355241
Bad Moms,7/28/2016,20000000,183936074,163936074,763698.7240968408
102 Dalmatians,10/7/2000,85000000,183611771,98611771,1055240.0632183908
The Grudge,10/22/2004,10000000,183474602,173474602,960600.0104712042
The BFG,6/1/2016,140000000,183345589,43345589,760713.2620800106
Aliens,7/18/1986,18500000,183316455,164816455,1671070.6927985414
Paul Blart: Mall Cop,1/15/2009,26000000,183293131,157293131,868099.491813605
Mirror Mirror,3/15/2012,85000000,183018522,98018522,797841.7817535049
Storks,9/22/2016,70000000,182379278,112379278,754478.2711217934
Cape Fear,11/15/1991,35000000,182300000,147300000,1322931.785195936
The Haunted Mansion,11/25/2003,90000000,182290266,92290266,989095.3119913185
While You Were Sleeping,4/21/1995,17000000,182057016,165057016,1196169.6189224706
The Bridges of Madison County,5/28/1995,24000000,182016617,158016617,1193551.586885246
Grease,7/7/1978,6000000,181813770,175813770,2767332.8767123288
Poseidon,5/12/2006,160000000,181674817,21674817,897159.5901234568
Hot Shots!,7/31/1991,26000000,181096164,155096164,1325740.5856515374
Road to Perdition,7/12/2002,80000000,181001478,101001478,1005005.4303164908
Kill Bill: Vol. 1,10/10/2003,30000000,180949000,150949000,978102.7027027027
Sweet Home Alabama,9/26/2002,30000000,180622424,150622424,996262.6806398234
Déjà Vu,11/22/2006,75000000,180557550,105557550,894735.1337958374
Lo imposible,9/9/2012,42000000,180274123,138274123,779034.8736209362
The Dictator,5/15/2012,65000000,179379533,114379533,780538.8377608076
The League of Extraordinary Gentlemen,7/11/2003,78000000,179265204,101265204,974797.194127243
Allegiant,3/9/2016,110000000,179246868,69246868,752720.6255354173
Moulin Rouge!,3/9/2001,52500000,179213434,126713434,1017102.3496027242
Daredevil,2/14/2003,78000000,179179718,101179718,978589.3937738941
City Slickers,6/7/1991,27000000,179033791,152033791,1316424.9338235294
Scary Movie 4,4/13/2006,45000000,178262620,133262620,884678.0148883375
Dante's Peak,2/7/1997,116000000,178127760,62127760,1116088.7218045113
Eagle Eye,9/25/2008,80000000,178066569,98066569,822201.146957377
Patriot Games,6/4/1992,45000000,178051587,133051587,1269982.7888730387
Brokeback Mountain,9/2/2005,14000000,178043761,164043761,895592.3591549295
Flubber,11/26/1997,80000000,177977226,97977226,1103392.5976441412
Baywatch,5/12/2017,69000000,177856751,108856751,726737.9184662469
Double Jeopardy,9/24/1999,70000000,177841558,107841558,1057321.9857312723
War Horse,12/25/2011,66000000,177584879,111584879,783468.4622681049
Paranormal Activity 2,10/20/2010,3000000,177512032,174512032,811287.0116040456
英雄,12/19/2002,31000000,177394432,146394432,976303.9735828289
How to Lose a Guy in 10 Days,2/7/2003,50000000,177371441,127371441,968713.4953577281
He's Just Not That Into You,2/6/2009,40000000,177259441,137259441,835368.9377123655
The Descendants,9/9/2011,20000000,177243185,157243185,781188.9734627946
The A-Team,6/10/2010,110000000,177238796,67238796,813152.5520152318
Tootsie,12/16/1982,21000000,177200000,156200000,1811860.9406952965
In the Line of Fire,7/8/1993,40000000,176997168,136997168,1225742.1606648199
Analyze This,3/5/1999,80000000,176885658,96885658,1072034.290909091
Dr. Dolittle 2,6/22/2001,70000000,176104344,106104344,992137.1492957746
The Italian Job,5/30/2003,60000000,176070171,116070171,958465.8192705499
The Bucket List,12/25/2007,45000000,175372502,130372502,830834.2903164676
Hacksaw Ridge,10/7/2016,40000000,175302354,135302354,725201.9989326891
Sleeping with the Enemy,2/8/1991,19000000,174999005,155999005,1298212.203264095
Cowboys & Aliens,7/29/2011,163000000,174822325,11822325,771689.1787503586
The Grand Budapest Hotel,2/26/2014,30000000,174600318,144600318,738914.474825746
Percy Jackson: Sea of Monsters,8/7/2013,90000000,174578751,84578751,746455.4060467682
Identity Thief,2/7/2013,35000000,173965010,138965010,749313.0346390083
Big Momma's House,5/31/2000,30000000,173959438,143959438,1009045.4640371229
In Time,10/27/2011,40000000,173930596,133930596,768821.977633382
Le fabuleux destin d'Amélie Poulain,4/25/2001,10000000,173921954,163921954,978739.18964547
Anchorman 2: The Legend Continues,12/18/2013,50000000,173649015,123649015,742356.2945672806
Creed,11/25/2015,37000000,173567581,136567581,733823.405559666
Elf,10/9/2003,32000000,173398518,141398518,937289.2864864864
The Girl on the Train,10/5/2016,45000000,173185859,128185859,716446.3469422369
Scream,12/20/1996,14000000,173046663,159046663,1087659.7297297297
Cold Mountain,12/24/2003,79000000,173013509,94013509,934198.2127429806
Evan Almighty,6/9/2007,175000000,173000000,-2000000,830325.6028259868
Black Hawk Down,12/28/2001,92000000,172989651,80989651,976790.8018068888
The Santa Clause 2,10/31/2002,65000000,172855065,107855065,953420.1047986762
Scream 2,12/9/1997,24000000,172363301,148363301,1068588.350898946
Along Came Polly,1/16/2004,42000000,171963386,129963386,923541.2781954887
Couples Retreat,9/19/2009,70000000,171844840,101844840,794926.5648056917
Antz,10/2/1998,60000000,171757863,111757863,1047304.0426829269
No Country for Old Men,11/8/2007,25000000,171600000,146600000,816454.7024650652
John Wick: Chapter 2,2/8/2017,40000000,171539887,131539887,704178.0560994733
Cocktail,7/29/1988,20000000,171504781,151504781,1441216.6470588236
Mr. Deeds,6/28/2002,50000000,171269535,121269535,950969.1004997224
AVP: Alien vs. Predator,8/12/2004,70000000,171183863,101183863,903344.9234828496
Contact,7/11/1997,90000000,171120329,81120329,1066170.274143302
Blood Diamond,12/7/2006,100000000,170877916,70877916,846768.6620416254
Cloverfield,1/15/2008,25000000,170764026,145764026,809001.4496873223
The Other Guys,8/6/2010,100000000,170432927,70432927,780685.1066363736
The Specialist,10/7/1994,45000000,170362582,125362582,1139549.043478261
Starsky & Hutch,3/5/2004,60000000,170268750,110268750,908584.5784418356
Shall We Dance?,10/15/2004,50000000,170128460,120128460,891191.5138816134
What Happens in Vegas,5/7/2008,35000000,170000000,135000000,784740.9431662912
Stuart Little 2,7/19/2002,120000000,169956806,49956806,940546.795794134
Zookeeper,7/6/2011,80000000,169852759,89852759,751820.3583537681
Dumb and Dumber To,11/12/2014,40000000,169837010,129837010,719188.188913026
Ghost in the Shell,3/29/2017,110000000,169801921,59801921,694418.2207063519
Meet the Robinsons,3/23/2007,150000000,169332978,19332978,819276.4773617951
The Emperor's New Groove,12/9/2000,100000000,169327687,69327687,973147.6264367816
Twelve Monkeys,12/29/1995,29500000,168840000,139340000,1093523.3160621761
Seven Pounds,12/18/2008,55000000,168167691,113167691,796463.4915673264
Fantastic Four,8/5/2015,120000000,167977596,47977596,704852.3640880176
Unstoppable,11/4/2010,100000000,167805466,67805466,766924.8867702911
DodgeBall: A True Underdog Story,6/18/2004,20000000,167722310,147722310,885545.4593453009
Alexander,11/21/2004,155000000,167298192,12298192,879128.7020493957
Magic Mike,6/28/2012,7000000,167221571,160221571,729893.7207556394
Sleepers,10/18/1996,44000000,165615285,121615285,1044232.5662042876
Bridge of Spies,10/15/2015,40000000,165478348,125478348,695760.7615267535
The Princess Diaries,8/3/2001,37000000,165335153,128335153,931465.6507042254
The Scorpion King,4/16/2002,60000000,165333180,105333180,919539.3770856507
The Muppets,11/22/2011,45000000,165184237,120184237,731966.0259137155
The Huntsman: Winter's War,4/6/2016,115000000,164602163,49602163,687960.6914624615
Speed 2: Cruise Control,6/13/1997,160000000,164508066,4508066,1026251.1915159076
Daddy Day Care,5/3/2003,60000000,164433867,104433867,896097.3678474114
Six Days Seven Nights,6/12/1998,70000000,164000000,94000000,1006134.9693251534
Saw III,10/27/2006,10000000,163876815,153876815,813284.4416873449
Miami Vice,7/27/2006,135000000,163794509,28794509,803308.0382540461
Four Christmases,11/26/2008,80000000,163733697,83733697,778838.6751526913
Burn After Reading,9/5/2008,37000000,163720069,126720069,748321.7114675272
The Incredible Hulk,6/12/2008,150000000,163712074,13712074,748175.7374951444
Up in the Air,9/5/2009,25000000,163670000,138670000,757840.2455908024
劇場版ポケットモンスター ミュウツーの逆襲,7/18/1998,30000000,163644662,133644662,1001497.3194614443
Unbroken,12/25/2014,65000000,163442937,98442937,699349.7712948264
The Happening,6/11/2008,60000000,163403799,103403799,746766.8989785892
Talladega Nights: The Ballad of Ricky Bobby,8/4/2006,72500000,162966177,90466177,799245.5958803335
The Island,7/20/2005,126000000,162949164,36949164,829680.0610997963
World Trade Center,8/9/2006,63000000,162945894,99945894,799146.1206473762
The Interpreter,4/8/2005,80000000,162944923,82944923,837332.5950668037
The Spiderwick Chronicles,2/14/2008,90000000,162839667,72839667,769225.5624890762
The Magnificent Seven,9/14/2016,90000000,162360636,72360636,672501.2674586212
Memoirs of a Geisha,12/6/2005,85000000,162242962,77242962,824405.2947154471
Jack Reacher: Never Go Back,10/19/2016,60000000,162146076,102146076,671821.257659942
Eyes Wide Shut,7/14/1999,65000000,162091208,97091208,972352.7774445112
Alien: Resurrection,11/12/1997,70000000,162000000,92000000,1003095.9752321981
Limitless,3/8/2011,27000000,161849455,134849455,724265.573887867
Scream 3,2/3/2000,40000000,161834276,121834276,953087.6089517078
Live and Let Die,7/5/1973,7000000,161777836,154777836,3651869.887133183
Flight,11/2/2012,31000000,161772375,130772375,702682.965498369
Payback,2/5/1999,90000000,161626121,71626121,982529.6109422492
The Ring Two,3/17/2005,50000000,161451538,111451538,829658.4686536485
Olympus Has Fallen,3/20/2013,70000000,161025640,91025640,692491.0657073681
Love's Deadly Triangle: The Texas Cadet Murder,2/20/1997,14000000,161001698,147001698,1006260.6125
Born on the Fourth of July,12/20/1989,14000000,161001698,147001698,1263749.5918367347
A Star Is Born,12/16/1976,6000000,161000000,155000000,2752136.752136752
Legends of the Fall,12/16/1994,30000000,160638883,130638883,1068788.3100465734
Into the Storm,8/6/2014,50000000,160602194,110602194,675219.01854935
Johnny English,4/6/2003,40000000,160583018,120583018,873683.4494015233
Hellboy II: The Golden Army,7/11/2008,85000000,160388063,75388063,729155.9664308705
27 Dresses,1/10/2008,30000000,160259319,130259319,759234.9772598067
Underworld: Awakening,1/19/2012,70000000,160112671,90112671,703288.0661328366
Johnny English Reborn,9/15/2011,45000000,160078586,115078586,705537.0070827585
Never Say Never Again,10/7/1983,36000000,160000000,124000000,1584158.415841584
Alien³,5/22/1992,50000000,159773545,109773545,1139611.5905848788
The Sting,12/25/1973,5500000,159616327,154116327,3425243.068669528
The Jackal,11/14/1997,60000000,159330280,99330280,986565.2012383901
Step Up 3D,8/4/2010,30000000,159291809,129291809,729652.0988310308
Daylight,12/6/1996,80000000,159212469,79212469,1003861.7213114755
Unforgiven,8/7/1992,14000000,159157447,145157447,1129577.33853797
Demolition Man,10/8/1993,57000000,159055768,102055768,1091666.218256692
Sin City,4/1/2005,40000000,158733820,118733820,815692.8057553957
The Heat,6/27/2013,43000000,158674180,115674180,679267.5388277196
The Fast and the Furious: Tokyo Drift,6/3/2006,85000000,158468292,73468292,781016.7175948743
Goosebumps,8/5/2015,58000000,158162788,100162788,663668.3563000386
Days of Thunder,6/27/1990,60000000,157920733,97920733,1211048.56595092
Final Destination 5,8/12/2011,47000000,157887643,110887643,696937.2221854378
Crimson Tide,5/12/1995,53000000,157387195,104387195,1034081.4388961893
The Book of Eli,1/14/2010,80000000,157107755,77107755,725044.6727307129
Don't Breathe,8/25/2016,9900000,157100845,147200845,650715.0993256789
This Means War,2/14/2012,65000000,156974557,91974557,689504.0344720046
葉問3,12/19/2015,36000000,156844753,120844753,662026.8491786119
P.S. I Love You,11/15/2007,30000000,156835339,126835339,746206.0025597473
Mystic River,10/7/2003,25000000,156822020,131822020,847686.5945945946
Under Siege,10/8/1992,35000000,156563139,121563139,1104112.4047954865
Lara Croft Tomb Raider: The Cradle of Life,7/21/2003,95000000,156505388,61505388,847808.1690140845
Licence to Kill,7/7/1989,32000000,156167015,124167015,1255361.8569131831
The Hateful Eight,12/25/2015,44000000,155760117,111760117,657448.703337892
Rocky Balboa,12/20/2006,24000000,155721132,131721132,769312.3666113351
Hannah Montana: The Movie,4/10/2009,35000000,155545279,120545279,729437.6242731195
What Lies Beneath,7/21/2000,100000000,155464351,55464351,899677.9571759258
Knowing,3/19/2009,50000000,155446362,105446362,728973.7478897017
The Accountant,10/14/2016,44000000,155160045,111160045,641876.0057750621
Blade II,3/22/2002,54000000,155010032,101010032,862124.7608453837
The Monuments Men,1/24/2014,70000000,154984035,84984035,660121.7091672665
Dreamgirls,12/25/2006,70000000,154937680,84937680,765441.8623033753
Maid in Manhattan,12/13/2002,55000000,154906693,99906693,856311.1829740187
Cool Runnings,9/30/1993,14000000,154864401,140864401,1062899.1146190804
Monster-in-Law,5/13/2005,43000000,154749918,111749918,796038.6728395062
The Phantom of the Opera,12/8/2004,70000000,154648887,84648887,812658.3657383079
The Town,9/15/2010,37000000,154026136,117026136,705121.9608220144
Ride Along,1/7/2014,25000000,153997819,128997819,658346.6671796713
Focus,2/25/2015,50100000,153962963,103862963,652056.6451662086
Free Willy,7/16/1993,20000000,153698625,133698625,1061454.5925414364
Another 48 Hrs.,6/8/1990,38000000,153518974,115518974,1181824.2802155504
Gremlins,6/7/1984,11000000,153083102,142083102,1476211.2054001929
The Devil's Advocate,10/17/1997,57000000,152944660,95944660,947025.7585139319
Tower Heist,11/2/2011,75000000,152930623,77930623,675996.2118198294
Saw II,10/28/2005,4000000,152925093,148925093,773912.4139676114
Chocolat,12/14/2000,25000000,152500343,127500343,876438.7528735632
A View to a Kill,5/24/1985,30000000,152427960,122427960,1416616.7286245355
Backdraft,5/24/1991,75000000,152368585,77368585,1120357.2426470588
A Time to Kill,7/24/1996,40000000,152266007,112266007,967997.5015893197
Date Night,4/8/2010,55000000,152263880,97263880,698429.330899183
Kill Bill: Vol. 2,4/16/2004,30000000,152159461,122159461,804650.7720782654
Phenomenon,7/5/1996,32000000,152036382,120036382,968384.5987261146
Congo,6/9/1995,50000000,152022101,102022101,996866.2360655738
Sweeney Todd: The Demon Barber of Fleet Street,12/20/2007,50000000,152000000,102000000,720106.1209020276
Jackass Presents: Bad Grandpa,10/22/2013,15000000,151831537,136831537,651444.58078938
Big,6/3/1988,18000000,151668774,133668774,1285328.593220339
The Bone Collector,11/4/1999,73000000,151493655,78493655,900140.5525846701
Planes: Fire & Rescue,7/17/2014,50000000,151165787,101165787,635545.5787632646
Vantage Point,2/1/2008,40000000,151161491,111161491,714059.9405743222
Midnight in Paris,5/11/2011,30000000,151119219,121119219,668775.641252589
47 Ronin,12/6/2013,175000000,150962475,-24037525,647771.3914241211
Step Up 2: The Streets,2/14/2008,23000000,150816700,127816700,712431.209345609
Gods of Egypt,2/25/2016,140000000,150680864,10680864,632761.9303579527
Friends with Benefits,7/21/2011,35000000,150483765,115483765,664255.512149904
Happy Feet Two,11/17/2011,130000000,150406466,20406466,666482.6207947818
Broken Arrow,2/9/1996,50000000,150270147,100270147,970110.6972240155
The Taking of Pelham 1 2 3,6/11/2009,100000000,150166126,50166126,696203.0571228551
西游记之大圣归来,7/10/2015,10000000,150000000,140000000,628524.9775826092
Star Trek: First Contact,11/21/1996,46000000,150000000,104000000,945775.5359394704
The General's Daughter,6/18/1999,60000000,149705852,89705852,898055.5008998201
Jack and Jill,11/11/2011,79000000,149673788,70673788,661600.0884056049
Lone Survivor,12/24/2013,40000000,149295601,109295601,638244.502299971
Beverly Hills Chihuahua,10/3/2008,20000000,149281606,129281606,689290.0130671875
Ghost Rider: Spirit of Vengeance,12/10/2011,57000000,149217355,92217355,661213.4203622957
Surf's Up,6/8/2007,85000000,149044513,64044513,715349.5670787897
Death Becomes Her,7/30/1992,55000000,149022650,94022650,1057648.3321504614
Lights Out,7/21/2016,4900000,148868835,143968835,618100.2827497727
Resident Evil: Extinction,9/20/2007,45000000,148412065,103412065,710323.0893670789
Seabiscuit,7/22/2003,87000000,148336445,61336445,803556.0400866739
Spy Kids,3/18/2001,35000000,147934180,112934180,836258.7902769926
The Game Plan,9/28/2007,22000000,147880543,125880543,707779.1428954321
The Mexican,3/1/2001,57000000,147845033,90845033,839075.1021566403
No Strings Attached,1/21/2011,25000000,147780440,122780440,667756.1237907179
Source Code,3/30/2011,32000000,147332697,115332697,655085.6669008386
Romeo + Juliet,10/31/1996,14500000,147298761,132798761,928743.764186633
Swordfish,6/7/2001,102000000,147080413,45080413,826294.4550561798
The Last Witch Hunter,10/21/2015,90000000,146936910,56936910,619109.2375366569
Ben-Hur,12/26/1959,15000000,146900000,131900000,5013651.877133106
Mama,1/17/2013,15000000,146497771,131497771,631004.4149444794
The Color Purple,12/18/1985,15000000,146292009,131292009,1334781.1040145985
Police Academy,3/22/1984,4500000,146198896,141698896,1418030.0290979631
Music and Lyrics,2/9/2007,40000000,145896422,105896422,716939.2576867699
Driving Miss Daisy,12/13/1989,7500000,145793296,138293296,1156172.053925456
Lilo & Stitch,6/21/2002,80000000,145771527,65771527,809392.1543586897
借りぐらしのアリエッティ,7/16/2010,37000000,145570827,108570827,666801.7653633332
Chronicle,2/1/2012,15000000,145000000,130000000,636906.304493923
I Am Number Four,2/18/2011,50000000,144492830,94492830,646595.828466843
The Exorcism of Emily Rose,9/9/2005,19000000,144216468,125216468,725434.949698189
The Beach,2/11/2000,40000000,144056873,104056873,848391.4782096584
Charlotte's Web,12/15/2006,85000000,144000000,59000000,713577.7998017839
Pete's Dragon,8/10/2016,65000000,143695338,78695338,596620.0316380804
Spy Game,11/18/2001,92000000,143049560,51049560,809561.7430673458
Meet Joe Black,11/12/1998,90000000,142940100,52940100,871585.9756097561
Paranormal Activity 4,10/17/2012,5000000,142817992,137817992,620351.714222421
The Legend of Zorro,10/24/2005,75000000,142400065,67400065,720648.1022267207
Power Rangers,3/23/2017,100000000,142337240,42337240,582099.2622401073
New Year's Eve,12/8/2011,56000000,142044638,86044638,629429.6057995675
Legally Blonde,7/13/2001,18000000,141774679,123774679,798730.585915493
Gothika,11/21/2003,40000000,141591324,101591324,768265.4584915898
Bad Boys,4/7/1995,19000000,141407024,122407024,930921.8169848585
Scary Movie 2,7/4/2001,45000000,141220678,96220678,795609.4535211268
Thunderball,12/16/1965,5500000,141195658,135695658,4440115.031446541
Shallow Hal,11/1/2001,40000000,141069860,101069860,795207.7790304397
Evita,12/14/1996,55000000,141047179,86047179,889326.475409836
Animal House,7/27/1978,2700000,141000000,138300000,2136363.6363636362
The Devil's Own,3/12/1997,90000000,140807547,50807547,880047.16875
Trainwreck,7/17/2015,35000000,140795793,105795793,590794.5458970442
Die Hard,7/15/1988,28000000,140767956,112767956,1187915.240506329
Sausage Party,7/11/2016,19000000,140705322,121705322,584742.0998387553
Step Up Revolution,7/26/2012,33000000,140470746,107470746,609737.6323362807
Deep Impact,5/8/1998,75000000,140464664,65464664,862805.0614250613
Lion,11/24/2016,12000000,140302754,128302754,581127.414758607
Monster House,7/21/2006,75000000,140175006,65175006,687469.3771456596
The SpongeBob SquarePants Movie,11/14/2004,30000000,140161792,110161792,733831.3717277487
Legend of the Guardians: The Owls of Ga'Hoole,7/10/2010,80000000,140073390,60073390,642506.0662076684
American Graffiti,8/1/1973,777000,140000000,139223000,3104212.8603104213
Anastasia,11/20/1997,53000000,139804348,86804348,866734.9535027897
Saw IV,10/25/2007,10000000,139352633,129352633,663025.1311989418
Star Trek: The Motion Picture,12/6/1979,35000000,139000000,104000000,1812255.5410691004
Platoon,12/18/1986,6000000,138530565,132530565,1245778.4622302158
Big Momma's House 2,1/26/2006,40000000,138259062,98259062,695818.127830901
Far and Away,5/22/1992,60000000,137783840,77783840,982766.3338088446
Bridge to Terabithia,2/16/2007,60000000,137587063,77587063,670005.9556274104
Contagion,9/8/2011,60000000,137551594,77551594,606250.60712507
Last Action Hero,6/18/1993,85000000,137298489,52298489,950820.5609418282
Conspiracy Theory,8/7/1997,75000000,136982834,61982834,851883.2960199005
Anaconda,4/11/1997,45000000,136885767,91885767,854467.9588014982
The Best Exotic Marigold Hotel,11/28/2011,10000000,136836156,126836156,606349.7288099542
The Godfather: Part III,12/24/1990,54000000,136766062,82766062,1016092.5854383359
Remember the Titans,9/29/2000,30000000,136706683,106706683,785670.591954023
Let's Be Cops,8/13/2014,17000000,136621271,119621271,574396.14129795
Love Story,12/16/1970,2200000,136400000,134200000,3427135.67839196
17 Again,3/11/2009,20000000,136267476,116267476,640628.6334851839
Lost in Space,4/3/1998,80000000,136159423,56159423,837904.1415384616
Saw 3D,10/21/2010,20000000,136150434,116150434,622251.2214183535
The Bounty Hunter,3/16/2010,40000000,136000000,96000000,623827.4566646331
The Jungle Book 2,2/7/2003,20000000,135680000,115680000,741015.8383397051
Stardust,8/9/2007,70000000,135560026,65560026,651991.0637417815
Babel,9/8/2006,25000000,135330182,110330182,666979.7042878265
A Perfect World,11/24/1993,30000000,135130999,105130999,926824.4101508915
Sense and Sensibility,12/13/1995,16500000,135000000,118500000,879478.8273615636
Wall Street: Money Never Sleeps,9/2/2010,70000000,134748021,64748021,616867.9631384505
Last Vegas,10/31/2013,28000000,134402450,106402450,576663.7776795713
Scent of a Woman,12/23/1992,31000000,134095253,103095253,940359.4179523143
"\"劇場版ポケットモンスター 幻のポケモン ルギア爆�?\"\"Ash Ketchum must put his skill to the test when he attempts to save the world from destruction. The Greedy Pokemon collector Lawrence III throws the universe into chaos after disrupting the balance of nature by capturing one of the Pokemon birds that rule the elements of fire\"",7/17/1999,30000000,133949270,103949270,801611.4302812688
Annie,12/19/2014,65000000,133821816,68821816,572605.0824322763
Hot Shots! Part Deux,5/21/1993,25000000,133752825,108752825,926266.1011080332
Point Break,12/3/2015,105000000,133718711,28718711,565347.0499947151
The Artist,5/15/2011,15000000,133432856,118432856,590504.9299888478
The Big Short,12/11/2015,28000000,133346506,105346506,563773.4108445196
Star Trek IV: The Voyage Home,11/25/1986,24000000,133000000,109000000,1203619.9095022625
Astérix aux Jeux Olympiques,1/13/2008,97250400,132900000,35649600,629619.101762365
Zero Dark Thirty,12/19/2012,40000000,132820716,92820716,576779.207920792
Bringing Down the House,3/7/2003,20000000,132675402,112675402,720279.0553745929
V for Vendetta,3/15/2006,54000000,132511035,78511035,663218.3933933934
The Three Musketeers,8/31/2011,75000000,132274484,57274484,582992.0533829317
Perfume: The Story of a Murderer,9/13/2006,50000000,132180323,82180323,651455.5101034993
2 Guns,8/2/2013,61000000,131940411,70940411,564144.4477225208
Seven Years in Tibet,9/12/1997,70000000,131457682,61457682,815494.3052109182
Bewitched,6/21/2005,85000000,131426169,46426169,672600.6601842374
School of Rock,10/3/2003,35000000,131282949,96282949,709637.5621621622
Blade,8/21/1998,45000000,131183530,86183530,801855.3178484108
Unknown,2/16/2011,30000000,130786397,100786397,585260.4500888274
Cloud Atlas,10/26/2012,102000000,130482868,28482868,566772.2232116098
Munich,12/22/2005,70000000,130358911,60358911,657382.3045890065
Man on Fire,4/23/2004,70000000,130293714,60293714,689020.1692226336
Jingle All the Way,11/15/1996,60000000,129832389,69832389,818615.315258512
Julie & Julia,8/6/2009,40000000,129540499,89540499,600185.7862987296
Resident Evil: Apocalypse,9/10/2004,45000000,129394835,84394835,681384.0705634544
Atonement,8/29/2007,30000000,129266061,99266061,620010.8446448271
Cheaper by the Dozen 2,12/21/2005,60000000,129181830,69181830,651446.4447806354
Mean Girls,4/30/2004,17000000,129042871,112042871,682405.452141724
About a Boy,4/26/2002,27000000,129000000,102000000,717463.8487208008
Blade: Trinity,12/8/2004,65000000,128905366,63905366,677379.7477666842
Space Cowboys,7/31/2000,65000000,128884132,63884132,745857.2453703703
The Talented Mr. Ripley,12/25/1999,40000000,128798265,88798265,763022.8969194313
The Nutty Professor,6/26/1996,54000000,128769345,74769345,820186.9108280254
Out of Africa,12/20/1985,31000000,128499205,97499205,1172438.0018248176
Failure to Launch,3/10/2006,50000000,128406887,78406887,642677.1121121121
Pan,9/24/2015,150000000,128388320,-21611680,539814.1592176188
Step Brothers,7/25/2008,65000000,128107642,63107642,584736.7791643464
A Perfect Murder,6/5/1998,60000000,128038368,68038368,785511.4601226994
The Forbidden Kingdom,4/18/2008,55000000,127906624,72906624,590432.733852801
The Adjustment Bureau,3/3/2011,50200000,127869379,77669379,572206.9880564021
Chi bi,7/10/2008,80341000,127814609,47473609,581070.5797312288
The Heartbreak Kid,10/5/2007,60000000,127766650,67766650,611510.9411494429
The Woman in Black,2/1/2012,17000000,127730736,110730736,561051.800248613
U-571,4/20/2000,62000000,127666415,65666415,744410.583090379
First Knight,7/7/1995,55000000,127600435,72600435,836724.1639344263
La Marche de l'empereur,1/26/2005,8000000,127392239,119392239,664193.1126173097
Law Abiding Citizen,10/15/2009,53000000,126690726,73690726,586050.9027324831
Lucy,7/14/2014,40000000,126546825,86546825,531151.4165792235
Walking With Dinosaurs,12/18/2013,80000000,126546518,46546518,540991.2874707159
Predators,7/3/2010,40000000,126248813,86248813,579093.7750847434
L.A. Confidential,9/19/1997,35000000,126216940,91216940,781045.4207920792
Sex Tape,7/17/2014,40000000,126069509,86069509,530033.4199418125
This Is the End,6/12/2013,32000000,126041322,94041322,539782.2821022338
Mechanic: Resurrection,8/25/2016,40000000,125729635,85729635,520774.86869791406
Porky's,11/13/1981,4000000,125728258,121728258,1341817.0544290289
I Know What You Did Last Summer,10/17/1997,17000000,125586134,108586134,777623.1207430341
Ender's Game,10/23/2013,110000000,125537191,15537191,538626.7199842107
First Blood,10/22/1982,15000000,125212904,110212904,1277682.693877551
Goldfinger,9/17/1964,2500000,124881062,122381062,4015468.231511254
Ride Along 2,1/14/2016,40000000,124827316,84827316,526884.2796603015
Ray,10/29/2004,40000000,124731534,84731534,653044.6806282722
Coraline,2/5/2009,60000000,124596398,64596398,587184.2991993139
The Thomas Crown Affair,8/6/1999,48000000,124305181,76305181,743896.9539198085
The Help,8/9/2011,25000000,124272124,99272124,548553.814915359
The Time Machine,3/4/2002,80000000,123729176,43729176,691997.6286353467
The Theory of Everything,11/26/2014,15000000,123726688,108726688,526918.0791441663
Blended,5/21/2014,40000000,123494610,83494610,518138.1874021893
The Queen,9/15/2006,15000000,123384128,108384128,608103.1444061113
Nutty Professor II: The Klumps,7/27/2000,84000000,123307945,39307945,713587.6446759258
The Wedding Singer,2/13/1998,18000000,123306987,105306987,761624.3792464484
Big Fish,12/25/2003,70000000,122919055,52919055,663709.8002159827
Escape Plan,10/9/2013,50000000,122915111,72915111,526299.3628664161
The Ten Commandments,10/5/1956,13000000,122700000,109700000,4461818.181818182
Hide and Seek,1/27/2005,25000000,122644820,97644820,639441.188738269
Spirit: Stallion of the Cimarron,5/24/2002,80000000,122563539,42563539,681287.0428015564
Magic Mike XXL,7/1/2015,14800000,122513057,107713057,513350.1093633461
Nanny McPhee,10/21/2005,25000000,122489822,97489822,619887.7631578947
Surrogates,9/24/2009,80000000,122444772,42444772,566409.8030780333
MouseHunt,12/19/1997,38000000,122417389,84417389,757533.3477722773
Invictus,12/10/2009,60000000,122233971,62233971,566031.6602531152
Poltergeist,6/4/1982,10700000,122200000,111500000,1259793.8144329898
Mortal Kombat,8/18/1995,18000000,122195920,104195920,797623.4986945171
Prisoners,9/18/2013,46000000,122126687,76126687,522923.4797427488
Peter Pan,12/25/2003,100000000,121975011,21975011,658612.3704103673
Executive Decision,3/15/1996,55000000,121969216,66969216,783360.4110468851
Deepwater Horizon,9/29/2016,110000000,121790373,11790373,503830.2106904839
Wayne's World,2/14/1992,20000000,121697323,101697323,878047.0634920635
天將雄師,2/19/2015,65000000,121545703,56545703,514764.601747424
Superbad,8/17/2007,20000000,121463226,101463226,582585.3805937935
Starship Troopers,11/6/1997,105000000,121214377,16214377,750553.4179566563
Pride & Prejudice,9/16/2005,28000000,121147947,93147947,608172.4246987952
赤壁 2,1/7/2009,80000000,121059225,41059225,573351.8279081002
Eight Below,2/17/2006,40000000,120455994,80455994,602882.8528528528
Lethal Weapon,3/6/1987,15000000,120207127,105207127,1072320.4906333631
Apocalypto,12/7/2006,40000000,120175290,80175290,595516.7988107037
We Bought a Zoo,12/22/2011,50000000,120081841,70081841,529776.72335826
The Pianist,9/24/2002,35000000,120072577,85072577,662286.690568119
PK,12/18/2014,13000000,120000000,107000000,513463.43926369346
Star Trek: Generations,11/17/1994,38000000,120000000,82000000,801603.2064128257
Rocky V,10/18/1990,42000000,119946358,77946358,896460.0747384154
Intolerable Cruelty,9/2/2003,60000000,119940815,59940815,647628.590712743
Parental Guidance,12/25/2012,25000000,119772232,94772232,520115.65051241964
Road Trip,5/19/2000,16000000,119754278,103754278,694630.3828306264
Lost in Translation,8/31/2003,4000000,119723856,115723856,646457.1058315336
Spy Kids 2: The Island of Lost Dreams,8/7/2002,38000000,119723358,81723358,662553.1710016603
Allied,11/17/2016,85000000,119520023,34520023,495046.31946055207
Blazing Saddles,2/7/1974,2600000,119500000,116900000,2531779.661016949
Fried Green Tomatoes,12/27/1991,11000000,119418501,108418501,864724.8443157133
Sahara,4/6/2005,130000000,119269486,-10730514,612895.6115107914
Beverly Hills Cop III,5/24/1994,50000000,119208989,69208989,805466.1418918918
The Omen,6/6/2006,25000000,119188334,94188334,587424.0216855594
Unfaithful,5/10/2002,50000000,119137784,69137784,662612.8142380422
Fahrenheit 9/11,6/25/2004,6000000,119114517,113114517,628904.524815206
The Shallows,6/24/2016,17000000,119100758,102100758,494958.0181857473
Charlie Wilson's War,12/19/2007,75000000,119000410,44000410,563769.2344134925
Message in a Bottle,2/22/1999,80000000,118880016,38880016,720484.9454545454
The Purge: Election Year,6/29/2016,10000000,118587880,108587880,492826.6037202653
The Pirates! In an Adventure with Scientists!,3/12/2012,60000000,118338361,58338361,515878.3261839994
Beethoven's 2nd,12/14/1993,15000000,118243066,103243066,810994.9657064471
The Saint,4/3/1997,68000000,118063304,50063304,736974.43196005
Why Him?,12/22/2016,38000000,118034273,80034273,486059.788584206
Star Trek: Insurrection,12/10/1998,70000000,118000000,48000000,719951.1897498474
風立ちぬ,7/20/2013,30000000,117932401,87932401,504249.67397392646
Pompeii,2/18/2014,130000000,117831631,-12168369,498667.4636997287
Disturbia,4/12/2007,20000000,117760134,97760134,569753.8004509255
Blue Streak,9/17/1999,65000000,117758500,52758500,700109.9881093936
Final Destination 3,2/10/2006,25000000,117719158,92719158,592446.6935078007
Now You See Me,5/29/2013,75000000,117698894,42698894,504055.1510894889
The Client,7/20/1994,45000000,117615211,72615211,789363.8322147651
The Forgotten,9/24/2004,42000000,117575636,75575636,615901.7077003666
A Knight's Tale,5/11/2001,65000000,117487473,52487473,661156.2915025324
Dennis the Menace,6/23/1993,35000000,117270765,82270765,812124.4113573406
Rocky,11/21/1976,1000000,117235147,116235147,2014349.6048109964
Jackass 3D,10/15/2010,20000000,117224271,97224271,535977.9389239681
Corpse Bride,9/9/2005,40000000,117195061,77195061,589512.3792756539
Horrible Bosses,7/8/2011,35000000,117000000,82000000,517877.85164791386
Warm Bodies,1/31/2013,35000000,116980662,81980662,503866.46623536607
The Piano,5/19/1993,7000000,116700000,109700000,808171.7451523546
The Siege,11/6/1998,70000000,116672912,46672912,711420.1951219512
S.W.A.T.,8/8/2003,80000000,116643346,36643346,631870.7800650054
The First Wives Club,9/20/1996,26000000,116400000,90400000,735312.697409981
Sliver,5/21/1993,40000000,116300000,76300000,805401.6620498615
Casino,11/22/1995,52000000,116112375,64112375,756432.4104234527
Diamonds Are Forever,12/13/1971,7200000,116019547,108819547,2822860.0243309
The Towering Inferno,12/14/1974,14000000,116000000,102000000,2235067.4373795763
The Butler,8/16/2013,25000000,115922175,90922175,495078.66785679205
The Chronicles of Riddick,6/11/2004,105000000,115772733,10772733,610293.7954665262
A Nightmare on Elm Street,4/30/2010,35000000,115664037,80664037,530136.1136319885
The Notebook,6/25/2004,29000000,115603229,86603229,610365.5174234424
Closer,12/1/2004,27000000,115505027,88505027,606962.8323699422
Pitch Perfect,9/28/2012,17000000,115350426,98350426,498668.1739777016
DragonHeart,5/31/1996,57000000,115267375,58267375,735592.6930440333
The Blues Brothers,6/17/1980,27000000,115229890,88229890,1393348.1257557436
Get Shorty,10/20/1995,30250000,115101622,84851622,749359.5182291667
Dear John,2/4/2010,25000000,114977104,89977104,530481.5609414001
The Iron Lady,12/30/2011,13000000,114956699,101956699,507165.6365120332
Freddy vs. Jason,8/15/2003,30000000,114908830,84908830,622474.7020585049
The Lake House,6/16/2006,40000000,114830111,74830111,564275.7297297297
Bride Wars,1/9/2009,30000000,114663461,84663461,543060.6792552915
We Were Soldiers,3/1/2002,75000000,114660784,39660784,641279.552572707
Office Christmas Party,11/25/2016,45000000,114501299,69501299,474259.00046389876
Hope Springs,8/7/2012,30000000,114281051,84281051,496056.7195794756
Step Up,8/11/2006,12000000,114194847,102194847,560053.1976459048
Seventh Son,12/12/2014,95000000,114178613,19178613,486255.4426519939
Water for Elephants,3/15/2011,38000000,114156230,76156230,510841.5560239319
The Collector,7/9/2009,3400000,114000000,110600000,529368.3335577731
Coyote Ugly,7/30/2000,45000000,113916474,68916474,659238.8541666666
Saw V,10/23/2008,10800000,113857533,103057533,535989.327998117
Insomnia,5/24/2002,46000000,113714830,67714830,632100.2223457476
Judge Dredd,6/30/1995,90000000,113493481,23493481,744219.5475409837
Species,7/7/1995,35000000,113374103,78374103,743436.7409836065
Striptease,6/28/1996,50000000,113309743,63309743,721718.1082802548
Body of Lies,10/10/2008,70000000,113280098,43280098,523057.34325146716
Rambo,1/24/2008,50000000,113244290,63244290,534945.8413835128
White Chicks,6/23/2004,37000000,113086475,76086475,597077.4815205913
Changeling,1/30/2008,55000000,113020255,58020255,533887.5399753416
The Reader,12/10/2008,32000000,113019290,81019290,537603.4115341438
The Pacifier,3/4/2005,56000000,113006880,57006880,584619.1412312468
The Rocky Horror Picture Show,8/14/1975,1200000,112892319,111692319,2079048.232044199
Saving Mr. Banks,11/16/2013,35000000,112544580,77544580,482922.3897120348
Cats & Dogs 2 : The Revenge of Kitty Galore,7/30/2010,85000000,112483764,27483764,515243.1565832386
Tooth Fairy,1/14/2010,48000000,112462508,64462508,519009.0222302214
How to Be Single,1/21/2016,38000000,112343513,74343513,473801.35463981004
Abraham Lincoln: Vampire Hunter,6/20/2012,69000000,112265139,43265139,490018.24062434526
명량,7/30/2014,9500000,112156811,102656811,471540.3318029699
Frankenstein,11/4/1994,45000000,112006296,67006296,748205.0501002005
Doctor Zhivago,12/22/1965,11000000,111858363,100858363,3517558.5849056602
Get Hard,3/26/2015,40000000,111811453,71811453,472577.87649144756
You Only Live Twice,6/12/1967,9500000,111584787,102084787,3350894.5045045046
Underworld: Evolution,1/12/2006,50000000,111340801,61340801,561476.555723651
Fool's Gold,2/7/2008,70000000,111231041,41231041,525435.61194749
The Secret of My Success,4/10/1987,12000000,110996879,98996879,984888.0124223602
Sea of Love,9/15/1989,19000000,110879513,91879513,887036.104
Captain Underpants: The First Epic Movie,6/1/2017,38000000,110824373,72824373,452427.4785164622
The Dukes of Hazzard,8/5/2005,50000000,110803676,60803676,564173.5030549899
The Net,7/28/1995,22000000,110627965,88627965,723531.4911706998
Freaky Friday,8/3/2003,26000000,110230332,84230332,597130.7258938245
Moneyball,9/22/2011,50000000,110206216,60206216,486731.4250886623
Free Birds,10/30/2013,55000000,110000000,55000000,471963.23835430713
Billy Elliot,5/18/2000,5000000,110000000,105000000,638051.0440835267
The 5th Wave,1/14/2016,38000000,109906372,71906372,463904.3880531496
Return to Never Land,2/14/2002,20000000,109862682,89862682,617900.3487064117
The Prestige,10/19/2006,40000000,109676311,69676311,544299.3101736973
Treasure Planet,11/26/2002,140000000,109578115,-30421885,605738.6124930901
Sideways,10/22/2004,16000000,109502303,93502303,573310.4869109947
The 40 Year Old Virgin,8/11/2005,26000000,109449237,83449237,557277.1741344195
The Game,9/12/1997,50000000,109423648,59423648,678806.7493796527
Earth,4/22/2007,15000000,109000000,94000000,524166.98325070087
One Flew Over the Cuckoo's Nest,11/18/1975,3000000,108981275,105981275,1963626.5765765766
Transporter 3,11/26/2008,30000000,108979549,78979549,518387.41271381546
The Purge: Anarchy,7/17/2014,9000000,108782847,99782847,457355.1914635992
Neighbors 2: Sorority Rising,5/4/2016,35000000,108758521,73758521,452728.5256983961
Sanctum,2/3/2011,30000000,108609310,78609310,490758.6677450985
Cinderella Man,6/2/2005,88000000,108539911,20539911,558045.8149100257
Confessions of a Shopaholic,2/5/2009,40000000,108332743,68332743,510538.72182399983
10 Cloverfield Lane,3/10/2016,15000000,108286421,93286421,454732.7574622478
The Boxtrolls,9/10/2014,60000000,108255770,48255770,454796.9382139301
The Man from U.N.C.L.E.,8/13/2015,75000000,108145109,33145109,453788.7049128048
Hidalgo,3/5/2004,100000000,108103450,8103450,576859.3916755603
The Amityville Horror,4/15/2005,19000000,108047131,89047131,555226.7780061666
Three Kings,9/27/1999,75000000,108000000,33000000,642092.7467300833
Arthur et les Minimoys,12/13/2006,86000000,107944236,21944236,534907.0168483647
The American President,11/17/1995,62000000,107879496,45879496,702798.019543974
Horrible Bosses 2,11/26/2014,42000000,107670357,65670357,458538.5627651057
Paul Blart: Mall Cop 2,4/16/2015,38000000,107597242,69597242,452459.9650974538
A League of Their Own,7/1/1992,40000000,107458785,67458785,764831.2099644128
Ace Ventura: Pet Detective,2/4/1994,15000000,107217396,92217396,730861.5950920247
Shaft,6/15/2000,46000000,107196498,61196498,621789.4315545243
ParaNorman,8/3/2012,60000000,107139399,47139399,465057.14062479656
The Texas Chainsaw Massacre,10/17/2003,9500000,107071655,97571655,580334.1734417344
Nell,12/23/1994,31000000,106683817,75683817,709805.8349966733
The Whole Nine Yards,2/18/2000,41300000,106371651,65071651,621329.7371495328
Race to Witch Mountain,3/12/2009,50000000,106303988,56303988,499762.53002928884
Kramer vs. Kramer,12/18/1979,8000000,106260000,98260000,1365809.7686375321
About Schmidt,12/13/2002,30000000,105834556,75834556,585044.5328911
Life As We Know It,10/2/2010,38000000,105610124,67610124,482875.22804065637
The Brothers Grimm,8/26/2005,88000000,105316267,17316267,529759.8943661972
Gangster Squad,1/10/2013,60000000,105200903,45200903,456839.0785131145
Hereafter,10/15/2010,50000000,105197635,55197635,480989.2277937552
Along Came a Spider,4/6/2001,60000000,105178561,45178561,594565.0706613905
Forgetting Sarah Marshall,4/17/2008,30000000,105173115,75173115,485492.0556519812
Sisters,12/18/2015,30000000,105011053,75011053,443241.71014199127
Planet 51,11/19/2009,70000000,104945765,34945765,485974.7671904014
The Graduate,12/21/1967,3000000,104945305,101945305,3077574.926686217
Alien,5/25/1979,11000000,104931801,93931801,1451338.8796680497
Training Day,10/5/2001,45000000,104876233,59876233,590187.0174451323
The Hitchhiker's Guide to the Galaxy,1/15/2005,50000000,104478416,54478416,547867.9391714735
Chappie,3/4/2015,49000000,104399548,55399548,442148.01858384965
Vacation,7/28/2015,31000000,104384188,73384188,438007.46907467395
Män som hatar kvinnor,2/27/2009,13000000,104345682,91345682,490556.02724849444
Under Siege 2: Dark Territory,7/13/1995,60000000,104324083,44324083,684092.3475409836
Insidious: Chapter 3,6/4/2015,10000000,104303851,94303851,437079.8070717991
The Cell,8/17/2000,33000000,104155843,71155843,599630.6447898677
Home on the Range,4/2/2004,110000000,103951461,-6048539,552933.3031914893
Saw,10/1/2004,1200000,103911669,102711669,544325.1388161341
Snake Eyes,8/7/1998,73000000,103891409,30891409,635810.3365973072
Dick Tracy,6/15/1990,47000000,103738726,56738726,798604.5111624326
Ouija,10/24/2014,5000000,103590271,98590271,438661.15747974813
Birdman,8/27/2014,18000000,103215094,85215094,433620.38558002946
Working Girl,12/20/1988,28000000,103173635,75173635,851970.5615194055
She's All That,1/29/1999,10000000,103166989,93166989,627154.9483282674
The Water Horse,12/25/2007,40000000,103071443,63071443,488305.11180595035
Transcendence,4/16/2014,100000000,103039258,3039258,433120.04203446826
Resident Evil,3/15/2002,33000000,102984862,69984862,575977.9753914989
Just Like Heaven,9/16/2005,58000000,102854431,44854431,516337.50502008037
The Cable Guy,6/10/1996,47000000,102825796,55825796,656195.2520740269
Love & Other Drugs,11/22/2010,30000000,102820008,72820008,469114.3220837763
Primal Fear,4/3/1996,30000000,102616183,72616183,656533.4804862443
Zombieland,10/7/2009,23600000,102391382,78791382,473646.04930219223
U.S. Marshals,3/6/1998,60000000,102367405,42367405,631118.4032059186
Dawn of the Dead,3/19/2004,28000000,102356381,74356381,544448.835106383
Butch Cassidy and the Sundance Kid,9/23/1969,6000000,102308889,96308889,2742865.6568364613
Mary Poppins,8/27/1964,6000000,102272727,96272727,3288512.122186495
John Q,2/15/2002,36000000,102244770,66244770,575054.9493813273
鐵道飛虎,12/23/2016,50000000,102205175,52205175,420876.2801691656
Sultan,7/6/2016,10400000,102000000,91600000,423890.819023555
The Stepford Wives,6/10/2004,90000000,102000000,12000000,537691.0911966263
The Other Woman,10/28/2010,30000000,102000000,72000000,466172.7672838124
The Aviator,12/17/2004,116000000,102000000,-14000000,534871.5259570006
The Devil Inside,1/6/2012,1000000,101758490,100758490,448937.81571923324
Journey to the Center of the Earth,7/10/2008,45000000,101702060,56702060,462357.74944991
Timecop,9/15/1994,27000000,101646581,74646581,680365.3346720214
Pineapple Express,8/6/2008,27000000,101624843,74624843,463858.22462412016
Little Man,8/31/2006,64000000,101595121,37595121,500715.23410547065
Just Married,1/9/2003,18000000,101564935,83564935,558970.47330765
Mars Attacks!,12/12/1996,70000000,101371017,31371017,639161.5195460278
Heaven is for Real,4/16/2014,12000000,101332962,89332962,425947.71752837324
The Time Traveler's Wife,8/14/2009,39000000,101229792,62229792,469016.8926119147
Joy,12/24/2015,60000000,101134059,41134059,426877.28562021983
功夫,2/10/2004,20000000,100914445,80914445,541968.0182599355
Courage Under Fire,7/4/1996,46000000,100860818,54860818,642425.5923566879
Fight Club,10/15/1999,63000000,100853753,37853753,599606.1414982164
My Bloody Valentine,1/16/2009,15000000,100734718,85734718,474731.57926981564
Life,3/22/2017,58000000,100541806,42541806,411173.56987453176
Tammy,7/2/2014,20000000,100525432,80525432,421932.55823714583
Little Miss Sunshine,7/26/2006,8000000,100523181,92523181,493002.35899950954
The Rugrats Movie,11/20/1998,30000000,100491683,70491683,613128.0231848689
Airport,3/5/1970,10000000,100489151,90489151,2630606.047120419
Any Given Sunday,12/16/1999,55000000,100230832,45230832,593784.5497630332
The Hunchback of Notre Dame,6/21/1996,100000000,100138851,138851,637827.076433121
Philomena,11/1/2013,12000000,100129872,88129872,429614.7149556569
Where the Wild Things Are,10/16/2009,100000000,100086793,86793,462657.94388203206
Nim's Island,4/3/2008,37000000,100076342,63076342,465854.8758745572
Don't Say a Word,9/28/2001,50000000,100020092,50020092,562859.2684299381
Baahubali: The Beginning,7/10/2015,40000000,100000000,60000000,419016.65172173944
Spice World,12/19/1997,25000000,100000000,75000000,618811.8811881188
Dilwale Dulhania Le Jayenge,10/20/1995,13200000,100000000,86800000,651041.6666666667
Conan the Destroyer,6/29/1984,18000000,100000000,82000000,960614.7934678195
Mad Max,4/12/1979,400000,100000000,99600000,1416430.59490085
Project X,3/1/2012,12000000,100000000,88000000,435934.99337378814
Hitman,11/21/2007,24000000,99965753,75965753,475945.80452874745
Street Fighter,12/22/1994,35000000,99423521,64423521,661500.4723885562
The Lucky One,4/19/2012,25000000,99357138,74357138,432335.3044840415
Hellboy,4/2/2004,66000000,99318987,33318987,528292.4840425532
Blue Jasmine,7/25/2013,18000000,99206215,81206215,424181.15077583515
No se Aceptan Devoluciones,7/20/2013,5500000,99067206,93567206,423586.7827960851
7Aum Arivu,10/26/2011,16000000,98900000,82900000,437165.7163064139
Black Mass,9/4/2015,53000000,98837872,45837872,415381.1679169556
The Visit,9/10/2015,5000000,98450062,93450062,413751.3374939587
Justin Bieber: Never Say Never,2/11/2011,13000000,98441954,85441954,444816.7675060662
Crash,1/13/2004,6500000,98410061,91910061,531371.8196544277
Evolution,6/8/2001,80000000,98376292,18376292,552675.797752809
Riddick,9/2/2013,38000000,98337295,60337295,419977.4289021093
Predator,6/11/1987,18000000,98235548,80235548,865511.4361233481
Once Upon a Time in Mexico,9/11/2003,29000000,98185582,69185582,530159.7300215983
Killers,6/4/2010,75000000,98159963,23159963,450347.36310875596
The Thin Red Line,12/25/1998,52000000,98126565,46126565,597240.2008520998
Bajrangi Bhaijaan,7/17/2015,14000000,98000000,84000000,411218.7180046661
Are We There Yet?,1/20/2005,32000000,97918663,65918663,510524.8331595412
Fred Claus,11/3/2007,100000000,97838349,-2161651,465504.54616822966
Phone Booth,9/9/2002,13000000,97837138,84837138,540536.6740331491
Silent Hill,4/21/2006,50000000,97607453,47607453,482012.1135802469
Safe Haven,2/7/2013,28000000,97594140,69594140,420363.61913458473
The Man with the Golden Gun,12/1/1974,7000000,97572000,90572000,1880000.0
The Little Prince,7/29/2015,64000000,97571250,33571250,409419.6361133957
Paul,2/14/2011,40000000,97552050,57552050,440795.6748256962
Evil Dead,4/5/2013,17000000,97542952,80542952,419483.64734164474
The Book of Life,10/1/2014,50000000,97437106,47437106,410377.2685347024
Scream 4,4/11/2011,40000000,97138686,57138686,431907.93487056816
Insidious,9/13/2010,1500000,97009150,95509150,444101.7858532588
Enemy at the Gates,3/13/2001,68000000,96976270,28976270,550376.1066969354
Star Trek VI: The Undiscovered Country,12/5/1991,27000000,96900000,69900000,702683.1036983321
Jarhead,11/4/2005,72000000,96889998,24889998,490333.9979757085
Star Trek II: The Wrath of Khan,6/3/1982,12000000,96800000,84800000,997938.1443298969
The Jewel of the Nile,12/4/1985,25000000,96773200,71773200,885390.6678865508
8MM,2/26/1999,40000000,96618699,56618699,585567.8727272727
Calendar Girls,9/2/2003,10000000,96542059,86542059,521285.4157667387
13 Going on 30,4/13/2004,37000000,96455697,59455697,513062.2180851064
Vicky Cristina Barcelona,8/15/2008,15000000,96408652,81408652,440049.3504833718
Paycheck,12/25/2003,60000000,96269812,36269812,519815.39956803457
Kick-Ass,3/22/2010,28000000,96188903,68188903,441215.2846900816
The Manchurian Candidate,7/30/2004,80000000,96105964,16105964,507155.4828496042
The Manchurian Candidate,10/24/1962,80000000,96105910,16105910,3161378.6184210526
The 6th Day,11/17/2000,82000000,96085477,14085477,552215.3850574712
Think Like a Man,4/16/2012,12000000,96070507,84070507,418034.1013423841
The Butterfly Effect,1/22/2004,13000000,96060858,83060858,515901.49301826
The Rite,1/28/2011,37000000,96047633,59047633,433997.8627168348
Metropolis,5/26/2001,14500000,95789342,81289342,538142.3707865168
My Sister's Keeper,6/26/2009,30000000,95714875,65714875,444459.85855649615
Underworld,9/19/2003,22000000,95708457,73708457,517343.01081081084
Shooter,3/22/2007,61000000,95696996,34696996,463006.6671182373
Norbit,2/8/2007,60000000,95673607,35673607,470142.88522302324
TMNT,3/23/2007,34000000,95608995,61608995,462580.8956581481
Arthur,7/17/1981,7000000,95461682,88461682,1034254.4095341279
Poltergeist,5/20/2015,35000000,95437994,60437994,399927.8991610724
Dolphin Tale,9/23/2011,37000000,95404397,58404397,421358.42965095997
"\"金陵十三�?\"\"A Westerner finds refuge with a group of women in a church during Japan's rape of Nanking in 1937. Posing as a priest\"",12/15/2011,94000000,95311434,1311434,422344.96969052433
Be Cool,3/4/2005,53000000,95226116,42226116,492633.8127263321
The Princess Diaries 2: Royal Engagement,8/6/2004,40000000,95149435,55149435,502107.8364116095
42,4/12/2013,40000000,95020213,55020213,408634.6035582352
Captain Phillips,10/10/2013,55000000,95000000,40000000,406772.11341662885
Changing Lanes,4/7/2002,45000000,94935764,49935764,528007.5862068965
Green Zone,3/11/2010,100000000,94882889,-5117111,435980.5772155621
The Wedding Planner,1/26/2001,35000000,94728529,59728529,538842.5995449374
1408,7/12/2007,25000000,94679598,69679598,454536.9780939899
Dirty Grandpa,1/21/2016,11500000,94073028,82573028,396746.7894783456
Ben-Hur,8/17/2016,100000000,94061311,-5938689,389603.98545322
The Crow,5/11/1994,15000000,94000000,79000000,637288.1355932204
Syriana,11/23/2005,50000000,94000000,44000000,477642.2764227642
Speed Racer,5/9/2008,120000000,93945766,-26054234,433665.22951364523
Forces of Nature,3/12/1999,75000000,93888180,18888180,569019.2727272727
In the Heart of the Sea,11/20/2015,100000000,93820758,-6179242,396663.17725399
Racing Stripes,1/6/2005,30000000,93772522,63772522,491727.9601468275
Bicentennial Man,12/17/1999,100000000,93700000,-6300000,555094.7867298578
The Fighter,12/17/2010,25000000,93617009,68617009,425100.9612983203
The Lovely Bones,12/26/2009,65000000,93525586,28525586,431616.0452634445
Cats & Dogs,7/4/2001,60000000,93375151,33375151,526057.1887323944
Two Weeks Notice,12/19/2002,60000000,93354918,33354918,513786.0099064392
Money Monster,5/12/2016,27000000,93282604,66282604,388307.00706409296
Nanny McPhee and the Big Bang,3/26/2010,35000000,93246388,58246388,427718.06668532034
Michael Clayton,9/28/2007,25000000,92991835,67991835,445073.2999578818
Flashdance,4/14/1983,4000000,92921203,88921203,942405.7099391482
Secret Window,3/12/2004,40000000,92913171,52913171,495801.33938100317
When Harry Met Sally...,7/21/1989,16000000,92823546,76823546,744972.27929374
No Reservations,7/25/2007,28000000,92601050,64601050,445375.0775549859
I Am Sam,12/28/2001,22000000,92542418,70542418,522543.29757199326
Role Models,2/3/2008,28000000,92380927,64380927,436391.03324153373
Four Brothers,8/11/2005,45000000,92374674,47374674,470339.48065173114
Old Dogs,11/24/2009,35000000,92219310,57219310,427042.07937985356
Der Untergang,9/8/2004,18339750,92180910,73841160,485418.16745655605
The Skeleton Key,7/29/2005,43000000,91974818,48974818,468303.55397148675
Behind Enemy Lines,11/17/2001,40000000,91753202,51753202,519259.77362761745
Southpaw,6/15/2015,30000000,91709827,61709827,384305.21124045626
Friday the 13th,2/11/2009,19000000,91379051,72379051,430641.2134236285
Underworld: Rise of the Lycans,1/22/2009,35000000,91353501,56353501,430520.80417355895
White Noise,1/7/2005,10000000,91196419,81196419,478219.2920818039
The Haunting,7/23/1999,80000000,91188905,11188905,545714.5721125075
Save the Last Dance,1/12/2001,13000000,91038276,78038276,519921.6219303255
Romeo Must Die,3/20/2000,25000000,91036760,66036760,531446.3514302393
"\"धू�?�?\"\"To avenge his father's death\"",12/18/2013,19500000,91000000,71500000,389028.54015971546
Fantasia 2000,12/17/1999,80000000,90874570,10874570,538356.4573459715
The Karate Kid,6/22/1984,8000000,90815558,82815558,872387.6849183477
Drag Me to Hell,3/15/2009,30000000,90810892,60810892,426925.48035108997
Galaxy Quest,12/23/1999,45000000,90683916,45683916,537226.990521327
King Kong,9/8/1976,23000000,90614445,67614445,1573167.4479166665
Anchorman: The Legend of Ron Burgundy,7/9/2004,26000000,90574188,64574188,478216.40971488913
The Mortal Instruments: City of Bones,8/21/2013,60000000,90565421,30565421,386785.42722796166
Hairspray,7/13/2007,50000000,90450008,40450008,434231.5997676417
Bring It On,8/25/2000,28000000,90449929,62449929,520724.97985031665
Final Destination 2,1/31/2003,26000000,90426405,64426405,493863.48989623156
Trading Places,6/7/1983,40600000,90400000,49800000,908542.7135678392
Bedazzled,10/19/2000,48000000,90383208,42383208,519145.36473291216
Identity,4/25/2003,30000000,90259536,60259536,491877.5803814714
Rush,9/2/2013,38000000,90247624,52247624,385428.18461748713
Get Him to the Greek,6/4/2010,40000000,90029656,50029656,413046.3881815888
Valerian and the City of a Thousand Planets,7/20/2017,197471676,90024292,-107447384,366669.3494189859
Atomic Blonde,7/26/2017,30000000,90007945,60007945,366602.76801388076
The Abyss,8/9/1989,70000000,90000098,20000098,722312.1829855538
Enter the Dragon,8/17/1973,850000,90000000,89150000,1991150.442477876
Patton,1/25/1970,12000000,89800000,77800000,2363157.8947368423
Sucker Punch,3/24/2011,82000000,89792502,7792502,399244.58218100003
Burlesque,11/23/2010,55000000,89519773,34519773,408432.25400243636
Apocalypse Now,8/15/1979,31500000,89460381,57960381,1212200.2845528456
The Long Kiss Goodnight,10/11/1996,65000000,89456761,24456761,565109.0397978522
The Purge,5/31/2013,3000000,89328627,86328627,382557.15962039196
The Lone Ranger,7/3/2013,255000000,89289910,-165710090,382240.74898542784
Red Riding Hood,3/11/2011,42000000,89162162,47162162,398994.75985268515
Rumor Has It...,12/23/2005,70000000,88933562,18933562,448479.88905698434
My Big Fat Greek Wedding 2,3/23/2016,18000000,88923251,70923251,371657.9425815323
The Hundred-Foot Journey,8/6/2014,22000000,88880821,66880821,373681.2009148546
John Wick,10/22/2014,20000000,88761661,68761661,375868.2410830358
The Cider House Rules,12/17/1999,24000000,88545092,64545092,524556.2322274881
괴물,7/27/2006,11000000,88489643,77489643,433985.4977930358
Spotlight,11/6/2015,20000000,88346473,68346473,372242.192503455
Shanghai Knights,2/6/2003,50000000,88323487,38323487,482378.41070453305
Season of the Witch,1/7/2011,40000000,88100000,48100000,400049.0411991481
This Is 40,12/20/2012,35000000,88058786,53058786,382398.75803369813
The Hand that Rocks the Cradle,1/10/1992,11700000,88036683,76336683,637485.0325850833
Jaws 3-D,3/16/1983,20500000,87987055,67487055,892363.6409736308
Spawn,7/31/1997,40000000,87840042,47840042,546268.9179104477
State of Play,4/17/2009,60000000,87784194,27784194,410482.72669459827
Gosford Park,11/7/2001,19800000,87754044,67954044,494667.6662908681
Ali,12/11/2001,107000000,87713825,-19286175,496399.688737974
RV,4/28/2006,50000000,87528173,37528173,432237.8913580247
Collateral Beauty,12/6/2016,36000000,87416021,51416021,362073.05162530235
Peter Pan,2/5/1953,4000000,87404651,83404651,3298288.716981132
About Time,8/16/2013,12000000,87100449,75100449,371987.27733195527
Old School,2/21/2003,24000000,87055349,63055349,472613.1867535288
Star Trek III: The Search for Spock,5/31/1984,18000000,87000000,69000000,838958.5342333654
The Naked Gun 2½: The Smell of Fear,6/28/1991,23000000,86930411,63930411,638255.5873715125
The Illusionist,8/18/2006,40000000,86915017,46915017,428363.8097585017
Epic Movie,1/25/2007,20000000,86865564,66865564,426859.90594548377
Snowpiercer,8/1/2013,39200000,86758912,47558912,370959.5727668817
The Kingdom,8/22/2007,70000000,86658558,16658558,415648.5107199386
Romancing the Stone,3/30/1984,10000000,86572238,76572238,839691.9301648885
Dinner for Schmucks,7/30/2010,69000000,86387857,17387857,395708.23866759497
Sky High,7/29/2005,35000000,86369815,51369815,439764.8421588595
Paranormal Activity: The Marked Ones,1/1/2014,5000000,86362372,81362372,369202.5000427504
Young Frankenstein,12/15/1974,2800000,86273333,83473333,1662299.2870905588
War Dogs,8/17/2016,40000000,86234523,46234523,357185.2602017993
Pain & Gain,4/18/2013,25000000,86175291,61175291,369938.35884006956
Step Up All In,7/16/2014,45000000,86165646,41165646,362265.80394531053
The Second Best Exotic Marigold Hotel,2/26/2015,10000000,85978266,75978266,364131.0779733948
Tears of the Sun,3/7/2003,70000000,85632458,15632458,464888.4799131379
Volver,3/16/2006,12899867,85582407,72682540,424726.58560794045
Spy Kids: All the Time in the World,8/18/2011,27000000,85564310,58564310,377119.69288947457
Paper Towns,6/18/2015,12000000,85512300,73512300,358310.776270249
Rat Race,7/30/2001,48000000,85498534,37498534,481681.8816901409
The Possession,8/30/2012,14000000,85446075,71446075,369245.85254551505
Max Payne,10/15/2008,35000000,85416905,50416905,394402.37241022656
The Lincoln Lawyer,3/17/2011,40000000,85412898,45412898,379771.54011009046
Match Point,10/26/2005,15000000,85306374,70306374,431712.4190283401
Stripes,6/25/1981,10000000,85300000,75300000,931222.7074235808
Did You Hear About the Morgans?,12/17/2009,58000000,85280250,27280250,393564.21935787564
Nerve,7/27/2016,19000000,85241496,66241496,353920.9047992726
Transporter 2,8/2/2005,32000000,85167639,53167639,433643.783095723
Final Fantasy: The Spirits Within,7/2/2001,137000000,85131830,-51868170,479615.94366197183
Das Boot,9/16/1981,14000000,85000000,71000000,910064.2398286937
猛龍過江,6/1/1972,130000,85000000,84870000,2038369.3045563549
Zodiac,3/2/2007,65000000,84785914,19785914,412880.87771241576
The Animal,6/1/2001,22000000,84772742,62772742,476251.3595505618
Meet the Spartans,1/24/2008,30000000,84646831,54646831,399856.54225694755
Going in Style,4/6/2017,25000000,84618541,59618541,346054.1337455628
J. Edgar,11/9/2011,35000000,84606030,49606030,373982.3630818194
Made of Honor,5/2/2008,40000000,84601681,44601681,390531.7820081982
Never Been Kissed,4/9/1999,25000000,84565230,59565230,508816.0649819495
The Poseidon Adventure,12/1/1972,5000000,84563118,79563118,1989720.4235294117
大鱼·海棠,7/8/2016,4531653,84552250,80020597,351381.59316455276
An American Tail,11/21/1986,9000000,84542002,75542002,765085.9909502262
The Santa Clause 3: The Escape Clause,11/1/2006,12000000,84500122,72500122,419355.4441687345
The Land Before Time,11/18/1988,12300000,84460846,72160846,700919.8838174274
Pinocchio,2/23/1940,2600000,84300000,81700000,6021428.571428572
Premonition,2/8/2007,20000000,84146832,64146832,413499.9778868692
Sicario,9/17/2015,30000000,84025816,54025816,353290.1218476442
Marmaduke,6/4/2010,50000000,83761844,33761844,384290.3401922327
The Judge,10/8/2014,50000000,83719388,33719388,352602.15724014776
Snatch,9/1/2000,10000000,83557872,73557872,481047.0466321244
Point Break,7/12/1991,24000000,83531958,59531958,613303.6563876652
Airplane!,7/2/1980,3500000,83453539,79953539,1009111.7170495767
Fantasia,11/13/1940,2280000,83320000,81040000,5951428.571428572
Fiddler on the Roof,11/3/1971,9000000,83304330,74304330,2036780.6845965772
Blow,4/4/2001,53000000,83282296,30282296,470787.4279253816
El laberinto del fauno,5/27/2006,19000000,83258226,64258226,410341.1828486939
Piranha 3D,8/20/2010,24000000,83188165,59188165,380830.186001584
Hall Pass,2/25/2011,36000000,83160734,47160734,372138.76769276895
Rings,2/1/2017,25000000,83080890,58080890,341050.3565227029
Savages,7/6/2012,45000000,82966152,37966152,362133.14477267966
Firewall,2/10/2006,45000000,82800000,37800000,416708.60593860096
28 Days Later,10/31/2002,5000000,82719885,77719885,456259.7076668505
The Constant Gardener,8/31/2005,25000000,82466670,57466670,414822.28370221326
Carrie,10/16/2013,30000000,82394288,52394288,353518.8635125221
The Strangers,5/29/2008,9000000,82391145,73391145,376533.3500902589
Hannibal Rising,2/6/2007,50000000,82169884,32169884,403785.19796166074
Elizabeth,9/13/1998,30000000,82150642,52150642,502143.2885085575
Catwoman,7/22/2004,100000000,82102379,-17897621,433257.93667546177
Abduction,9/22/2011,35000000,82087155,47087155,362542.1449423861
On Her Majesty's Secret Service,12/12/1969,6500000,81974493,75474493,2174389.7347480105
Hitman: Agent 47,8/20/2015,35000000,81967450,46967450,344480.657294753
Ouija: Origin of Evil,10/20/2016,9000000,81705746,72705746,338532.1334311154
M*A*S*H,1/24/1970,3500000,81600000,78100000,2147368.4210526315
Waiting to Exhale,12/22/1995,16000000,81452156,65452156,527539.8704663212
Bei Jing yu shang Xi Ya Tu,3/20/2013,4881000,81350000,76469000,349845.8270080118
Act of Valor,2/24/2012,12000000,81272766,69272766,354296.4270767943
Underworld: Blood Wars,11/28/2016,35000000,81093313,46093313,335884.69217005203
Jimmy Neutron: Boy Genius,12/21/2001,25000000,80936232,55936232,457008.65047995484
The Rundown,9/26/2003,85000000,80916492,-4083508,437386.44324324327
Hostel,1/6/2005,4800000,80578934,75778934,422542.91557420033
Hot Fuzz,2/14/2007,12000000,80573774,68573774,395941.86703620164
Vampires Suck,8/18/2010,20000000,80547866,60547866,368743.0632808244
Muppets Most Wanted,3/20/2014,50000000,80383290,30383290,339066.99230613484
Halloween,8/31/2007,15000000,80253908,65253908,384929.2915727373
Nacho Libre,6/16/2006,32000000,80197993,48197993,394093.33169533167
Runaway Jury,10/9/2003,60000000,80154140,20154140,433265.6216216216
Finding Forrester,12/21/2000,43000000,80049764,37049764,457165.9851513421
Footloose,2/17/1984,8200000,80035402,71835402,780072.1442495127
Lobo Guerreiro,4/2/2015,12000000,80000000,68000000,338124.8441455797
Exit Wounds,3/13/2001,50000000,79958599,29958599,453794.5459704881
The Golden Child,12/12/1986,25000000,79817939,54817939,722334.2895927601
The Wedding Ringer,1/16/2015,23000000,79799880,56799880,339976.1419892468
What to Expect When You're Expecting,5/17/2012,40000000,79700000,39700000,347309.9817847462
Earthquake,11/15/1974,7000000,79666653,72666653,1546925.3009708738
WarGames,6/3/1983,12000000,79567667,67567667,799675.0452261306
Uncle Buck,8/16/1989,15000000,79258538,64258538,634068.304
Conan the Barbarian,4/2/1982,20000000,79114085,59114085,833657.3761854583
Home Alone 3,12/12/1997,32000000,79082515,47082515,490282.1760694358
From Russia with Love,10/11/1963,2000000,78898765,76898765,2561648.214285714
If I Stay,8/21/2014,11000000,78874843,67874843,331363.74253773666
48 Hrs.,12/7/1982,12000000,78868508,66868508,808078.9754098362
The Naked Gun: From the Files of Police Squad!,12/2/1988,12000000,78756177,66756177,653578.2323651452
The Boss,4/7/2016,29000000,78636257,49636257,328663.0792314669
Le Dîner de cons,4/15/1998,12500000,78599508,66099508,483689.28
Collateral Damage,2/6/2002,85000000,78382433,-6617567,440846.07986501686
Scary Movie 5,4/11/2013,20000000,78378744,58378744,337067.9350280178
The Terminator,10/26/1984,6400000,78371200,71971200,744265.9069325736
Priest,5/5/2011,60000000,78309131,18309131,346555.78322210617
K-9,4/28/1989,17000000,78247647,61247647,632048.844911147
Paranormal Activity: The Ghost Dimension,10/21/2015,10000000,78096553,68096553,329054.8125863754
Drive,8/6/2011,15000000,78054825,63054825,344544.4613652917
Exorcist: The Beginning,8/20/2004,80000000,78000586,-1999414,410745.58188520273
Teenage Mutant Ninja Turtles II: The Secret of the Ooze,3/22/1991,25000000,78000000,53000000,576923.076923077
Hostage,3/10/2005,52000000,77944725,25944725,403231.8934299017
The Sentinel,4/19/2006,60000000,77920346,17920346,384791.8320987654
Out of Sight,6/26/1998,48000000,77745568,29745568,476382.1568627451
Showtime,3/14/2002,85000000,77741732,-7258268,434797.158836689
Gandhi,11/30/1982,22000000,77737889,55737889,796494.7643442623
Sinister,3/29/2012,3000000,77712439,74712439,337755.3469370015
Windtalkers,6/14/2002,115000000,77628265,-37371735,431507.8654808227
The Number 23,2/23/2007,30000000,77566815,47566815,377726.12392379914
Serendipity,10/5/2001,28000000,77516304,49516304,436220.0562746202
The Back-Up Plan,4/23/2010,35000000,77477008,42477008,355109.16774376883
The Grey,1/26/2012,25000000,77278331,52278331,339441.7669977115
There Will Be Blood,12/28/2007,25000000,77208711,52208711,365779.37748720864
The Name of the Rose,9/24/1986,20000000,77200000,57200000,699909.3381686311
Diary of a Wimpy Kid: Dog Days,8/2/2012,22000000,77112176,55112176,334718.7721103052
Mike and Dave Need Wedding Dates,7/7/2016,33000000,77068246,44068246,320279.6266436159
シン・ゴジラ,7/29/2016,15000000,77000000,62000000,319702.38614235475
Stealth,7/28/2005,135000000,76932943,-58067057,391715.59572301427
Coach Carter,1/14/2005,30000000,76669806,46669806,402044.07970634504
Bend It Like Beckham,4/11/2002,3500159,76578641,73078482,425910.127919911
The Unborn,1/9/2009,16000000,76514050,60514050,362380.23519605194
Bad Santa,11/26/2003,23000000,76488889,53488889,415023.8144329897
The Road to El Dorado,3/31/2000,95000000,76432727,-18567273,446192.21833041444
United 93,4/28/2006,15000000,76286096,61286096,376721.4617283951
The Untouchables,6/2/1987,25000000,76270454,51270454,671986.3788546255
Next,4/24/2007,70000000,76066841,6066841,365795.6566273461
Ghajini,12/25/2008,9100000,76000000,66900000,359945.6292654741
The Newton Boys,3/26/1998,27000000,76000000,49000000,467692.3076923077
The Ides of March,9/24/2011,12500000,75993061,63493061,335627.2651388343
Cruel Intentions,3/5/1999,10500000,75902208,65402208,460013.38181818184
Superman III,6/17/1983,39000000,75850624,36850624,759265.5055055055
Barbershop,4/1/2002,12000000,75781642,63781642,421477.4304783092
Dreamcatcher,3/21/2003,68000000,75715436,7715436,411944.7007616975
Diary of a Wimpy Kid,3/19/2010,15000000,75700498,60700498,347235.6554087217
The Nightmare Before Christmas,10/9/1993,18000000,75634409,57634409,519110.5628002746
The Rookie,3/25/2002,20000000,75597042,55597042,420450.73414905445
Stomp the Yard,5/16/2007,13000000,75511123,62511123,362420.91748579324
30 Days of Night,10/17/2007,30000000,75505973,45505973,359249.45641054923
The Last of the Mohicans,9/25/1992,40000000,75505856,35505856,532481.3540197461
The Change-Up,8/5/2011,52000000,75450437,23450437,333048.34359619505
The Count of Monte Cristo,1/23/2002,35000000,75395048,40395048,424044.13948256464
Revolutionary Road,12/19/2008,35000000,75225693,40225693,356278.41320811014
Manchester by the Sea,11/18/2016,9000000,75026965,66026965,310758.16378939
The Ghost and the Darkness,10/11/1996,50000000,75000000,25000000,473783.95451674034
Easy A,9/10/2010,8000000,74952305,66952305,343126.9370396312
Edge of Darkness,1/29/2010,80000000,74901339,-5098661,345579.9271942087
The Prince of Tides,12/25/1991,30000000,74787599,44787599,541546.6980448951
Crimson Peak,10/13/2015,55000000,74679822,19679822,313994.49204920995
Random Hearts,10/8/1999,64000000,74608570,10608570,443570.5707491082
Escape from Planet Earth,2/14/2013,40000000,74597643,34597643,321311.66062214103
From Hell,10/19/2001,35000000,74558115,39558115,420282.49718151067
Ladder 49,10/1/2004,60000000,74541707,14541707,390475.1545311681
Elizabeth: The Golden Age,9/9/2007,55000000,74237563,19237563,356072.5358530385
The Core,3/28/2003,60000000,74208267,14208267,403744.6517954298
Hard Target,8/20/1993,18000000,74189677,56189677,511300.3239145417
August: Osage County,12/26/2013,25000000,74188937,49188937,317160.5918363857
Oliver & Company,11/18/1988,31000000,74151346,43151346,615363.867219917
Always,12/22/1989,31000000,74134790,43134790,581905.7299843014
Amistad,12/3/1997,36000000,74000000,38000000,458772.47365158086
The Hurricane,9/17/1999,50000000,73956241,23956241,439692.2770511296
Miracles from Heaven,3/17/2016,16000000,73883359,57883359,308798.1701990713
Obsessed,4/24/2009,20000000,73830340,53830340,345233.89570552146
Death Race,8/22/2008,45000000,73762516,28762516,337149.2117760521
Deep Blue Sea,7/28/1999,60000000,73648228,13648228,440743.43506882107
Life,4/16/1999,80000000,73345029,-6654971,441305.83032490977
Beetlejuice,2/29/1988,15000000,73326666,58326666,629413.4420600858
The Kite Runner,10/14/2007,20000000,73276047,53276047,350710.4902936784
To Rome with Love,4/20/2012,17000000,73244881,56244881,318712.3599416922
Righteous Kill,9/11/2008,60000000,73174566,13174566,334461.8457558403
Perfect Stranger,4/12/2007,60795000,73090611,12295611,353631.1651490667
Hotel for Dogs,1/16/2009,35000000,73034460,38034460,344188.8280951775
Barnyard,8/4/2006,51000000,72779000,21779000,356934.77194703283
Jackass Number Two,9/22/2006,11000000,72778712,61778712,360647.7304261645
The One,11/2/2001,49000000,72700000,23700000,409808.34272829763
The Transporter Refueled,9/3/2015,25000000,72629670,47629670,305237.21868499025
Urban Legend,9/25/1998,14000000,72527595,58527595,442241.43292682926
A Nightmare on Elm Street 4: The Dream Master,8/19/1988,7000000,72500000,65500000,605175.2921535893
Mirrors,8/15/2008,35000000,72436439,37436439,330630.1589330217
Diary of a Wimpy Kid: Rodrick Rules,3/25/2011,21000000,72417394,51417394,321989.60454589914
Vanishing Point,1/15/1971,1300000,72266306,70966306,1815736.3316582916
Eternal Sunshine of the Spotless Mind,3/19/2004,20000000,72258126,52258126,384351.7340425532
The Cannonball Run,6/19/1981,18000000,72179579,54179579,787986.6703056769
Around the World in 80 Days,6/16/2004,110000000,72178895,-37821105,381092.37064413936
Babylon A.D.,8/20/2008,70000000,72108608,2108608,329589.6299072597
My Fair Lady,10/21/1964,17000000,72070731,55070731,2309959.326923077
RED,10/13/2010,58000000,71664962,13664962,327669.67367896443
The Best Man Holiday,11/15/2013,17000000,71625195,54625195,307313.26345417026
Run All Night,3/11/2015,50000000,71561644,21561644,303074.48362901754
What Dreams May Come,10/2/1998,85000000,71485043,-13514957,435884.40853658534
The Royal Tenenbaums,10/5/2001,21000000,71441250,50441250,402032.92065278563
National Lampoon's Christmas Vacation,12/1/1989,27000000,71320000,44320000,565582.8707375099
The Rescuers,6/22/1977,1200000,71215869,70015869,1167473.262295082
xXx: State of the Union,4/27/2005,60000000,71073932,11073932,365606.646090535
The Score,7/13/2001,68000000,71069884,3069884,400393.7126760563
The Counselor,10/25/2013,25000000,71009334,46009334,304670.8657092964
The Dark Tower,8/3/2017,60000000,71000000,11000000,289183.3218610372
Rules of Engagement,4/7/2000,60000000,71000000,11000000,414477.52481027436
Cleopatra,6/12/1963,31115000,71000000,39885000,2320261.4379084967
Anacondas: The Hunt for the Blood Orchid,8/26/2004,20000000,70992898,50992898,373843.5913638757
Groundhog Day,2/11/1993,14600000,70906973,56306973,495506.4500349406
Le Pacte des loups,1/31/2001,29000000,70752904,41752904,402462.4800910125
Firefox,6/13/1982,18000000,70687344,52687344,728735.5051546391
All the President's Men,4/4/1976,8500000,70600000,62100000,1258467.0231729054
The House Bunny,8/22/2008,25000000,70442940,45442940,321976.2961473241
Star Trek V: The Final Frontier,6/9/1989,30000000,70200000,40200000,565672.8444802578
Think Like a Man Too,6/20/2014,24000000,70181428,46181428,294570.5267576075
Ferris Bueller's Day Off,6/11/1986,6000000,70136369,64136369,640514.7853881279
Boomerang,6/30/1992,40000000,70100000,30100000,498932.384341637
A Cinderella Story,7/10/2004,19000000,70067909,51067909,369946.72122492077
3:10 to Yuma,9/6/2007,55000000,70016220,15016220,335825.3153628471
Das Leben der Anderen,3/15/2006,2000000,70000000,68000000,350350.3503503503
3 Idiots,12/23/2009,9000000,70000000,61000000,323046.6063953998
Halloween,10/25/1978,300000,70000000,69700000,1038575.6676557863
Lawrence of Arabia,12/10/1962,15000000,69995385,54995385,2302479.7697368423
Children of Men,9/22/2006,76000000,69959751,-6040249,346678.6471754212
Kubo and the Two Strings,8/18/2016,60000000,69929545,9929545,289649.68851997284
Curious George,2/10/2006,50000000,69834815,19834815,351458.5556114746
21,3/27/2008,35000000,69823199,34823199,325026.64519162284
Splash,3/9/1984,8000000,69821334,61821334,680519.8245614036
The Brave One,9/14/2007,70000000,69766619,-233381,334628.1308456041
The Best Little Whorehouse in Texas,7/23/1982,35000000,69701637,34701637,713425.1484135108
The Kid,7/7/2000,65000000,69700000,4700000,403356.48148148146
Without a Paddle,8/20/2004,19000000,69631118,50631118,366672.5539757767
The Hills Have Eyes,3/10/2006,15000000,69623713,54623713,348467.03203203203
The Adventures of Sharkboy and Lavagirl,6/10/2005,50000000,69425966,19425966,356945.8406169666
13 Hours: The Secret Soldiers of Benghazi,1/13/2016,50000000,69411370,19411370,292978.8194972058
License to Wed,7/4/2007,35000000,69307224,34307224,332729.509023087
Babe: Pig in the City,11/25/1998,90000000,69131860,-20868140,421792.92251372786
Takers,8/26/2010,32000000,69055695,37055695,316132.62741543405
Guess Who,3/25/2005,35000000,68915888,33915888,354141.2538540596
Brick Mansions,4/22/2014,28000000,68896829,40896829,289604.1572089113
House of Wax,4/30/2005,40000000,68766121,28766121,353735.1903292181
The Men Who Stare at Goats,10/17/2009,24000000,68729358,44729358,317706.08792123146
Witness,2/8/1985,12000000,68706993,56706993,648179.179245283
2001: A Space Odyssey,4/10/1968,10500000,68700000,58200000,1997093.023255814
The Sweetest Thing,4/12/2002,43000000,68696770,25696770,382073.2480533926
Land of the Lost,6/5/2009,100000000,68688831,-31311169,318456.46822103637
Letters from Iwo Jima,12/19/2006,19000000,68673228,49673228,339267.7851553237
The Call,3/14/2013,13000000,68572378,55572378,294589.0545724805
Looney Tunes: Back in Action,11/14/2003,80000000,68514844,-11485156,371354.1680216802
Pokémon 3: The Movie,7/8/2000,16000000,68411275,52411275,395898.5821759259
Pokémon 3: The Movie,7/8/2000,16000000,68411275,52411275,395898.5821759259
Purple Rain,7/27/1984,7200000,68392977,61192977,654478.2488038278
Dan in Real Life,10/26/2007,25000000,68377859,43377859,325334.6417543309
The X Files: I Want to Believe,7/24/2008,30000000,68369434,38369434,312066.6496261742
Ghost Ship,10/25/2002,35000000,68349884,33349884,376998.80860452284
Open Range,8/29/2003,22000000,68296293,46296293,368770.4805615551
Star Wars: The Clone Wars,8/5/2008,8500000,68282844,59782844,311671.4167039427
The Watch,7/26/2012,68000000,68267862,267862,296328.4934824789
Moonrise Kingdom,5/16/2012,16000000,68263166,52263166,297471.5048937153
Saw VI,10/22/2009,11000000,68233629,57233629,315414.54721952573
Сталинград,10/9/2013,30000000,68129518,38129518,291717.7686622764
Frequency,4/28/2000,31000000,68106245,37106245,397120.9620991254
ゲド戦記,7/29/2006,22000000,68000000,46000000,333496.8121628249
Legion,1/21/2010,26000000,67918658,41918658,313363.22154091747
Todo sobre mi madre,4/19/1999,8272296,67872296,59600000,408377.2322503009
Son of God,2/28/2014,22000000,67800064,45800064,286932.1731917577
War Room,8/28/2015,3000000,67790117,64790117,284898.2622034504
The Last Exorcism,8/27/2010,1800000,67738090,65938090,310100.71461597976
Austin Powers: International Man of Mystery,5/2/1997,16500000,67683989,51183989,422760.70580886945
Sudden Impact,12/7/1983,22000000,67642693,45642693,667746.2290227049
Bandits,10/12/2001,75000000,67631903,-7368097,380595.96510973555
Jersey Boys,6/5/2014,40000000,67347013,27347013,282563.4191060782
Star Trek: Nemesis,12/13/2002,60000000,67312826,7312826,372099.64621337753
Wild Things,3/20/1998,20000000,67200000,47200000,413538.46153846156
Boogeyman,2/4/2005,20000000,67192859,47192859,350327.73201251304
Coal Miner's Daughter,3/7/1980,15000000,67182787,52182787,838736.4169787766
The Dilemma,1/13/2011,70000000,67112664,-2887336,304748.659313514
प्रे�?रत�?धन पायो,11/11/2015,23400000,67000000,43600000,282300.19887416996
The Giver,8/11/2014,25000000,66980456,41980456,281605.60348451976
Joan of Arc,10/18/1999,60000000,66976317,6976317,397957.91443850263
When a Stranger Calls,2/3/2006,15000000,66966987,51966987,337025.60140915954
The Emoji Movie,7/28/2017,50000000,66913939,16913939,272540.7768848847
Skyline,11/11/2010,10000000,66821036,56821036,305393.6006361887
Selma,12/25/2014,20000000,66787908,46787908,285776.2411908929
Dragnet,6/25/1987,20000000,66673516,46673516,585883.2688927944
The Cabin in the Woods,4/12/2012,30000000,66486080,36486080,288963.1223243584
Not Another Teen Movie,12/7/2001,16000000,66468332,50468332,376164.8670062253
August Rush,11/21/2007,25000000,66122026,41122026,314812.82256375096
Herbie Fully Loaded,6/22/2005,50000000,66002004,16002004,337778.93551688845
Mighty Morphin Power Rangers: The Movie,6/30/1995,15000000,66000000,51000000,432786.88524590165
Bad Company,6/7/2002,70000000,65977295,-4022705,366744.2745969983
Flags of Our Fathers,10/18/2006,90000000,65900249,-24099751,327048.382133995
Scarface,12/8/1983,25000000,65884703,40884703,650391.9348469891
In the Name of the Father,12/12/1993,13000000,65796862,52796862,451281.6323731138
Sweet November,2/16/2001,40000000,65754228,25754228,373179.5005675369
EverAfter,7/31/1998,26000000,65705772,39705772,402116.1077111383
16 Blocks,3/1/2006,55000000,65664721,10664721,328652.25725725724
The Age of Adaline,4/16/2015,25000000,65663276,40663276,276122.3523475116
Benvenuti al sud,10/1/2010,4000000,65584679,61584679,299869.1378119985
Street Kings,4/10/2008,20000000,65569869,45569869,305227.4151278029
Matchstick Men,9/1/2003,62000000,65565672,3565672,354026.30669546436
Deuce Bigalow: Male Gigolo,12/10/1999,17000000,65535067,48535067,389394.3374925728
Taxi 3,1/29/2003,14500000,65497208,50997208,357712.76897870016
Taking Lives,3/19/2004,45000000,65470529,20470529,348247.49468085106
The American,8/31/2010,20000000,65464324,45464324,299691.55691062496
Barbershop 2:  Back in Business,1/20/2004,18000000,65070412,47070412,349465.15574650915
Moonlight,10/21/2016,4000000,65046687,61046687,269508.50828454585
Staying Alive,7/11/1983,22000000,64892670,42892670,649576.2762762762
The Bank Job,2/28/2008,20000000,64822796,44822796,303579.83964632277
The Darkest Hour,12/22/2011,30000000,64626786,34626786,285120.2700019853
Hot Tub Time Machine,3/26/2010,36000000,64572262,28572262,296190.8086363407
Monster Trucks,12/21/2016,125000000,64493915,-60506085,265583.02002561366
Flushed Away,10/22/2006,149000000,64459316,-84540684,319897.3498759305
Miracle,2/6/2004,28000000,64445708,36445708,346110.1396348013
Kiss of the Dragon,7/6/2001,25000000,64437847,39437847,363030.123943662
Fences,12/16/2016,24000000,64414761,40414761,265257.067439744
The Imaginarium of Doctor Parnassus,10/1/2009,30000000,64352607,34352607,297684.79995559197
Sudden Death,12/22/1995,35000000,64350171,29350171,416775.71891191707
Zathura: A Space Adventure,11/6/2005,65000000,64321501,-678499,325513.6690283401
Jackass: The Movie,10/21/2002,5000000,64282312,59282312,354563.221180364
Wag the Dog,12/25/1997,15000000,64256513,49256513,397626.9368811881
28 Weeks Later,4/26/2007,15000000,64238440,49238440,308914.3972801023
The Danish Girl,11/27/2015,15000000,64191523,49191523,271394.241623507
The Boy,1/22/2016,10000000,64188367,54188367,270710.20323814586
The Lazarus Effect,1/29/2015,3300000,64110728,60810728,273134.72107429215
My Cousin Vinny,3/13/1992,11000000,64088552,53088552,460075.7501794687
Baby Mama,4/23/2008,30000000,63833449,33833449,294663.06455186673
Space Chimps,7/17/2008,37000000,63800345,26800345,291211.4192600166
Hanna,4/7/2011,30000000,63782078,33782078,283594.38165277935
High Crimes,4/3/2002,42000000,63781810,21781810,354737.5417130144
What About Bob?,5/17/1991,35000000,63710000,28710000,468455.8823529412
Footloose,10/6/2011,24000000,63543328,39543328,280642.3785779588
Risky Business,8/5/1983,6200000,63541777,57341777,634149.4710578842
Dragon: The Bruce Lee Story,5/7/1993,14000000,63513743,49513743,440455.91539528436
Begin Again,9/7/2013,8000000,63464861,55464861,271044.7663667152
Tango & Cash,12/22/1989,55000000,63408614,8408614,497712.8257456829
Side Effects,2/7/2013,30000000,63372757,33372757,272963.1255222556
The Host,3/22/2013,44000000,63327201,19327201,272338.7462316852
Lions for Lambs,10/22/2007,35000000,63215872,28215872,300774.45200949674
Jeepers Creepers 2,8/8/2003,17000000,63102666,46102666,341834.59371614305
Contraband,1/12/2012,25000000,63100000,38100000,278384.3998852933
The Longest Ride,4/9/2015,34000000,63013281,29013281,266329.44771533273
Unfriended,4/17/2015,1000000,62882090,61882090,264427.1146527617
The Nice Guys,5/15/2016,50000000,62788218,12788218,261368.1861890113
The Reaping,4/5/2007,40000000,62771059,22771059,303702.5197642801
Honey,11/24/2003,18000000,62646763,44646763,339917.32501356484
Runner Runner,9/24/2013,30000000,62616646,32616646,268112.68872085155
The Crying Game,9/2/1992,3705538,62548947,58843409,442667.70700636937
A Fish Called Wanda,7/15/1988,7500000,62493712,54993712,527373.0970464135
Year One,6/18/2009,60000000,62357900,2357900,289564.01409791457
Deux frères,4/7/2004,74500000,62172050,-12327950,330702.39361702127
Down and Out in Beverly Hills,1/31/1986,14000000,62134225,48134225,568474.153705398
Captain Corelli's Mandolin,8/17/2001,57000000,62112895,5112895,348361.72181716206
Brooklyn,10/20/2015,11000000,62076141,51076141,261553.83506926888
Snakes on a Plane,8/6/2006,33000000,62022014,29022014,304178.58754291316
The Rocketeer,6/21/1991,42000000,62000000,20000000,455212.9221732746
எந்திரன்,10/1/2010,26400000,62000000,35600000,283479.1117044867
Chennai Express,8/9/2013,18000000,62000000,44000000,265096.61061156075
I Love Trouble,6/29/1994,45000000,61947267,16947267,417434.4137466307
The 13th Warrior,8/27/1999,160000000,61698899,-98301101,367474.0857653365
R.I.P.D.,7/18/2013,130000000,61648500,-68351500,263593.6838594646
Woman in Gold,4/10/2015,11000000,61619773,50619773,260439.70177388747
Krampus,11/26/2015,15000000,61548707,46548707,260220.7250819152
The Goonies,6/6/1985,19000000,61503218,42503218,571591.2453531598
Flatliners,8/9/1990,26000000,61489265,35489265,467243.6550151976
Funny People,7/31/2009,75000000,61458982,-13541018,284751.1606141757
National Lampoon's Vacation,7/28/1983,15000000,61399552,46399552,612769.9800399202
After the Sunset,11/12/2004,60000000,61347797,1347797,321192.6544502618
The Legend of Hercules,1/10/2014,70000000,61279452,-8720548,261972.04124557532
Misery,11/28/1990,20000000,61276872,41276872,457973.6322869955
Friday Night Lights,10/8/2004,30000000,61255921,31255921,320879.6280775275
The Walk,9/30/2015,35000000,61181942,26181942,257242.08074403586
Crossroads,2/15/2002,12000000,61141030,49141030,343875.30933633295
The Shaggy Dog,3/9/2006,50000000,61112916,11112916,305870.4504504504
Dilwale,12/18/2015,26000000,61000000,35000000,257475.22328589036
Colombiana,7/27/2011,40000000,60965854,20965854,269111.45247081155
The Omen,6/6/1976,2800000,60922980,58122980,1072587.676056338
Mission to Mars,3/10/2000,90000000,60874615,-29125385,355576.0221962617
Harlem Nights,11/17/1989,30000000,60864870,30864870,482671.45122918324
Snatched,5/3/2017,42000000,60845711,18845711,248620.78673493152
Zoolander,9/28/2001,28000000,60780981,32780981,342042.6617895329
A History of Violence,9/23/2005,32000000,60740827,28740827,304923.8303212852
(500) Days of Summer,7/17/2009,7500000,60722734,53222734,281339.98350584245
Kick-Ass 2,7/17/2013,28000000,60700000,32700000,259538.1332922861
The Fly,8/15/1986,15000000,60629159,45629159,552681.4858705561
Fargo,4/5/1996,7000000,60611975,53611975,387792.54638515675
Kiss the Girls,10/3/1997,27000000,60527873,33527873,374553.66955445544
Marie Antoinette,5/24/2006,40000000,60474340,20474340,298049.9753573189
Ninja Assassin,9/29/2009,40000000,60462347,20462347,279689.08348251664
21 Grams,9/6/2003,20000000,60427839,40427839,326284.22786177107
Monster,11/16/2003,8000000,60378584,52378584,327610.3309820944
The Insider,10/28/1999,90000000,60289912,-29710088,358228.82947118237
The Perfect Guy,9/11/2015,12000000,60273173,48273173,253307.1634201181
Secretariat,8/20/2010,35000000,60251371,25251371,275826.98602355807
The Ghost Writer,2/12/2010,45000000,60222298,15222298,277853.7424852704
Chain Reaction,8/2/1996,50000000,60209334,10209334,382767.5397329943
The International,2/3/2009,50000000,60161391,10161391,283522.0341858591
A Haunted House,1/11/2013,2500000,60141683,57641683,261167.635052979
Why Did I Get Married Too?,4/2/2010,20000000,60072596,40072596,275550.99101413245
Beautiful Creatures,2/13/2013,60000000,60052138,52138,258660.3464762282
Spartacus,10/6/1960,12000000,60000000,48000000,2013422.8187919462
Duplicity,3/19/2009,78146652,60000000,-18146652,281373.10073157004
The Gods Must Be Crazy,9/10/1980,5000000,60000000,55000000,714285.7142857143
Selena,3/21/1997,20000000,60000000,40000000,374531.8352059925
The Good Shepherd,12/11/2006,85000000,59908565,-25091435,296870.9861248761
Something Borrowed,5/5/2011,35000000,59901913,24901913,265094.93990193127
Next Friday,1/12/2000,11000000,59827328,48827328,354427.298578199
Friday the 13th,5/9/1980,550000,59754601,59204601,730496.3447432764
Fletch,5/31/1985,8000000,59612888,51612888,554023.12267658
Dr. No,10/4/1962,950000,59600000,58650000,1960526.3157894737
Quartet,9/8/2012,11000000,59520298,48520298,257210.44739355333
The Last Boy Scout,12/11/1991,29000000,59509925,30509925,431544.053662074
The Flintstones in Viva Rock Vegas,4/28/2000,83000000,59468275,-23531725,346753.79008746357
Rock of Ages,6/13/2012,75000000,59418613,-15581387,258929.45293230723
One Day,3/2/2011,15000000,59389433,44389433,265763.7727270693
Jeepers Creepers,7/1/2001,10000000,59217789,49217789,333621.3464788732
Good Luck Chuck,9/21/2007,25000000,59192128,34192128,283302.676417659
The Gift,7/30/2015,5000000,58978653,53978653,247480.87832961278
Chariots of Fire,5/15/1981,5500000,58972904,53472904,656713.8530066815
The Story of Us,10/13/1999,50000000,58900031,8900031,350178.5434007135
Under the Tuscan Sun,4/30/2003,18000000,58878723,40878723,320864.97547683923
The Blue Lagoon,7/5/1980,4500000,58853106,54353106,711645.7799274486
The Getaway,12/13/1972,3352254,58831997,55479743,1384282.282352941
Agent Cody Banks,3/14/2003,28000000,58795814,30795814,319195.5157437568
Morning Glory,1/12/2010,40000000,58785180,18785180,271290.7557906104
Honey I Blew Up the Kid,7/16/1992,40000000,58662452,18662452,416341.0361958836
Jack,8/9/1996,45000000,58620973,13620973,372669.88556897646
Skiptrace,7/21/2016,32000000,58500000,26500000,242890.77388737342
Must Love Dogs,7/21/2005,30000000,58405313,28405313,297379.39409368637
The Ninth Gate,8/24/1999,38000000,58401898,20401898,347837.39130434784
That's My Boy,6/14/2012,70000000,58058367,-11941633,253001.8868911181
Sliding Doors,4/23/1998,6000000,58000000,52000000,356265.35626535624
Sky Captain and the World of Tomorrow,9/17/2004,70000000,57958696,-12041304,303607.62702985853
Throw Momma from the Train,12/11/1987,14000000,57915972,43915972,501871.50779896014
Red Eye,8/4/2005,26000000,57891803,31891803,294764.78105906316
Aliens in the Attic,7/31/2009,45000000,57881056,12881056,268173.9484974564
Nine Lives,8/3/2016,30000000,57814445,27814445,240044.36389605107
Killer Elite,9/23/2011,66000000,57777106,-8222894,255175.5623374157
Drumline,12/13/2002,20000000,57588485,37588485,318344.30624654505
Boyz n the Hood,7/12/1991,6500000,57504069,51004069,422203.1497797357
Commando,10/3/1985,10000000,57500000,47500000,528978.8408463661
Inkheart,12/11/2008,60000000,57490374,-2509626,273466.7789257378
Derailed,11/11/2005,22000000,57479076,35479076,290886.012145749
Pet Sematary,4/21/1989,11500000,57469467,45969467,464212.17285945074
The Quest,4/19/1996,30000000,57400547,27400547,366542.4457215837
The Shack,3/3/2017,20000000,57330873,37330873,235154.3800066448
Sister Act 2: Back in the Habit,12/9/1993,38000000,57319029,19319029,393134.6296296296
The Physician,12/25/2013,32000000,57284237,25284237,244892.34169530944
Willow,5/1/1988,35000000,57269863,22269863,487403.08936170215
Madea's Family Reunion,2/24/2006,6000000,57231524,51231524,286444.06406406406
Walking Tall,4/2/2004,56000000,57223890,1223890,304382.39361702127
Unlawful Entry,6/26/1992,23000000,57138719,34138719,406681.2740213523
Predator 2,11/20/1990,35000000,57120318,22120318,426908.20627802686
Smokin' Aces,12/9/2006,17000000,57103895,40103895,282972.72051536175
The Mist,11/21/2007,18000000,57096190,39096190,271840.01790169306
Annie,6/18/1982,50000000,57059003,7059003,585220.5435897436
Shanghai Noon,5/26/2000,55000000,56932305,1932305,330233.78770301625
Lake Placid,7/15/1999,27000000,56870414,29870414,341154.25314937014
Murder by Numbers,4/19/2002,50000000,56714147,6714147,315429.07119021134
A Civil Action,3/5/1998,70000000,56702901,-13297099,349586.3193588163
Elektra,1/13/2005,43000000,56681566,13681566,297228.9774514945
Guess Who's Coming to Dinner,12/11/1967,4000000,56666667,52666667,1671583.0973451328
Tombstone,12/25/1993,25000000,56505065,31505065,386491.5526675787
Cradle 2 the Grave,2/28/2003,25000000,56489558,31489558,306675.12486427795
Cellular,9/6/2004,25000000,56422687,31422687,297117.8883622959
15 Minutes,3/1/2001,60000000,56359980,-3640020,319863.67763904657
The Eye,2/1/2008,12000000,56309766,44309766,265997.29797395284
Lucky Number Slevin,2/24/2006,27000000,56308881,29308881,281826.23123123124
Frida,8/29/2002,12000000,56298474,44298474,311041.2928176796
Into the Wild,9/11/2007,15000000,56255142,41255142,269821.7756247302
공조,1/18/2017,8520000,56100000,47580000,230292.73038509378
Kicking & Screaming,5/13/2005,45000000,56070433,11070433,288428.1532921811
Remember Me,3/12/2010,16000000,56032889,40032889,257467.40583832265
Bajirao Mastani,12/18/2015,19500000,56000000,36500000,236370.69678704688
Doom,10/20/2005,60000000,55987321,-4012679,283336.64473684214
Zoolander 2,2/6/2016,50000000,55969000,5969000,236045.56515724704
Pay It Forward,10/12/2000,40000000,55707411,15707411,320157.5344827586
The Aristocats,12/23/1970,4000000,55675257,51675257,1398875.8040201005
Ирония судьбы. Продолжение,12/21/2007,5000000,55635037,50635037,263573.22815993935
Cop Out,2/26/2010,30000000,55583804,25583804,255403.89007080792
The Lizzie McGuire Movie,4/25/2003,17000000,55534455,38534455,302640.08174386923
Out of Time,10/3/2003,50000000,55495563,5495563,299976.0162162162
Great Expectations,1/19/1998,25000000,55494066,30494066,342767.54786905495
La Guerre du feu,12/15/1981,12000000,55260558,43260558,587878.2765957447
Extremely Loud & Incredibly Close,12/24/2011,40000000,55247881,15247881,243742.44369443893
Dallas Buyers Club,9/7/2013,5000000,55198285,50198285,235739.99888959594
Why Did I Get Married?,10/12/2007,15000000,55184721,40184721,264122.606922694
The Ant Bully,7/27/2006,50000000,55181129,5181129,270628.39136831777
The Mothman Prophecies,1/25/2002,32000000,55157539,23157539,310222.3790776153
Eastern Promises,9/14/2007,51500000,55112356,3612356,264340.5247254065
Halloween: H20,8/5/1998,17000000,55041738,38041738,336852.7417380661
Spanglish,12/17/2004,80000000,55041367,-24958633,288628.03880440484
Barbershop: The Next Cut,4/15/2016,20000000,55030051,35030051,230000.08777025927
The Guardian,9/28/2006,70000000,55011732,-14988268,272605.21308225964
Analyze That,12/6/2002,60000000,55003135,-4996865,304052.7086788281
"\"कि�?\"\"An adrenaline junkie walks away from a whirlwind romance and embraces a new life as a thief\"",7/25/2014,22000000,55000000,33000000,231236.23093352167
Dawn of the Dead,9/2/1978,650000,55000000,54350000,827067.6691729323
The Money Pit,3/15/1986,10000000,54999651,44999651,505511.4981617647
The Crazies,2/26/2010,20000000,54956140,34956140,252519.8156512629
We Own the Night,5/25/2007,21000000,54926886,33926886,263625.43196129624
St. Vincent,10/9/2014,13000000,54837234,41837234,230958.77152712556
The Three Stooges,4/13/2012,30000000,54819301,24819301,238256.73555425167
Driven,4/27/2001,94000000,54744738,-39255262,308073.93359594827
The Punisher,4/15/2004,33000000,54700105,21700105,290958.00531914894
Small Soldiers,7/10/1998,40000000,54682547,14682547,335064.62622549024
The Tree of Life,5/18/2011,32000000,54674226,22674226,242219.30516298808
Open Water,8/6/2004,130000,54667954,54537954,288485.24538258574
Milk,11/26/2008,20000000,54586584,34586584,259654.20400707802
No Escape,8/26/2015,5000000,54418872,49418872,228703.57435541827
Domestic Disturbance,10/30/2001,75000000,54249294,-20750706,305802.1082299887
La Bamba,7/24/1987,6500000,54215416,47715416,473910.979020979
Prophecy,1/1/1979,12000000,54000000,42000000,790629.5754026355
The Verdict,12/8/1982,16000000,53977250,37977250,553045.5942622952
The Five-Year Engagement,4/27/2012,30000000,53909751,23909751,234578.90477122905
The Three Musketeers,11/11/1993,30000000,53898845,23898845,369676.5775034293
Tin Cup,8/16/1996,45000000,53854588,8854588,341283.82762991125
No Good Deed,9/10/2014,13200000,53830415,40630415,226148.75793489083
Nine,12/3/2009,80000000,53825515,-26174485,249251.05001643905
Lawless,8/29/2012,26000000,53676580,27676580,231957.46023240438
Stranger Than Fiction,9/9/2006,30000000,53653224,23653224,264431.85805815674
디워,2/8/2007,70000000,53587404,-16412596,263330.06058997835
10 Things I Hate About You,3/30/1999,16000000,53478166,37478166,321769.95186522265
Final Destination,3/16/2000,23000000,53302314,30302314,311163.5376532399
Papillon,12/13/1973,12000000,53267000,41267000,1152965.3679653679
Madea's Big Happy Family,4/22/2011,25000000,53213633,28213633,235496.06574498594
Arachnophobia,8/9/1990,31000000,53208180,22208180,404317.47720364743
Bienvenue chez les ch'tis,1/9/2008,11000000,53191886,42191886,251998.70191396624
Pitch Black,2/18/2000,23000000,53187659,30187659,310675.57827102806
A Walk Among the Tombstones,9/18/2014,28000000,53181600,25181600,223985.71386454283
RoboCop,7/17/1987,13000000,53000000,40000000,463286.7132867133
Edward Scissorhands,12/5/1990,20000000,53000000,33000000,396113.60239162925
Big Fat Liar,2/8/2002,15000000,52970014,37970014,297919.088863892
Sinister 2,8/19/2015,10000000,52882018,42882018,222244.7120132804
From Paris with Love,2/5/2010,52000000,52826594,826594,243731.4306015013
3 Days to Kill,2/14/2014,28000000,52597999,24597999,224030.0492799673
Wild,12/5/2014,15000000,52501541,37501541,223589.6845135683
The Boy Next Door,1/23/2015,4000000,52425855,48425855,223352.9664880156
Dolphin Tale 2,9/12/2014,36000000,52424533,16424533,220242.46001571225
The Night Before,11/20/2015,25000000,52395996,27395996,221524.13486946412
Dragonfly,2/22/2002,60000000,52322400,-7677600,292630.87248322146
Æon Flux,11/30/2005,62000000,52304001,-9695999,265772.36280487804
Silent Hill: Revelation 3D,10/10/2012,20000000,52302796,32302796,226108.742548105
The Color of Money,10/7/1986,13800000,52293982,38493982,474106.81776971894
Stand by Me,8/22/1986,8000000,52287414,44287414,474477.44101633393
Radio,10/24/2003,32000000,52277485,20277485,283346.8021680217
One Hour Photo,8/21/2002,12000000,52223306,40223306,288526.55248618784
Funny Girl,9/19/1968,14000000,52223306,38223306,1479413.7677053825
The Finest Hours,1/25/2016,80000000,52099090,-27900910,219724.47503489928
Elizabethtown,10/6/2005,57000000,52034889,-4965111,261219.32228915664
Amadeus,10/26/1984,18000000,51973029,33973029,493571.0256410256
Jaws: The Revenge,7/17/1987,23000000,51881013,28881013,453505.35839160834
Blue Crush,8/8/2002,25000000,51842679,26842679,286899.16436081904
Enough,5/24/2002,38000000,51801187,13801187,287944.3413007226
狄仁傑之通天帝國,9/18/2010,13000000,51723285,38723285,236491.46590706456
The China Syndrome,3/16/1979,5900000,51718367,45818367,732554.7733711048
Maximum Risk,9/13/1996,25000000,51702483,26702483,327645.6463878327
Biloxi Blues,3/25/1988,20000000,51684798,31684798,441373.1682322801
Hot Pursuit,5/8/2015,35000000,51680201,16680201,217321.75942473876
The Breakfast Club,2/15/1985,1000000,51525171,50525171,486086.5188679245
Daybreakers,1/6/2009,20000000,51416464,31416464,243514.88801428417
Mortal Kombat: Annihilation,11/21/1997,30000000,51376861,21376861,318517.4271543707
Broadcast News,12/16/1987,20000000,51249404,31249404,442950.76923076925
Delivery Man,10/10/2013,26000000,51164106,25164106,219075.06872307812
Defiance,12/31/2008,32000000,51155219,19155219,242277.5985943176
The Next Three Days,11/18/2010,30000000,51148651,21148651,233364.7429726388
Hollywood Homicide,6/9/2003,75000000,51142659,-23857341,278403.15187806205
The Naked Gun 33�? The Final Insult,3/18/1994,30000000,51132598,21132598,346896.8656716418
Silver Streak,12/3/1976,6500000,51079064,44579064,877647.147766323
The Mechanic,1/13/2011,40000000,51070807,11070807,231904.96451324338
Hoodwinked!,12/16/2005,15000000,51053787,36053787,257457.32223903175
Magic in the Moonlight,7/25/2014,16800000,51029361,34229361,214542.49281065536
Hable con ella,3/14/2002,9285469,51001550,41716081,285243.56823266216
விஸ்வரூபம்,1/25/2013,17000000,51000000,34000000,219670.4082423783
Sleeping Beauty,1/28/1959,6000000,51000000,45000000,1764705.8823529412
Team America: World Police,10/10/2004,32000000,50907422,18907422,266670.6233630173
Doubt,11/27/2008,20000000,50907234,30907234,242152.49158056965
Bull Durham,6/15/1988,7000000,50888000,43888000,431254.23728813557
The Tale of Despereaux,12/19/2008,60000000,50877145,-9122855,240960.60489810223
Unleashed,2/2/2005,45000000,50871113,5871113,265229.9947862356
The Mighty Ducks,10/1/1992,10000000,50752337,40752337,357914.9294781382
A Bridge Too Far,6/15/1977,22000000,50750000,28750000,836079.0774299835
Bonnie and Clyde,7/18/1967,2500000,50700000,48200000,1513432.8358208956
Bride of Chucky,10/16/1998,25000000,50671850,25671850,308974.6951219512
Meet Dave,7/8/2008,60000000,50650079,-9349921,230265.31159644306
Jack Ryan: Shadow Recruit,1/15/2014,60000000,50549107,-9450893,216099.39892953026
Patriots Day,12/12/2016,45000000,50548152,5548152,209368.0705126081
Fever Pitch,4/6/2005,30000000,50451307,20451307,259256.45940390546
Red Tails,1/19/2012,58000000,50365377,-7634623,221227.76647940156
Concussion,11/12/2015,35000000,50363790,15363790,212204.59601577508
K-PAX,10/22/2001,48000000,50315140,2315140,283625.36640360765
Natural Born Killers,8/25/1994,34000000,50282766,16282766,336564.6987951807
Escape from New York,5/22/1981,6000000,50244700,44244700,554577.2626931567
Breakdown,5/2/1997,36000000,50159144,14159144,313298.8382261087
The Longest Day,9/25/1962,10000000,50100000,40100000,1648026.3157894737
Absolute Power,2/14/1997,50000000,50068310,68310,313711.21553884714
Stigmata,9/10/1999,29000000,50041732,21041732,298044.86003573553
A Walk in the Clouds,8/11/1995,20000000,50012507,30012507,327092.9169391759
The Women,9/12/2008,16000000,50007546,34007546,228571.44293660842
Valley of the Dolls,12/27/1967,5000000,50000000,45000000,1466275.6598240468
How the West Was Won,11/1/1962,15000000,50000000,35000000,1644736.8421052631
The Deer Hunter,12/8/1978,15000000,50000000,35000000,738552.4372230428
The Switch,5/11/2010,19000000,49830607,30830607,228394.27898321554
Leaving Las Vegas,10/27/1995,3600000,49800000,46200000,324218.75
Major League,2/16/1989,11000000,49797148,38797148,407172.10139002453
She's Out of My League,3/11/2010,20000000,49779728,29779728,228734.54608948174
Raising Helen,5/27/2004,50000000,49718611,-281389,262090.72746441752
The Island of Dr. Moreau,8/23/1996,40000000,49627779,9627779,314497.96577946766
Australia,11/18/2008,130000000,49554002,-80445998,235715.51838955798
Notes on a Scandal,12/25/2006,15000000,49469904,34469904,244397.20180222907
Entourage,6/3/2015,30000000,49263404,19263404,206435.70596468291
Bugsy,12/10/1991,30000000,49114016,19114016,356156.7512690355
The Black Dahlia,9/15/2006,50000000,49111202,-888798,242046.33809758502
La Belle et la Bête,2/12/2014,33000000,49100000,16100000,209131.06256468795
Capote,9/30/2005,7000000,49084830,42084830,246409.78915662653
Death at a Funeral,4/15/2010,21000000,49050886,28050886,224994.77544505044
Agneepath,1/25/2012,11097000,49028000,37931000,215353.39514984866
About Last Night,2/14/2014,12500000,49002684,36502684,208716.5656505424
On Deadly Ground,2/18/1994,50000000,49000000,-1000000,332880.4347826087
Florence Foster Jenkins,5/6/2016,29000000,48902953,19902953,203568.06630340216
Darkman,8/24/1990,16000000,48878502,32878502,368338.3722682743
Men of Honor,9/13/2000,32000000,48814909,16814909,281029.9884858952
Conan the Barbarian,8/17/2011,90000000,48795021,-41204979,215061.201733006
How Do You Know,12/17/2010,120000000,48668907,-71331093,220998.29263973335
Sur la Piste du Marsupilami,4/3/2012,50000000,48600000,-1400000,211226.28593780557
The Avengers,8/13/1998,60000000,48585416,-11414584,297340.3671970624
Tremors,1/19/1990,11000000,48572000,37572000,379468.75
Date Movie,2/17/2006,20000000,48548426,28548426,242985.1151151151
Les petits mouchoirs,10/20/2010,25000000,48531470,23531470,221804.4085318757
Magnolia,12/8/1999,37000000,48451803,11451803,287889.5008912656
9,8/19/2009,30000000,48428063,18428063,224236.17741435114
Mother's Day,4/28/2016,25000000,48418160,23418160,201550.02102160853
Charlie St. Cloud,5/1/2010,44000000,48190704,4190704,220877.92536369388
Malcolm X,11/18/1992,34000000,48169908,14169908,339463.76321353065
G.I. Jane,8/22/1997,50000000,48169156,-1830844,298816.1042183623
End of Watch,9/20/2012,7000000,48126384,41126384,208053.81359779005
The Preacher's Wife,12/13/1996,40000000,48093211,8093211,303235.88272383355
21 & Over,3/1/2013,13000000,48065672,35065672,206491.6119996735
The Shadow,7/1/1994,25000000,48063435,23063435,323877.59433962265
The Last King of Scotland,9/1/2006,6000000,48027970,42027970,236707.5899457861
Single White Female,8/14/1992,16000000,48017402,32017402,340790.6458481192
써니,5/4/2011,3550000,48000000,44450000,212423.21785771186
The Natural,5/11/1984,28000000,47951979,19951979,463752.2147001934
Hachi: A Dog's Tale,6/13/2009,16000000,47801389,31801389,221617.7112840936
The Nanny Diaries,8/24/2007,20000000,47738099,27738099,228970.68924169024
Scott Pilgrim vs. the World,7/27/2010,60000000,47664559,-12335441,218332.29048334493
New Jack City,3/8/1991,8500000,47624253,39124253,352772.2444444444
The Godfather: Part II,12/20/1974,13000000,47542841,34542841,912530.5374280231
Precious,11/6/2009,10000000,47536959,37536959,219742.79572874773
Man on the Moon,12/22/1999,82000000,47434430,-34565570,281009.6563981043
The Rescuers Down Under,11/16/1990,37931000,47431461,9500461,354495.2242152466
Hard to Kill,2/9/1990,10000000,47410000,37410000,370390.625
Almost Famous,9/15/2000,60000000,47383689,-12616311,272790.3799654577
L'arnacoeur,3/17/2010,8700000,47355187,38655187,217216.66078005955
Her,12/18/2013,23000000,47351251,24351251,202428.44012380514
Last Man Standing,9/20/1996,67000000,47267001,-19732999,298591.28869235626
Texas Chainsaw 3D,1/3/2013,20000000,47241945,27241945,205150.01302761855
The Wedding Date,2/4/2005,15000000,47175038,32175038,245959.53076120958
High Fidelity,3/17/2000,30000000,47126295,17126295,275109.7197898424
Soul Surfer,4/8/2011,18000000,47088990,29088990,209371.87091496002
Looper,9/26/2012,30000000,47042000,17042000,203365.94370495898
Grand Masti,9/13/2013,5500000,47000000,41500000,200726.8875801306
Airport 1975,10/18/1974,3000000,47000000,44000000,912621.3592233009
The Object of My Affection,4/17/1998,15000000,46905889,31905889,288119.7113022113
GoodFellas,9/12/1990,25000000,46836394,21836394,352949.46495855314
Land of the Dead,6/24/2005,15000000,46770602,31770602,239358.24974411464
Practical Magic,10/16/1998,75000000,46683377,-28316623,284654.73780487804
Dog Day Afternoon,8/11/1975,1800000,46665856,44865856,859408.0294659301
A Monster Calls,10/7/2016,43000000,46652768,3652768,192996.15685333576
Colors,4/15/1988,6000000,46616067,40616067,398087.67719897523
Torque,1/16/2004,40000000,46546197,6546197,249979.57572502687
Fantastic Mr. Fox,10/23/2009,40000000,46471023,6471023,214815.4347524615
Get Rich or Die Tryin',11/9/2005,40000000,46442528,6442528,235033.03643724698
Dhoom 2,11/24/2006,11000000,46396427,35396427,229912.91873141724
Full Metal Jacket,6/26/1987,17000000,46357676,29357676,407360.94903339195
An Inconvenient Truth,1/24/2006,1000000,46243000,45243000,232727.73024660294
The Enforcer,12/20/1976,9000000,46236000,37236000,790358.9743589744
Man on a Ledge,1/13/2012,42000000,46221189,4221189,203918.50969492423
Parker,1/23/2013,35000000,46216641,11216641,199067.22345218508
The Fog,10/14/2005,18000000,46201432,28201432,231934.8995983936
The Big Lebowski,3/6/1998,15000000,46189568,31189568,284769.2231812577
Eddie the Eagle,2/26/2016,23000000,46152411,23152411,193810.2019048259
Deliverance,7/30/1972,2000000,46122355,44122355,1098151.3095238095
Napoleon Dynamite,6/11/2004,400000,46118097,45718097,243110.6852925672
The World's End,7/18/2013,20000000,46089287,26089287,197066.351116185
Risen,2/19/2016,20000000,46069568,26069568,193462.31501856112
Marked for Death,10/5/1990,12000000,46044400,34044400,344901.872659176
Yeh Jawaani Hai Deewani,5/31/2013,7700000,46000000,38300000,196998.7666164177
Chef,5/8/2014,11000000,45967935,34967935,193223.77049180327
The Rainmaker,11/18/1997,40000000,45916769,5916769,284666.88778673275
Black Rain,9/22/1989,30000000,45892212,15892212,365383.85350318474
Brewster's Millions,5/22/1985,20000000,45833132,25833132,425958.47583643126
Broken Flowers,5/17/2005,10000000,45742101,35742101,235177.8971722365
Arthur,4/8/2011,40000000,45735397,5735397,203353.38763750187
RoboCop 2,6/22/1990,35000000,45681173,10681173,350315.74386503064
The Debt,4/11/2010,20000000,45636368,25636368,209332.49544743568
The Tigger Movie,2/11/2000,30000000,45554533,15554533,268283.46878680796
Queen of the Damned,2/10/2002,35000000,45479110,10479110,255788.02024746904
Push,2/6/2009,38000000,45465299,7465299,214263.89654701145
Thelma & Louise,5/24/1991,16000000,45361000,29361000,333536.76470588235
Earth to Echo,6/14/2014,13000000,45300000,32300000,190062.2212525646
The Dirty Dozen,6/15/1967,5400000,45300000,39900000,1360360.3603603605
Léon,9/14/1994,16000000,45284974,29284974,303112.27576974564
The Spy Next Door,1/15/2010,28000000,45236543,17236543,208764.45287442254
Blair Witch,9/15/2016,5000000,45172994,40172994,187107.51859767715
Rough Night,6/15/2017,20000000,45056771,25056771,183938.97246433017
Death Wish 2,2/20/1982,2000000,45000000,43000000,476190.4761904762
Monster's Ball,11/11/2001,4000000,44909486,40909486,253153.8105975197
Grudge Match,12/25/2013,40000000,44907260,4907260,191980.28352058004
Cop Land,8/15/1997,15000000,44862187,29862187,278993.7002487562
Red Dawn,11/21/2012,65000000,44806783,-20193217,195150.6439431884
A Nightmare on Elm Street 3: Dream Warriors,2/27/1987,5000000,44793222,39793222,399582.7118644068
Midnight Cowboy,5/25/1969,3600000,44785053,41185053,1223635.3278688523
Young Guns,8/12/1988,13000000,44726644,31726644,375854.1512605042
The Wrestler,9/7/2008,6000000,44703995,38703995,204330.29531544956
The Negotiator,7/29/1998,50000000,44547681,-5452319,272629.6266829865
Recess: School's Out,1/27/2001,10000000,44460850,34460850,252905.85893060293
The Good Son,9/24/1993,17000000,44456478,27456478,305123.3905284832
Into the Blue,9/30/2005,50000000,44434439,-5565561,223064.452811245
The Sisterhood of the Traveling Pants 2,8/6/2008,27000000,44352417,17352417,202442.9539085108
A Man Apart,4/4/2003,36000000,44350926,8350926,241299.92383025025
Boyhood,6/5/2014,4000000,44349000,40349000,186072.1732964677
Picture Perfect,8/1/1997,19000000,44332015,25332015,275696.6106965174
House at the End of the Street,9/21/2012,6900000,44287131,37387131,191456.44721313176
47 Meters Down,6/15/2017,5500000,44235023,38735023,180584.28282745808
Child's Play,11/8/1988,9000000,44196684,35196684,367387.2319201995
Astro Boy,10/15/2009,65000000,44091067,-20908933,203958.17778949658
Passenger 57,11/5/1992,15000000,44065653,29065653,310321.5
Oculus,9/8/2013,5000000,44030246,39030246,188043.70721207437
The Shining,5/22/1980,19000000,44017374,25017374,532253.6154776299
The Internship,6/7/2013,58000000,44000000,-14000000,188433.6028504865
The Last Emperor,10/21/1987,23000000,43984230,20984230,381145.8405545927
Max,6/26/2015,20000000,43967255,23967255,184230.11975495907
Timeline,11/26/2003,80000000,43935763,-36064237,238392.63700488332
The Transporter,10/2/2002,21000000,43928932,22928932,242299.6800882515
Still Alice,12/5/2014,5000000,43884652,38884652,186892.71417133705
Wall Street,12/10/1987,15000000,43848069,28848069,379965.9358752166
Café Society,5/11/2016,30000000,43763247,13763247,182173.03905856493
West Side Story,10/18/1961,6000000,43656822,37656822,1455227.4
Welcome Home Roscoe Jenkins,2/8/2008,35000000,43650785,8650785,206198.52805713934
We Are Marshall,12/12/2006,65000000,43545364,-21454636,215784.757185332
The DUFF,2/20/2015,8500000,43528634,35028634,184350.40805695433
Luftslottet som sprängdes,11/27/2009,4000000,43498108,39498108,201427.68894507497
Harold & Kumar Escape from Guantanamo Bay,4/25/2008,12000000,43493123,31493123,200769.61390745596
The Great Outdoors,6/17/1988,24000000,43455230,19455230,366710.8016877637
Brothers,1/27/2009,26000000,43318349,17318349,204145.9850230686
Beastly,1/21/2011,17000000,43165571,26165571,195046.61355841832
Boogie Nights,9/11/1997,15000000,43101594,28101594,267379.6153846154
Reign of Fire,7/12/2002,60000000,43061982,-16938018,239100.39977790118
Homefront,11/27/2013,22000000,43058898,21058898,184763.28154165004
The Longest Yard,8/21/1974,2900000,43008075,40108075,849961.9565217391
Escape from Alcatraz,6/22/1979,8000000,43000000,35000000,588235.2941176471
Kokowääh,2/2/2011,5650000,43000000,37350000,194298.46956065952
Legend,9/9/2015,25000000,42972994,17972994,180600.5337367879
Crank,8/31/2006,12000000,42931041,30931041,211587.1907343519
Snitch,2/21/2013,35000000,42930462,7930462,184430.59117681175
A Lot Like Love,4/22/2005,30000000,42886719,12886719,220610.69444444444
Basic,4/18/2003,50000000,42792561,-7207439,233201.9673024523
Heartbreak Ridge,12/15/1986,15000000,42724017,27724017,386642.6877828054
Mannequin,2/13/1987,6000000,42721196,36721196,382806.41577060934
La Vérité si je Mens ! 2,2/7/2001,12560000,42700000,30140000,242889.64732650737
The Gallows,7/10/2015,100000,42664410,42564410,178770.98225883496
Bangkok Dangerous,8/21/2008,45000000,42487390,-2512610,194198.7722994931
Almost Christmas,11/11/2016,17000000,42487325,25487325,176038.10601069801
Love the Coopers,11/12/2015,17000000,42426912,25426912,178763.07007786428
Time Bandits,7/13/1981,5000000,42365581,37365581,462506.34279475984
My Name Is Khan,2/12/2010,12000000,42345360,30345360,195373.09507661217
The Fourth Kind,11/6/2009,10000000,42333295,32333295,195688.50829750844
Blue Thunder,2/5/1983,22000000,42313354,20313354,432209.948927477
Bullitt,10/17/1968,5500000,42300873,36800873,1194939.9152542374
Lady in the Water,7/21/2006,75000000,42285169,-32714831,207381.89798921038
Escape from L.A.,8/9/1996,50000000,42277365,-7722635,268769.0082644628
Zack and Miri Make a Porno,9/18/2008,24000000,42105111,18105111,194415.3287805959
Oliver Twist,9/23/2005,50000000,42093706,-7906294,211313.78514056225
The Salvation,5/22/2014,10500000,42070000,31570000,176510.3233575142
A Good Year,9/9/2006,35000000,42064105,7064105,207314.46525381962
Going the Distance,9/1/2010,32000000,42045846,10045846,192483.23788334502
Around the World in Eighty Days,10/17/1956,6000000,42000000,36000000,1527272.7272727273
Teenage Mutant Ninja Turtles III,3/17/1993,21000000,42000000,21000000,291666.6666666667
The Hurt Locker,10/10/2008,15000000,42000000,27000000,193929.99127315037
Doctor Who,3/31/1996,5000000,42000000,37000000,268714.01151631476
Donnie Brasco,2/27/1997,35000000,41954997,6954997,262218.73125
The Fisher King,9/9/1991,24000000,41895491,17895491,305360.72157434403
The Guilt Trip,12/19/2012,40000000,41863726,1863726,181794.88448844885
The Return of the Pink Panther,5/21/1975,5000000,41833347,36833347,780472.8917910447
The Love Guru,6/20/2008,62000000,41819064,-20180936,190117.76472513683
Aliens vs Predator: Requiem,12/25/2007,40000000,41797066,1797066,198015.28330490808
Casino Royale,4/13/1967,12000000,41744718,29744718,1261169.7280966768
Mr. Brooks,6/1/2007,20000000,41637263,21637263,199840.95665028412
Never Back Down,3/4/2008,20000000,41627431,21627431,194950.69030759434
Ronin,9/25/1998,55000000,41610884,-13389116,253724.9024390244
Undercover Brother,5/31/2002,25000000,41604473,16604473,231264.44135630905
The Hours,12/27/2002,25000000,41597830,16597830,228936.87396807928
Orphan,7/24/2009,20000000,41596251,21596251,192723.3475726716
Set It Off,11/6/1996,9000000,41590886,32590886,262237.6166456494
Wimbledon,9/13/2004,31000000,41512007,10512007,218599.29963138493
Gremlins 2: The New Batch,6/15/1990,50000000,41482207,-8517793,319339.54580446496
Gridiron Gang,9/15/2006,30000000,41480851,11480851,204439.87678659437
Des hommes et des dieux,5/18/2010,4000000,41424067,37424067,190049.168444475
T2 Trainspotting,1/27/2017,18000000,41412709,23412709,170000.8169029117
Whale Rider,1/30/2003,8000000,41400000,33400000,226105.95303113054
The Lady in the Van,11/13/2015,6000000,41387687,35387687,174384.36225435667
Peggy Sue Got Married,10/5/1986,18000000,41382841,23382841,375184.41523118765
Ricki and the Flash,7/10/2015,18000000,41325328,23325328,173160.00569862645
Pinocchio,12/25/2002,40000000,41323171,1323171,227425.26692350028
Leatherheads,3/24/2008,58000000,41299492,-16700508,192248.93051488898
This Is Where I Leave You,9/10/2014,19800000,41296320,21496320,173491.35196676062
Man of the Year,10/9/2006,20000000,41237648,21237648,204349.09811694745
Private Parts,3/7/1997,28000000,41230799,13230799,257692.49375
A Walk to Remember,1/25/2002,11000000,41227069,30227069,231873.27896512934
Happy Gilmore,2/16/1996,12000000,41205099,29205099,264644.18111753376
Freedom Writers,1/5/2007,21000000,41170784,20170784,203396.88562169
The French Connection,10/9/1971,1800000,41158757,39358757,1006326.577017115
Clash of the Titans,3/15/1981,15000000,41092328,26092328,464320.0903954802
Dredd,9/7/2012,50000000,41037742,-8962258,177340.10639263288
John Tucker Must Die,7/27/2006,18000000,41009669,23009669,201126.38057871506
Gabbar Is Back,5/1/2015,11000000,41000000,30000000,172410.16799478565
Poltergeist II: The Other Side,5/23/1986,19000000,40996665,21996665,374398.76712328766
Pee-wee's Big Adventure,7/26/1985,6000000,40940662,34940662,379080.2037037037
La Vérité si je Mens ! 3,1/31/2012,25496629,40924982,15428353,179761.2348075884
Falling Down,2/26/1993,25000000,40903593,15903593,284843.9623955432
Quarantine,10/10/2008,12000000,40855419,28855419,188645.02500311672
House on Haunted Hill,10/29/1999,19000000,40846082,21846082,242698.05109922757
Gamer,9/3/2009,50000000,40828540,-9171460,189048.15042899677
Absence of Malice,12/18/1981,12000000,40716963,28716963,431781.1558854719
Three Fugitives,1/27/1989,15000000,40590000,25590000,333799.34210526315
The Dark Crystal,12/17/1982,15000000,40577001,25577001,414897.76073619636
30 Minutes or Less,8/11/2011,28000000,40547440,12547440,178981.83583835443
The Roommate,2/4/2011,16000000,40492759,24492759,182969.32795322378
Bill & Ted's Excellent Adventure,2/17/1989,10000000,40485039,30485039,331030.5723630417
War,8/24/2007,25000000,40452643,15452643,194026.7782627464
The Witch,2/19/2016,3500000,40423945,36923945,169754.35892698166
2010,12/6/1984,28000000,40400657,12400657,383671.95631528966
Reds,12/25/1981,32000000,40382659,8382659,428236.04453870625
Safe,4/16/2012,30000000,40346186,10346186,175559.4108304506
The Faculty,12/25/1998,15000000,40283321,25283321,245181.50334753498
Carol,11/20/2015,11800000,40272135,28472135,170265.87041538948
La mala educación,3/19/2004,5000000,40266982,35266982,214186.0744680851
Blast from the Past,2/12/1999,35000000,40263020,5263020,244760.0
Hardball,9/14/2001,32000000,40222729,8222729,225590.17947279863
Bridget Jones: The Edge of Reason,11/10/2004,50000000,40203020,-9796980,210487.01570680627
Diary of a Wimpy Kid: The Long Haul,5/19/2017,22000000,40120144,18120144,163785.7728970627
All About Steve,9/4/2009,15000000,40105542,25105542,185700.45701003386
Hannah and Her Sisters,2/7/1986,6400000,40084041,33684041,366734.13540713635
The Forest,1/7/2016,10000000,40055439,30055439,169070.21475966164
Dancer in the Dark,5/17/2000,12800000,40031879,27231879,232203.47447795823
I Still Know What You Did Last Summer,11/13/1998,65000000,40002112,-24997888,243915.31707317074
Beyond the Valley of the Dolls,7/17/1970,2090000,40000000,37910000,1025641.0256410256
Caddyshack,7/25/1980,6000000,39846344,33846344,478347.4669867947
Memento,10/11/2000,9000000,39723096,30723096,228293.6551724138
Jackie Brown,12/24/1997,12000000,39673162,27673162,245502.2400990099
Out for Justice,4/12/1991,14000000,39673161,25673161,293440.5399408284
Hocus Pocus,7/16/1993,28000000,39514713,11514713,272891.66436464083
Crazy Heart,12/16/2009,7000000,39462438,32462438,182117.2382284124
The Legend of Bagger Vance,11/2/2000,80000000,39459427,-40540573,226648.05858701895
Crocodile Dundee in Los Angeles,4/12/2001,21150000,39438674,18288674,222943.32391181457
Halloween II,8/28/2009,15000000,39421467,24421467,182532.98853076136
Sin City: A Dame to Kill For,8/20/2014,65000000,39407616,-25592384,165556.65438535318
Dead Man Walking,12/29/1995,11000000,39363635,28363635,254945.82253886008
Furry Vengeance,4/2/2010,35000000,39340177,4340177,180452.07766651837
Blind Date,3/27/1987,18000000,39321715,21321715,348906.07808340725
Alpha and Omega,9/17/2010,20000000,39300000,19300000,179689.17887074724
Dumb and Dumberer: When Harry Met Lloyd,6/13/2003,19000000,39267515,20267515,213758.92759934676
50/50,9/30/2011,8000000,39187783,31187783,173074.8605473874
The Gambler,12/25/2014,25000000,39171130,14171130,167607.85941371034
The Grudge 2,10/13/2006,20000000,39143839,19143839,193973.43409316154
The Sword and the Sorcerer,4/1/1982,4000000,39103425,35103425,412048.73551106424
Postcards from the Edge,9/12/1990,22000000,39071603,17071603,294435.5915599096
The Sisterhood of the Traveling Pants,6/1/2005,25000000,39053061,14053061,200786.94601542415
Agora,5/17/2009,70000000,39041505,-30958495,181004.9700268437
The Spirit,12/25/2008,60000000,39031337,-20968663,184857.35733602344
Mars Needs Moms,3/9/2011,150000000,38992758,-111007242,174490.00523567238
The Life of David Gale,2/21/2003,50000000,38955598,-11044402,211485.3311617807
Serenity,8/25/2005,39000000,38869464,-130536,195520.4426559356
Дневной дозор,1/1/2006,4200000,38862717,34662717,195979.4099848714
Clockstoppers,3/17/2002,26000000,38793283,12793283,215757.96996662958
Clockstoppers,3/17/2002,26000000,38793283,12793283,215757.96996662958
The Wicker Man,9/1/2006,40000000,38755073,-1244927,191005.7811729916
Little Shop of Horrors,12/19/1986,25000000,38748395,13748395,348456.7895683453
Nightcrawler,10/23/2014,8500000,38697217,30197217,163866.41174502755
Basic Instinct 2,3/29/2006,70000000,38629478,-31370522,191709.5682382134
The Great Mouse Detective,7/2/1986,14000000,38625550,24625550,352744.7488584475
The Grudge 3,5/12/2009,5000000,38610009,33610009,180542.08906928028
Urban Legends: Final Cut,9/19/2000,14000000,38574362,24574362,221691.7356321839
Mar adentro,9/3/2004,12806000,38535221,25729221,202923.75460768826
Accepted,8/18/2006,23000000,38505009,15505009,189773.33169048792
Dream House,9/30/2011,50000000,38502340,-11497660,170047.5662593134
Bachelor Party,6/29/1984,6000000,38435947,32435947,369221.39289145055
Midnight Run,7/20/1988,30000000,38413606,8413606,322803.4117647059
Last Holiday,1/13/2006,45000000,38399961,-6600039,193645.79425113462
Red Dawn,8/10/1984,4200000,38376497,34176497,367239.2057416268
Employee of the Month,10/6/2006,12000000,38368909,26368909,190133.34489593655
City Heat,12/5/1984,25000000,38348988,13348988,364187.9202279202
Million Dollar Arm,5/9/2014,25000000,38307627,13307627,161024.0731399748
National Lampoon’s Van Wilder,3/29/2002,5000000,38275483,33275483,212878.10344827586
Annie Hall,4/19/1977,4000000,38251425,34251425,634351.9900497512
The In-Laws,6/15/1979,9000000,38200000,29200000,528354.0802213001
Quest for Camelot,5/15/1998,40000000,38172500,-1827500,234474.8157248157
Just My Luck,5/12/2006,28000000,38159905,10159905,188443.97530864197
Адмиралъ,6/6/2008,2000000,38135878,36135878,174283.65514247195
The Running Man,11/13/1987,27000000,38122105,11122105,330347.53032928944
The Doctor,7/24/1991,12000000,38120905,26120905,279069.58272327966
Spaceballs,6/24/1987,22700000,38119483,15419483,334969.0949033392
The Secret Life of Bees,9/17/2008,11000000,38105395,27105395,175947.1171383321
Happily N'Ever After,9/14/2006,47000000,38085778,-8914222,187707.1365204534
The Producers,12/25/2005,45000000,38058335,-6941665,191923.0206757438
Hotel Rwanda,9/11/2004,17500000,38000000,20500000,200105.3185887309
Howard the Duck,8/1/1986,37000000,37962774,962774,346059.9270738377
Killing Them Softly,9/20/2012,15000000,37930465,22930465,163976.1236744381
The Black Stallion,10/17/1979,2700000,37799643,35099643,498019.01185770746
Jumping the Broom,5/6/2011,6600000,37710610,31110610,166887.69007452513
Om Shanti Om,11/7/2007,9100000,37707444,28607444,179408.04179334562
How Stella Got Her Groove Back,8/14/1998,20000000,37672350,17672350,230552.9375764994
Halloween: Resurrection,7/1/2002,13000000,37664855,24664855,209133.00943920045
Tom Jones,10/6/1963,1000000,37600000,36600000,1220779.2207792208
The Covenant,9/8/2006,20000000,37597471,17597471,185300.4977821587
Hell or High Water,8/12/2016,12000000,37589296,25589296,156069.96915079575
Gifted,4/12/2017,7000000,37461045,30461045,153199.8699514158
Oliver!,9/26/1968,10000000,37402877,27402877,1059571.5864022663
The Wild,3/6/2006,80000000,37384046,-42615954,187107.33733733732
The Majestic,12/21/2001,72000000,37317558,-34682442,210714.6132128741
Becoming Jane,3/2/2007,16500000,37311672,20811672,181696.17047800848
Do the Right Thing,6/30/1989,6500000,37295445,30795445,299802.6125401929
Snowden,9/15/2016,40000000,37279439,-2720561,154412.24298755737
Raising Cain,8/7/1992,12000000,37170057,25170057,263804.5209368346
Psycho,12/4/1998,60000000,37141130,-22858870,226608.480780964
Uptown Girls,8/15/2003,20000000,37095657,17095657,200951.55471289274
Keeping the Faith,4/14/2000,30000000,37036004,7036004,216205.5107997665
Junior,11/22/1994,60000000,37000000,-23000000,247160.9886439546
Don't Be Afraid of the Dark,11/6/2010,25000000,36993168,11993168,169070.6617368135
The Bachelor,11/5/1999,51000000,36911617,-14088383,219320.3624480095
The Family,9/13/2013,30000000,36894225,6894225,157567.29689214987
One for the Money,1/26/2012,40000000,36893721,-3106279,162054.09311130925
Ex Machina,1/21/2015,15000000,36869414,21869414,157076.94208467889
My Favorite Martian,2/11/1999,65000000,36850101,-28149899,224012.77203647417
Highlander III: The Sorcerer,11/29/1994,26000000,36800000,10800000,245824.98329993323
South Pacific,3/18/1958,6000000,36800000,30800000,1273356.401384083
Bounce,11/15/2000,35000000,36779296,1779296,211253.85410683515
Rear Window,8/1/1954,1000000,36764313,35764313,1366703.0855018587
Titan A.E.,6/16/2000,75000000,36754634,-38245366,212700.42824074073
Alive,1/15/1993,32000000,36733909,4733909,257601.04488078543
Friday the 13th Part III,8/13/1982,4000000,36690067,32690067,375538.04503582395
Joy Ride,10/5/2001,23000000,36642838,13642838,206206.17895329208
My Best Friend's Girl,9/19/2008,20000000,36620508,16620508,169090.828496627
Return to Me,4/7/2000,24000000,36609995,12609995,213718.5931115003
Taxi,10/6/2004,25000000,36609966,11609966,191775.62074384495
Burnt,10/2/2015,20000000,36606743,16606743,153914.60994458414
The 'Burbs,2/17/1989,18000000,36602000,18602000,299280.4578904334
Carlito's Way,11/10/1993,30000000,36516012,6516012,250452.75720164608
Baby Geniuses,3/12/1999,12000000,36450736,24450736,220913.5515151515
Devil's Due,1/8/2014,7000000,36433975,29433975,155756.66051061064
Vegas Vacation,2/13/1997,25000000,36400360,11400360,228072.43107769423
Beauty Shop,6/2/2005,25000000,36351350,11351350,186896.40102827764
The Boat That Rocked,4/1/2009,50000000,36348784,-13651216,170459.50103170137
Mad Max Beyond Thunderdome,6/29/1985,12305523,36230219,23924696,336087.37476808904
Larry Crowne,6/30/2011,30000000,36160375,6160375,160056.9001690849
Ultimo tango a Parigi,10/14/1972,1250000,36144000,34894000,854468.0851063831
Love Happens,9/18/2009,18000000,36133014,18133014,167145.50576610834
Jersey Girl,3/25/2004,35000000,36098382,1098382,192012.67021276595
Hanging Up,2/16/2000,40000000,36037909,-3962091,210501.80490654206
葉問2: 宗師傳奇,4/21/2010,12902809,36000000,23097191,165002.88755053215
The Greatest Show on Earth,1/10/1952,4000000,36000000,32000000,1358490.566037736
The Robe,9/16/1953,4100000,36000000,31900000,1333333.3333333333
The Born Losers,8/18/1967,360000,36000000,35640000,1071428.5714285714
A Walk in the Woods,9/2/2015,8000000,35991087,27991087,151258.0092038076
Dirty Harry,12/21/1971,4000000,35976000,31976000,875328.4671532847
Jobs,8/16/2013,12000000,35931410,23931410,153455.32118437404
The Best of Me,10/16/2014,26000000,35926213,9926213,152132.3771654577
Taps,12/20/1981,14000000,35856053,21856053,380233.86002120894
The Black Hole,12/18/1979,20000000,35841901,15841901,460692.81491002574
Child's Play 2,11/9/1990,13000000,35763605,22763605,267291.51718983555
Riding in Cars with Boys,10/19/2001,48000000,35743308,-12256692,201484.2615558061
Robin Hood: Men in Tights,7/28/1993,20000000,35739755,15739755,246821.5124309392
127 Hours,11/5/2010,18000000,35692920,17692920,163128.11067489933
Hostel: Part II,6/8/2007,10200000,35619521,25419521,170958.38292888956
Bowling for Columbine,10/9/2002,4000000,35564473,31564473,196163.66795366793
No Way Out,8/14/1987,15000000,35509515,20509515,310397.8583916084
The Place Beyond the Pines,3/20/2013,15000000,35485608,20485608,152605.92351127375
Arbitrage,9/14/2012,12000000,35485056,23485056,153344.78213710044
Money Train,11/21/1995,60000000,35431113,-24568887,230821.58306188925
The Informant!,9/18/2009,22000000,35424826,13424826,163869.54208819626
Mermaids,12/14/1990,31000000,35419397,4419397,264718.9611360239
Original Sin,8/3/2001,42000000,35402320,-6597680,199449.69014084508
Room,10/16/2015,6000000,35401758,29401758,149163.03468500354
A Very Harold & Kumar Christmas,11/4/2011,19000000,35387212,16387212,156421.39415638952
The Bad News Bears,4/7/1976,35000000,35323292,323292,629648.6987522282
Vacancy,4/20/2007,19000000,35300645,16300645,169756.2623527884
Assault on Precinct 13,1/19/2005,30000000,35294470,5294470,184017.04900938476
Frankenweenie,10/4/2012,39000000,35287788,-3712212,152551.6412542096
K-19: The Widowmaker,7/19/2002,100000000,35168966,-64831034,194626.26452684007
Fletch Lives,3/17/1989,8045760,35150960,27105200,285548.00974817225
The Adventures of Rocky & Bullwinkle,6/30/2000,76000000,35134820,-40865180,203326.5046296296
Whatever Works,6/19/2009,15000000,35097815,20097815,162979.57752692117
Miss Potter,12/3/2006,30000000,35078241,5078241,173826.76412289395
My Week with Marilyn,10/17/2011,6400000,35057696,28657696,154964.84109092518
The Skulls,3/31/2000,15000000,35007180,20007180,204361.8213660245
Benvenuti al nord,1/18/2012,6000000,35000000,29000000,153736.0045330159
Ghoulies,11/8/1984,1000000,35000000,34000000,332383.66571699904
Midnight Express,9/12/1978,2300000,35000000,32700000,526315.7894736842
Giant,10/10/1956,5400000,35000000,29600000,1272727.2727272727
Red Heat,6/17/1988,29000000,34994648,5994648,295313.4852320675
Excalibur,4/10/1981,11000000,34967437,23967437,392451.5937149271
The Sitter,12/9/2011,25000000,34942188,9942188,154836.16930766776
Freddy's Dead: The Final Nightmare,9/5/1991,11000000,34872033,23872033,254169.3367346939
Secret in Their Eyes,10/14/2015,19500000,34854990,15354990,146549.28985275692
The Life Aquatic with Steve Zissou,12/10/2004,50000000,34808403,-15191597,182913.31056227008
White Fang,1/18/1991,14000000,34793160,20793160,258109.4955489614
Ji jie hao,10/9/2007,16000000,34786960,18786960,166495.76903932303
Take the Lead,3/17/2006,30000000,34742066,4742066,172417.20099255582
Psycho II,6/3/1983,5000000,34725000,29725000,348994.97487437184
The Kids Are All Right,7/9/2010,3500000,34705850,31205850,159193.11410892112
The Killing Fields,11/2/1984,14400000,34700291,20300291,329537.4264007597
Dangerous Liaisons,12/16/1988,14000000,34670720,20670720,286298.26589595375
Gone Baby Gone,10/19/2007,19000000,34619699,15619699,164716.87672771045
Mississippi Burning,12/8/1988,15000000,34604000,19604000,287170.1244813278
Viy,1/30/2014,26000000,34592118,8592118,147337.8084257244
The Best Man,10/22/1999,9000000,34573780,25573780,205429.47118241235
Thirteen Days,12/24/2000,80000000,34566746,-45433254,197411.4563106796
Salmon Fishing in the Yemen,9/10/2011,5000000,34564651,29564651,152341.67808928594
Hawaii,10/10/1966,15000000,34562222,19562222,1050523.4650455927
Crank: High Voltage,4/16/2009,20000000,34560577,14560577,161606.76810564118
In Bruges,2/8/2008,15000000,34533783,19533783,163131.4356166713
Courageous,9/30/2011,1000000,34522221,33522221,152469.1658459242
Woodstock,3/26/1970,600000,34505110,33905110,896236.6233766234
Steve Jobs,10/9/2015,30000000,34441873,4441873,144812.32183250785
The Doors,3/1/1991,38000000,34416893,-3583107,254939.94814814813
Swimfan,9/6/2002,8500000,34411240,25911240,190117.34806629835
American Psycho,4/13/2000,7000000,34266564,27266564,200038.3187390543
Bad News Bears,7/22/2005,30000000,34252847,4252847,174403.4979633401
Tommy,3/19/1975,5000000,34251525,29251525,647476.843100189
The Hunted,3/11/2003,55000000,34234008,-20765992,185852.37785016288
Victor Frankenstein,11/10/2015,40000000,34227298,-5772702,144214.52287052953
Les Aventures extraordinaires d'Adèle Blanc-Sec,4/9/2010,25000000,34100000,9100000,156415.56082547051
Endless Love,2/12/2014,20000000,34077920,14077920,145147.69082677047
Day of the Dead,7/19/1985,3500000,34000000,30500000,314814.81481481483
El secreto de sus ojos,8/13/2009,2000000,33965843,31965843,157370.21507269476
The Relic,1/10/1997,60000000,33956608,-26043392,213429.34003771213
Strictly Ballroom,8/20/1992,3000000,33946224,30946224,240242.20806794052
She's the Man,3/17/2006,20000000,33889159,13889159,168184.41191066997
The Pink Panther Strikes Again,12/15/1976,6000000,33833201,27833201,581326.4776632303
Stuck on You,12/10/2003,55000000,33828318,-21171682,183550.2875746066
Carrie,11/3/1976,1800000,33800000,32000000,582758.6206896552
Jay and Silent Bob Strike Back,8/22/2001,22000000,33788161,11788161,189501.7442512619
Where the Heart Is,4/27/2000,15000000,33771174,18771174,196916.4664723032
Porky's II: The Next Day,6/24/1983,6500000,33759266,27259266,337930.59059059055
The Wizard of Oz,8/15/1939,2777000,33754967,30977967,2446012.1014492754
Who's Afraid of Virginia Woolf?,6/21/1966,7500000,33736689,26236689,1038051.9692307692
The Outsiders,3/25/1983,10000000,33697647,23697647,341761.1257606491
新少林寺,1/20/2011,29000000,33662874,4662874,152108.0209119376
Y tu mamá también,6/8/2001,5000000,33616692,28616692,188857.8202247191
Devil,1/13/2010,10000000,33583175,23583175,154984.724510469
I Spy,10/31/2002,70000000,33561137,-36438863,185113.8279095422
Friday After Next,11/22/2002,20000000,33526835,13526835,185333.52681039248
Red Planet,11/10/2000,80000000,33463969,-46536031,192211.19471568064
Matilda,8/2/1996,36000000,33459416,-2540584,212710.84551811824
Fireproof,9/26/2008,500000,33456317,32956317,154480.55390099413
The Perks of Being a Wallflower,9/20/2012,13000000,33400000,20400000,144390.59818344523
2016: Obama's America,7/13/2012,2500000,33400000,30900000,145785.32020392484
Planet of the Apes,2/7/1968,5800000,33395426,27595426,976474.4444444444
Rosemary's Baby,6/12/1968,3200000,33395426,30195426,962404.2074927953
Haywire,11/6/2011,23000000,33372606,10372606,147516.27105158468
The Box,9/17/2009,30000000,33333531,3333531,154195.5480925353
Blade Runner,6/25/1982,28000000,33139618,5139618,339893.5179487179
Confessions of a Dangerous Mind,12/30/2002,30000000,33013805,3013805,181694.0286186021
Confessions of a Dangerous Mind,12/30/2002,30000000,33013805,3013805,181694.0286186021
Dracula 2000,12/22/2000,28000000,33000337,5000337,188465.65962307254
Run Fatboy Run,9/6/2007,10000000,33000000,23000000,158280.9727085232
Tron,7/9/1982,17000000,33000000,16000000,338461.53846153844
Friday the 13th: The Final Chapter,4/13/1984,2600000,32980880,30380880,319892.14354995155
Nick and Norah's Infinite Playlist,10/3/2008,9000000,32973937,23973937,152253.22177741452
Inside Llewyn Davis,10/6/2013,11000000,32935319,21935319,141022.8349019037
The Joy Luck Club,9/8/1993,11000000,32861136,21861136,226472.33631977948
Adaptation.,12/6/2002,19000000,32801173,13801173,181322.12824765063
Katy Perry: Part of Me,6/28/2012,12000000,32726956,20726956,142847.5975975976
The Last House on the Left,3/13/2009,15000000,32721635,17721635,153832.86555810992
Because of Winn-Dixie,2/18/2005,14000000,32645546,18645546,168885.39058458354
The November Man,8/27/2014,15000000,32556119,17556119,136772.60104776267
Sleepless,1/12/2017,30000000,32540674,2540674,134001.02125276419
Untraceable,1/22/2008,35000000,32483410,-2516590,153445.83902160203
Jungle Fever,6/7/1991,14000000,32482682,18482682,238843.25
Movie 43,1/1/2013,6000000,32438988,26438988,140867.58728504428
紅番區,1/30/1995,7500000,32392047,24892047,214659.0258449304
Hart's War,2/15/2002,70000000,32287044,-37712956,181591.92350956128
The Age of Innocence,9/17/1993,34000000,32255440,-1744560,221382.56691832535
Project Almanac,1/29/2015,12000000,32248241,20248241,137389.08581215225
The Lost Boys,7/31/1987,8500000,32222567,23722567,281665.7954545454
Lockout,4/12/2012,20000000,32204030,12204030,139965.79524958166
Reindeer Games,2/25/2000,42000000,32168970,-9831030,187902.8621495327
Alien Nation,10/7/1988,16000000,32155047,16155047,267512.8702163061
The Lawnmower Man,3/5/1992,10000000,32101000,22101000,230445.0825556353
Robin Hood,11/8/1973,15000000,32056467,17056467,698397.9738562092
Sunshine,4/5/2007,50000000,32017803,-17982197,154910.36161133312
You Again,9/24/2010,20000000,32005248,12005248,146335.79472454518
Airlift,1/22/2016,4500000,32000000,27500000,134957.88892122256
Psycho,6/16/1960,806948,32000000,31193052,1081081.081081081
Ночной дозор,6/27/2004,4200000,32000000,27800000,168954.5934530095
Metro,1/16/1997,55000000,31987563,-23012437,200423.3270676692
An American Werewolf in London,8/21/1981,10000000,31973249,21973249,343060.6115879828
The Invention of Lying,9/13/2009,18500000,31912793,13412793,147765.61913978396
Dressed to Kill,6/25/1980,6500000,31899000,25399000,385719.46795646916
The Outlaw Josey Wales,6/30/1976,3700000,31800000,28100000,556917.6882661997
1941,12/13/1979,35000000,31755742,-3244258,414025.3194263364
Spring Breakers,1/24/2013,5000000,31724284,26724284,136644.83171523822
The Soloist,4/24/2009,60000000,31720158,-28279842,148324.8447553494
Paint Your Wagon,10/15/1969,20000000,31678778,11678778,849296.9973190349
History of the World: Part I,6/12/1981,11000000,31672907,20672907,349590.5849889625
Rent,11/23/2005,40000000,31670620,-8329380,160927.94715447153
Can't Buy Me Love,8/14/1987,1800000,31623833,29823833,276432.1066433566
For Richer or Poorer,12/11/1997,35000000,31611225,-3388775,195977.8363298202
Daddy's Little Girls,2/14/2007,10000000,31609243,21609243,155328.73871616076
Rob Roy,4/13/1995,28000000,31596911,3596911,208011.26398946674
Scoop,7/27/2006,4000000,31584901,27584901,154903.87935262383
Little Big Man,12/14/1970,15000000,31559552,16559552,792953.5678391961
Jennifer's Body,9/18/2009,16000000,31556061,15556061,145973.25802467423
A Most Wanted Man,7/25/2014,15000000,31554855,16554855,132665.92250643257
"\"도가�?\"\"Based on actual events that took place at Gwangju Inhwa School for the hearing-impaired\"",9/22/2011,2200000,31500000,29300000,139121.3712508999
A Serious Man,10/2/2009,7000000,31430334,24430334,145391.665163269
Machete,9/1/2010,20000000,31327899,11327899,143417.15078351393
Johnson Family Vacation,4/7/2004,12000000,31179516,19179516,165848.48936170212
How High,12/21/2001,12000000,31155435,19155435,175920.01693958216
Pride and Glory,9/9/2008,30000000,31148328,1148328,142370.87890741054
Premium Rush,8/24/2012,35000000,31083599,-3916401,134324.36788861183
Ultraviolet,3/3/2006,30000000,31070211,1070211,155506.56156156154
High Anxiety,12/25/1977,3400000,31063038,27663038,497008.608
गुरु,1/12/2007,4700000,31000000,26300000,153149.9486206624
Joe Dirt,4/10/2001,17700000,30987695,13287695,175170.6896551724
Billy Lynn's Long Halftime Walk,11/10/2016,40000000,30930984,-9069016,128156.61707126076
Dune,12/14/1984,40000000,30925690,-9074310,293691.26305792975
Murphy's Romance,12/25/1985,13000000,30867525,17867525,281638.0018248175
The Texas Chain Saw Massacre,10/1/1974,85000,30859000,30774000,603894.324853229
The Princess Bride,9/18/1987,16000000,30857814,14857814,267630.65047701646
Pathfinder,1/11/2007,45000000,30822861,-14177139,152274.82511263932
Winter's Tale,2/13/2014,60000000,30800231,-29199769,131187.06794842854
Exorcist II: The Heretic,6/17/1977,14000000,30749142,16749142,504084.2950819672
When the Bough Breaks,9/9/2016,10000000,30658387,20658387,126987.70233775701
Dogma,11/12/1999,10000000,30652890,20652890,182132.44206773618
Cidade de Deus,2/5/2002,3300000,30641770,27341770,172338.41394825646
Cabin Fever,8/15/2003,1500000,30553394,29053394,165511.34344528712
I Don't Know How She Does It,9/16/2011,24000000,30551495,6551495,134932.25010047655
The New World,12/25/2005,30000000,30536013,536013,153988.9712556732
Two for the Money,10/7/2005,35000000,30526509,-4473491,153245.52710843374
Self/less,7/10/2015,26000000,30523226,4523226,127897.39958265942
From Here to Eternity,8/28/1953,1650000,30500000,28850000,1133828.996282528
The Lord of the Rings,11/15/1978,4000000,30471420,26471420,452098.2195845697
[REC],4/10/2007,1500000,30448000,28948000,147315.2511539243
What's Your Number?,9/30/2011,20000000,30426096,10426096,134378.4189629054
Mortdecai,1/21/2015,60000000,30418560,-29581440,129593.9877812902
The Girl Next Door,4/9/2004,25000000,30411183,5411183,161761.61170212767
Yentl,11/18/1983,12000000,30400000,18400000,300098.7166831195
Alex Cross,10/18/2012,45000000,30353232,-14646768,131843.88913261605
A Night at the Roxbury,10/1/1998,17000000,30331165,13331165,184946.1280487805
Assassins,10/6/1995,50000000,30303072,-19696928,197157.26740403386
The Fighting Temptations,9/17/2003,15000000,30238577,15238577,163451.76756756756
The Great Debaters,12/27/2007,15000000,30226144,15226144,143197.57437938222
Weekend at Bernie's,7/5/1989,6500000,30218387,23718387,242913.07877813504
The Art of War,8/23/2000,40000000,30199105,-9800895,173857.8295912493
When the Game Stands Tall,8/22/2014,15000000,30127963,15127963,126571.59361595758
Godsend,4/30/2004,25000000,30114487,5114487,159251.6499206769
Double Impact,7/31/1991,15000000,30102717,15102717,220371.28111273792
Road House,5/19/1989,15000000,30050028,15050028,242143.65834004837
Shaun of the Dead,4/9/2004,4000000,30039392,26039392,159784.0
Sophie's Choice,12/8/1982,12000000,30036000,18036000,307745.9016393443
Laws of Attraction,4/4/2004,28000000,30016165,2016165,159660.45212765958
Solaris,11/27/2002,47000000,30002758,-16997242,165852.72526257602
Chinatown,6/20/1974,6000000,30000000,24000000,607287.4493927126
Quo Vadis,11/8/1951,8250000,30000000,21750000,1136363.6363636365
Igor,9/19/2008,25000000,30000000,5000000,138521.42233796456
Airport '77,3/11/1977,6000000,30000000,24000000,504201.6806722689
Bob & Carol & Ted & Alice,9/17/1969,2000000,30000000,28000000,804289.544235925
Night of the Living Dead,10/1/1968,114000,30000000,29886000,849858.35694051
A Nightmare on Elm Street Part 2: Freddy's Revenge,10/31/1985,3000000,29999213,26999213,275222.1376146789
Those Magnificent Men in Their Flying Machines or How I Flew from London to Paris in 25 hours 11 minutes,6/3/1965,5600000,29950000,24350000,947784.8101265823
Leap Year,1/8/2010,19000000,29922472,10922472,138090.757636591
Keeping Up with the Joneses,10/20/2016,40000000,29918745,-10081255,123962.59835179176
Neighbors,12/18/1981,8500000,29916207,21416207,317245.03711558855
Pulse,8/11/2006,38000000,29907685,-8092315,146678.20009808728
The Four Feathers,9/8/2002,35000000,29882645,-5117355,165097.4861878453
Amour,7/1/2012,8900000,29844753,20944753,130267.27163209721
The Fox and the Hound,7/10/1981,12000000,29800000,17800000,325327.51091703057
Serpico,12/5/1973,3000000,29800000,26800000,645021.645021645
God's Not Dead,3/21/2014,17000000,29789000,12789000,125653.80981305258
Mystery Men,8/6/1999,68000000,29762011,-38237989,178108.98264512268
The World According to Garp,8/13/1982,17000000,29712172,12712172,304116.3971340839
Angel Eyes,5/15/2001,53000000,29700000,-23300000,167135.6218345526
The Raven,3/9/2012,26000000,29657751,3657751,129288.51485666458
Tora! Tora! Tora!,1/26/1970,25485000,29548291,4063291,777586.6052631579
In the Valley of Elah,8/31/2007,23000000,29541790,6541790,141694.03808336132
W.,10/17/2008,25100000,29506464,4406464,138902.97281393432
La vérité si je mens !,4/1/1997,4000000,29456000,25456000,183870.1622971286
Twilight Zone: The Movie,6/24/1983,10000000,29450919,19450919,294803.99399399396
The Pledge,1/9/2001,35000000,29400000,-5600000,167904.05482581383
The Evil Dead,10/15/1981,350000,29400000,29050000,314775.1605995717
A Low Down Dirty Shame,11/23/1994,10000000,29392418,19392418,196342.13760855046
Veer-Zaara,11/12/2004,7000000,29385320,22385320,153849.84293193716
Baby Boy,6/27/2001,16000000,29381649,13381649,165530.41690140846
The Frighteners,7/18/1996,30000000,29359216,-640784,186644.7298156389
Confessions of a Teenage Drama Queen,2/17/2004,15000000,29331068,14331068,156515.83778014942
Nocturnal Animals,11/4/2016,22500000,29252978,6752978,121204.12010623443
Fan,4/15/2016,16000000,29251596,13251596,122258.10307572066
Bulworth,5/15/1998,30000000,29202884,-797116,179378.89434889433
Masterminds,9/29/2016,25000000,29200000,4200000,120796.42905898753
Cloclo,3/14/2012,27563396,29193330,1629934,127263.94120108809
Raising Arizona,3/1/1987,6000000,29180280,23180280,260305.79839429082
The Rose,11/7/1979,9250000,29174648,19924648,384382.7140974967
Yu-Gi-Oh! The Movie,8/13/2004,20000000,29170410,9170410,153933.56200527705
The Last Picture Show,10/3/1971,1300000,29133000,27833000,712298.2885085575
Far from Heaven,9/1/2002,13500000,29027914,15527914,160375.21546961326
New in Town,1/30/2009,8000000,29010817,21010817,136719.01052343857
A Few Best Men,10/14/2011,12468389,29007412,16539023,128112.72805967645
The Out-of-Towners,4/2/1999,75000000,29000000,-46000000,174488.56799037306
Case 39,8/13/2009,27000000,29000000,2000000,134362.51934356958
Shorts,8/21/2009,40000000,28972508,-11027492,134151.23466793846
Drive Angry,2/24/2011,50000000,28931401,-21068599,129466.10014006542
James and the Giant Peach,4/12/1996,38000000,28921264,-9078736,185036.87779910426
The Guns of Navarone,4/27/1961,6000000,28900000,22900000,969798.6577181207
Big Eyes,12/24/2014,10000000,28883511,18883511,123588.55746725602
Draft Day,4/11/2014,25000000,28831145,3831145,121613.45498413984
Agent Cody Banks 2: Destination London,6/24/2004,26000000,28818995,2818995,152159.42449841605
Boiler Room,2/18/2000,26000000,28780255,2780255,168108.96612149535
Starman,12/13/1984,22000000,28744356,6744356,272975.84045584046
The Last Starfighter,7/13/1984,15000000,28733290,13733290,276016.2343900096
Wrong Turn,5/30/2003,12600000,28650575,16050575,155963.93576483396
Hoosiers,11/14/1986,9000000,28607524,19607524,259126.1231884058
Super Size Me,1/17/2004,65000,28575078,28510078,153464.4360902256
Go,4/9/1999,6500000,28451622,21951622,171189.06137184118
Taare Zameen Par,12/21/2007,2600000,28430000,25830000,134688.26985029373
A Man for All Seasons,12/12/1966,3900000,28350000,24450000,861702.1276595745
The Shawshank Redemption,9/23/1994,25000000,28341469,3341469,189575.04347826086
Thunderbirds,7/23/2004,57000000,28283637,-28716363,149254.0211081794
Taxi Driver,2/7/1976,1300000,28262574,26962574,506497.7419354839
The Master,9/7/2012,32000000,28258060,-3741940,122114.11063623831
Friday,4/26/1995,3500000,28215918,24715918,185387.1090670171
Ernest Saves Christmas,11/11/1988,6000000,28202109,22202109,234431.49625935164
East Is East,5/14/1999,3800000,28200000,24400000,169675.0902527076
Cirque du Freak: The Vampire's Assistant,10/23/2009,40000000,28169671,-11830329,130216.20209864558
The Thing,10/12/2011,35000000,28128670,-6871330,124231.71878933492
The Deep End of the Ocean,3/12/1999,38000000,28121100,-9878900,170430.9090909091
The Tailor of Panama,2/11/2001,21000000,28008462,7008462,159320.03412969282
Populärmusik från Vittula,9/24/2004,2224000,28000000,25776000,146673.6511262441
Vertigo,5/9/1958,2479000,28000000,25521000,968858.1314878893
Tristan & Isolde,4/7/2006,31000000,28000000,-3000000,138957.81637717123
Menace II Society,5/26/1993,3500000,27900000,24400000,193213.29639889195
Wolf Creek,1/1/2005,1000000,27762648,26762648,145582.84216046147
Love & Basketball,4/21/2000,20000000,27728118,7728118,161679.98833819243
Dirty Dancing: Havana Nights,2/27/2004,25000000,27685016,2685016,147732.2091782284
The Quiet American,11/22/2002,30000000,27674124,-2325876,152980.23217247098
Ice Princess,3/17/2005,25000000,27645491,2645491,142063.16032887975
The Last Castle,10/19/2001,72000000,27642707,-44357293,155821.3472378805
Lakeview Terrace,9/19/2008,20000000,27640028,7640028,127624.53306737219
The Road,11/25/2009,32000000,27635305,-4364695,127971.44233129118
Goal!: The Dream Begins,6/6/2005,30000000,27610873,-2389127,141958.21593830333
Carnage,9/16/2011,25000000,27603069,2603069,121910.37492105414
Poetic Justice,7/23/1993,14000000,27515786,13515786,190026.14640883976
Dick,8/4/1999,13000000,27500000,14500000,164572.11250748055
A Dangerous Method,9/30/2011,15000000,27462041,12462041,121287.51750058519
Escape to Victory,6/17/1981,10000000,27453418,17453418,299709.8034934498
The Incredible Burt Wonderstone,3/14/2013,30000000,27437881,-2562119,117873.98452569671
Now and Then,10/20/1995,12000000,27400000,15400000,178385.4166666667
Desperately Seeking Susan,3/29/1985,5000000,27400000,22400000,256314.31244153413
Irrational Man,7/17/2015,11000000,27391084,16391084,114935.98415549102
Ella Enchanted,4/9/2004,31000000,27388767,-3611233,145684.93085106384
In the Heat of the Night,8/2/1967,2000000,27379978,25379978,817312.776119403
Brown Sugar,10/5/2002,8000000,27362712,19362712,150925.0523993381
Mandela: Long Walk to Freedom,12/6/2013,35000000,27330000,-7670000,117271.47509751168
Экипаж,4/21/2016,10000000,27305571,17305571,113664.75737733579
Sorority Row,9/9/2009,12500000,27206120,14706120,125972.3386226727
Dark City,2/27/1998,27000000,27200316,200316,167696.15289765722
The Bridge on the River Kwai,10/2/1957,3000000,27200000,24200000,961130.74204947
A Passage to India,12/14/1984,8000000,27187653,19187653,258192.33618233618
Khumba,7/18/2013,20000000,27187375,7187375,116246.46716008842
American Ultra,8/19/2015,28000000,27139524,-860476,114057.97137994075
The Eagle,2/8/2011,25000000,27122040,2122040,122552.8107758835
Flash Gordon,9/1/1980,35000000,27107960,-7892040,322713.8095238095
Stay Alive,3/24/2006,9000000,27105095,18105095,134516.6004962779
All Dogs Go to Heaven,11/17/1989,13800000,27100027,13300027,214909.01665344965
Fast Times at Ridgemont High,8/13/1982,4500000,27092880,22592880,277306.857727738
The Musketeer,9/7/2001,40000000,27053815,-12946185,151731.99663488503
The Big Hit,4/24/1998,13000000,27007143,14007143,165891.54176904177
Clerks II,5/25/2006,5000000,26888376,21888376,132520.33514046328
Glory,12/15/1989,18000000,26828365,8828365,212754.6788263283
Shoot 'Em Up,7/26/2007,39000000,26820641,-12179359,128996.86413328395
The Invisible,4/27/2007,30000000,26810113,-3189887,128926.38579651741
CHiPS,3/23/2017,25000000,26800152,1800152,109601.31520832311
Garden State,7/28/2004,2500000,26781723,24281723,141328.35356200527
Overboard,12/16/1987,1880006,26713187,24833181,230883.2065687122
Event Horizon,8/15/1997,60000000,26673242,-33326758,165878.37064676615
The Bye Bye Man,1/12/2017,7400000,26667197,19267197,109814.30906897162
A Clockwork Orange,12/18/1971,2200000,26589000,24389000,646934.3065693431
An American Werewolf in Paris,12/25/1997,22000000,26570463,4570463,164421.18193069307
A Cure for Wellness,2/15/2017,40000000,26559557,-13440443,109028.03742154242
The Great Gatsby,3/27/1974,6500000,26533200,20033200,552775.0
Монгол,9/20/2007,18000000,26527510,8527510,126964.7643297469
Damien: Omen II,6/9/1978,6800000,26518355,19718355,406723.236196319
The Woman in Black 2: Angel of Death,12/30/2014,1000000,26501323,25501323,113395.50377181685
Billy Madison,2/10/1995,10000000,26488734,16488734,175538.3300198807
The Gauntlet,12/21/1977,5500000,26414658,20914658,422634.528
House Party,3/9/1990,2500000,26386000,23886000,205019.42501942505
Saving Grace,1/24/2000,10000000,26330482,16330482,155067.6207302709
Houseguest,1/6/1995,10500000,26325256,15825256,175151.40385894876
Sinbad: Legend of the Seven Seas,7/2/2003,60000000,26288320,-33711680,142948.9940184883
Private Lessons,8/21/1981,2800000,26279000,23479000,281963.5193133047
Aloha,5/27/2015,37000000,26250020,-10749980,109999.32952840703
Blood Work,8/4/2002,50000000,26199517,-23800483,144989.02600996126
Zwartboek,9/1/2006,21000000,26193068,5193068,129093.48447511089
The Whole Ten Yards,4/7/2004,40000000,26155781,-13844219,139126.49468085106
Your Highness,4/8/2011,49900000,26121638,-23778362,116144.69156002952
An Education,10/29/2009,7500000,26096852,18596852,120634.45661720519
That Awkward Moment,1/29/2014,8000000,26049082,18049082,110950.55392046204
The Elephant Man,10/2/1980,5000000,26010864,21010864,306731.88679245283
Jacob's Ladder,11/2/1990,25000000,25965144,965144,194059.3721973094
The Light Between Oceans,9/2/2016,20000000,25956113,5956113,107510.7816823235
The Cotton Club,12/14/1984,58000000,25928721,-32071279,246236.6666666667
Superhero Movie,3/27/2008,35000000,25871834,-9128166,120433.25900857915
From Dusk Till Dawn,1/19/1996,19000000,25836616,6836616,166795.45513234343
The Alamo,4/7/2004,145000000,25819961,-119180039,137340.21808510637
Candyman,10/16/1992,6000000,25792310,19792310,181635.98591549296
De rouille et d'os,5/17/2012,15400000,25762027,10362027,112263.60261114355
The Last Dragon,3/22/1985,10000000,25754284,15754284,240919.40130963517
RockNRolla,9/4/2008,18000000,25739015,7739015,117646.3207836075
Can't Hardly Wait,6/12/1998,10000000,25605015,15605015,157085.98159509202
Apollo 18,7/20/2011,5000000,25562924,20562924,112838.17343132712
Halloween II,10/30/1981,2500000,25533818,23033818,272506.06189967983
Er ist wieder da,10/8/2015,3196621,25513752,22317131,107273.65685887032
A Nightmare on Elm Street,11/14/1984,1800000,25504513,23704513,242208.10066476735
All About the Benjamins,3/8/2002,14000000,25482931,11482931,142521.98545861297
Mimic,8/22/1997,30000000,25480490,-4519510,158067.55583126552
Dark Water,6/27/2005,30000000,25473093,-4526907,130363.83316274309
The Beguiled,6/23/2017,10500000,25442939,14942939,103939.51859991993
Desperado,8/25/1995,7000000,25405445,18405445,165831.8864229765
The Hitcher,1/19/2007,10000000,25399945,15399945,124816.06789222552
A Lonely Place to Die,4/9/2011,4000000,25345000,21345000,112691.52445910736
The Great Race,7/1/1965,12000000,25333333,13333333,801687.7531645569
And So It Goes,7/20/2014,18000000,25312387,7312387,106420.74483292131
The Last Legion,4/19/2007,67000000,25303038,-41696962,121679.05592236557
North Country,2/12/2005,35000000,25224242,-9775758,131513.25338894682
Don't Tell Mom the Babysitter's Dead,6/7/1991,10000000,25196249,15196249,185266.53676470587
Twisted,2/27/2004,50000000,25195000,-24805000,134445.03735325506
Grimsby,2/24/2016,35000000,25182929,-9817071,105751.97369526145
Dark Skies,2/21/2013,3500000,25174316,21674316,108149.6393482062
Midnight in the Garden of Good and Evil,11/21/1997,35000000,25105255,-9894745,155643.24240545568
The Wood,7/16/1999,6000000,25059640,19059640,149967.9233991622
Wyatt Earp,6/24/1994,63000000,25052000,-37948000,168814.01617250673
Death Proof,5/21/2007,25000000,25037897,37897,120171.13826601136
Free State of Jones,6/24/2016,50000000,25035950,-24964050,104044.20931894876
Singham,7/22/2011,3062000,25034000,21972000,110503.43198922952
Cocoon: The Return,9/13/1988,17500000,25024919,7524919,208889.14023372286
Kingpin,7/4/1996,27000000,25023434,-1976566,159384.92993630574
Before the Devil Knows You're Dead,9/26/2007,18000000,25005257,7005257,119679.02611325956
The Apartment,6/15/1960,3000000,25000000,22000000,844594.5945945946
"\"バトル・ロワイア�?\"\"In the future\"",12/16/2000,4500000,25000000,20500000,142775.55682467163
Logan's Run,6/23/1976,9000000,25000000,16000000,437828.37127845886
Singh Is Kinng,1/1/2008,14000000,25000000,11000000,118438.50672730718
Some Like It Hot,3/18/1959,2883848,25000000,22116152,862068.9655172414
Bhaag Milkha Bhaag,7/12/2013,4600000,25000000,20400000,107022.38052021438
The Hills Have Eyes,7/22/1977,230000,25000000,24770000,408496.73202614376
Pure Luck,8/9/1991,17010000,24941969,7931969,182591.28111273792
Fright Night,8/2/1985,9000000,24922237,15922237,230761.4537037037
Fright Night,8/18/2011,17000000,24922237,7922237,109843.30223148764
Catch-22,6/24/1970,18000000,24911670,6911670,638760.7692307692
The 33,8/6/2015,25000000,24902723,-97277,104494.54925393175
Stay Hungry,4/23/1976,5000000,24854765,19854765,439907.34513274336
Seed of Chucky,11/11/2004,12000000,24829644,12829644,129998.13612565445
Race,2/19/2016,5000000,24804129,19804129,104161.25930156384
Thank You for Smoking,9/5/2005,6500000,24793509,18293509,124715.84004024144
The Craft,5/3/1996,15000000,24769466,9769466,158170.2809706258
Rendition,9/7/2007,27500000,24748670,-2751330,118704.35032855293
Big Miracle,2/2/2012,40000000,24719215,-15280785,108578.09569407413
Sparkle,8/17/2012,14000000,24637469,10637469,106468.12326334121
Mad Max 2,12/24/1981,2000000,24600832,22600832,260878.38812301168
Sicko,5/18/2007,9000000,24538513,15538513,117774.30982183997
Kidnap,8/4/2017,21000000,24527158,3527158,99899.22572183823
Notorious,8/15/1946,2000000,24464742,22464742,1211125.8415841584
Sling Blade,8/30/1996,1000000,24444121,23444121,154905.70975918885
Lucky Lady,12/25/1975,13000000,24441725,11441725,439599.37050359714
The Darjeeling Limited,9/29/2007,16000000,24377151,8377151,116672.81368457327
The Next Best Thing,3/3/2000,25000000,24362772,-637228,142305.9112149533
Renaissance Man,6/3/1994,40000000,24332324,-15667676,164407.5945945946
Trance,3/27/2013,20000000,24261569,4261569,104336.92281889296
Fair Game,5/20/2010,22000000,24188922,2188922,110976.17507397977
Hearts in Atlantis,9/7/2001,31000000,24185781,-6814219,135646.55636567582
Wanderlust,2/23/2012,35000000,24159934,-10840066,105321.60668201158
Let Me In,10/1/2010,20000000,24145613,4145613,110399.62781935978
Lord of War,9/16/2005,42000000,24127895,-17872105,121123.97088353414
Lionheart,6/7/1990,6000000,24078196,18078196,185359.4765204003
Virtuosity,8/4/1995,30000000,24048000,-5952000,157279.26749509483
Invasion of the Body Snatchers,12/19/1978,3500000,24046533,20546533,352072.2254758419
9 рота,9/19/2005,9500000,24000000,14500000,120481.92771084337
An Unmarried Woman,5/26/1978,2515000,24000000,21485000,368098.15950920247
The Fury,3/10/1978,5500000,24000000,18500000,378548.89589905366
The Rum Diary,10/13/2011,45000000,24000000,-21000000,105997.23523878086
Metegol,7/18/2013,22000000,24000000,2000000,102618.04281737836
Corky Romano,10/12/2001,11000000,23978402,12978402,134937.54642656163
The Founder,11/24/2016,25000000,23964782,-1035218,99261.00102720436
Stormbreaker,7/21/2006,40000000,23937870,-16062130,117400.04904364885
Harold & Kumar Go to White Castle,5/30/2004,9000000,23936908,14936908,126182.96257248288
American History X,10/30/1998,20000000,23875127,3875127,145580.04268292684
House of Wax,4/10/1953,658000,23800000,23142000,894736.8421052631
Silence,12/22/2016,46000000,23737523,-22262477,97750.04426801296
Les Poupées Russes,6/15/2005,13000000,23727301,10727301,121991.264781491
Santa Claus: The Movie,10/29/1985,50000000,23717291,-26282709,217589.82568807338
Network,11/1/1976,3800000,23689877,19889877,408446.1551724138
Sixteen Candles,5/4/1984,6500000,23686027,17186027,229071.82785299805
The Best Years of Our Lives,12/25/1946,2100000,23650000,21550000,1100000.0
The Glass House,9/14/2001,30000000,23619609,-6380391,132471.16657319124
The Losers,4/23/2010,25000000,23580000,-1420000,108076.89134559855
How To Make An American Quilt,10/6/1995,10000000,23574130,13574130,153377.5536759922
Hustle & Flow,7/22/2005,8000000,23563727,15563727,119978.24338085539
Oscar,4/26/1991,35000000,23562716,-11437284,173766.34218289086
Paris,1/19/2008,19000000,23550000,4550000,111246.00246583496
Traitor,8/23/2008,22000000,23530831,1530831,107553.28796113044
Biker Boyz,1/31/2003,24000000,23510601,-489399,128403.06389950847
Ernest Goes to Camp,5/22/1987,3000000,23509382,20509382,207131.11894273126
God's Not Dead 2,4/1/2016,5000000,23507567,18507567,98250.72619440695
Boys on the Side,2/3/1995,21000000,23450000,2450000,155400.92776673293
Caligola,1/21/1979,17500000,23438120,5938120,339191.31693198264
Tomcats,3/30/2001,11000000,23430766,12430766,132452.040700961
Antwone Fisher,12/19/2002,12500000,23367586,10867586,128605.31645569621
The Usual Suspects,7/19/1995,6000000,23341568,17341568,152659.04512753434
Alatriste,9/1/2006,24000000,23321954,-678046,114943.09512074913
The Remains of the Day,11/5/1993,11500000,23237911,11737911,159382.10562414266
Citizen Kane,4/30/1941,839727,23217674,22377947,1612338.4722222222
For the Boys,11/22/1991,40000000,23202444,-16797556,168255.57650471356
The Way Way Back,6/6/2013,4600000,23198652,18598652,99350.12676442374
The Iron Giant,8/6/1999,70000000,23159305,-46840695,138595.48174745662
Air Bud,8/1/1997,3000000,23144499,20144499,143933.4514925373
Whiskey Tango Foxtrot,3/4/2016,35000000,23083334,-11916666,96935.0360304369
Faster,11/23/2010,24000000,23081726,-918274,105309.93388965183
Warrior,9/9/2011,25000000,23057115,-1942885,101622.88608085892
Aquamarine,3/3/2006,12000000,23006849,11006849,115149.39439439439
Las aventuras de Tadeo Jones,8/31/2012,10500000,23000000,12500000,99391.98036360179
Mrs. Brown's Boys D'Movie,6/27/2014,5900000,23000000,17100000,96537.25078698846
Raging Bull,11/14/1980,18000000,23000000,5000000,269005.84795321635
Indigènes,5/25/2006,14500000,22963701,8463701,113177.4322326269
Domino,9/22/2005,50000000,22944502,-27055498,115183.24297188755
Armored,12/4/2009,20000000,22942221,2942221,106239.07033605156
Young Adult,12/16/2011,12000000,22939027,10939027,101202.33384069001
Rounders,9/11/1998,12000000,22921898,10921898,140109.4009779951
Gong fu guan lan,2/7/2008,10000000,22896728,12896728,108160.06197654149
The Wind That Shakes the Barley,6/23/2006,6500000,22889018,16389018,112476.74692874693
Being John Malkovich,9/30/1999,13000000,22863596,9863596,135931.01070154578
A Perfect Getaway,6/8/2009,14000000,22852638,8852638,105949.83610965585
Missing in Action,11/16/1984,1500000,22812411,21312411,216642.07977207977
Ёлки,12/12/2010,5000000,22772019,17772019,103896.90161922447
Convoy,6/27/1978,12000000,22765081,10765081,346500.4718417047
Rudy,9/17/1993,12000000,22750363,10750363,156145.25051475636
American Gigolo,2/8/1980,4800000,22743674,17943674,288259.4930291508
U2 3D,5/19/2007,15000000,22730842,7730842,109098.26639533098
Live by Night,12/25/2016,108000000,22678555,-85321445,93389.26202133924
Bulletproof,9/6/1996,25000000,22611954,-2388046,143295.01901140684
Drive Me Crazy,10/1/1999,8000000,22593409,14593409,134324.66706302023
The Chamber,10/11/1996,50000000,22540359,-27459641,142390.13897662665
Captain Ron,9/18/1992,24000000,22518097,-1481903,158801.81241184767
The Warriors,2/8/1979,4000000,22490039,18490039,325470.8972503618
Xanadu,8/8/1980,20000000,22471595,2471595,269767.0468187275
Baggage Claim,9/27/2013,8500000,22456509,13956509,96154.54343041628
Swimming Pool,5/18/2003,7800000,22441323,14641323,122162.89058247143
City By The Sea,9/6/2002,40000000,22433915,-17566085,123944.2817679558
License to Drive,7/6/1988,8000000,22433275,14433275,189310.33755274263
The First Power,4/6/1990,10000000,22424195,12424195,173965.82622187742
Deuce Bigalow: European Gigolo,8/6/2005,22000000,22400154,400154,114053.73727087576
The Railway Man,12/26/2013,18000000,22309223,4309223,95372.79621744558
Pink Floyd: The Wall,7/14/1982,12000000,22244207,10244207,228145.71282051282
Empire of the Sun,12/9/1987,35000000,22238696,-12761304,192709.67071057193
Emma,8/2/1996,6000000,22231658,16231658,141332.85441830894
Reign Over Me,3/23/2007,20000000,22222308,2222308,107517.23870992713
Dead Silence,3/16/2007,20000000,22217407,2217407,107493.52641204532
Doomsday,3/14/2008,30000000,22211426,-7788574,104021.14008467273
Don Juan DeMarco,10/1/1994,25000000,22200000,-2800000,148494.98327759196
The Sword in the Stone,12/25/1963,3000000,22182353,19182353,717875.501618123
Waitress,5/25/2007,2000000,22179430,20179430,106451.72592535708
Fanaa,5/26/2006,5300000,22175908,16875908,109294.76589452932
A Nightmare on Elm Street 5: The Dream Child,8/11/1989,8000000,22168359,14168359,177916.20385232745
The Marine,10/13/2006,20000000,22165608,2165608,109839.48463825569
Piku,5/8/2015,5500000,22159216,16659216,93182.29641933517
Lock Up,8/4/1989,24000000,22099847,-1900153,177366.34831460676
A Thousand Words,3/7/2012,40000000,22044277,-17955723,96098.71747924949
Little Black Book,8/6/2004,35000000,22034832,-12965168,116278.79683377309
Cousins,2/10/1989,13000000,22030000,9030000,181167.76315789475
முதல்வன்,11/7/1999,7400000,22000000,14600000,130718.954248366
Dil Dhadakne Do,6/5/2015,13000000,22000000,9000000,92189.84403154568
Death Wish,7/24/1974,3000000,22000000,19000000,440000.0
The Big Parade,11/5/1925,245000,22000000,21755000,1222222.2222222222
The Legend of Boggy Creek,8/1/1972,100000,22000000,21900000,523809.5238095238
Wild Child,1/1/2008,20000000,21972336,1972336,104094.82660602615
Friday the 13th: A New Beginning,3/22/1985,2200000,21930418,19730418,205148.9055191768
葉問,12/12/2008,11715578,21888598,10173020,104118.37623913084
Obitaemyy Ostrov,12/18/2008,36500000,21834845,-14665155,103412.59241367225
A Soldier's Story,9/14/1984,6000000,21821347,15821347,207822.3523809524
The Big Wedding,4/25/2013,35000000,21819348,-13180652,93667.38071218529
Melancholia,5/26/2011,7400000,21817298,14417298,96655.61177023064
Mr. 3000,6/15/2004,30000000,21800302,-8199698,114919.88402741171
My Blueberry Nights,5/16/2007,10000000,21786738,11786738,104566.97319920135
Diana,9/19/2013,15000000,21766271,6766271,93199.0742723061
The Caine Mutiny,6/24/1954,2000000,21750000,19750000,808550.185873606
Exodus,3/27/1960,4000000,21750000,17750000,737288.1355932204
Friday the 13th Part 2,5/1/1981,1250000,21722776,20472776,241901.73719376393
Marathon Man,10/5/1976,6500000,21709020,15209020,374939.896373057
The Player,4/3/1992,8000000,21706101,13706101,155599.29032258064
Como agua para chocolate,4/16/1992,2000000,21665468,19665468,155085.6692913386
The Rookie,12/6/1990,10000000,21633874,11633874,161688.14648729446
Consenting Adults,10/16/1992,18000000,21591728,3591728,152054.42253521126
Mud,5/1/2013,10000000,21587700,11587700,92672.94855008693
Black or White,9/6/2014,9000000,21571189,12571189,90623.44400519259
He Got Game,5/1/1998,25000000,21567853,-3432147,132480.66953316954
Black Christmas,12/25/2006,9000000,21510851,12510851,106270.5072721524
The Right Stuff,10/20/1983,27000000,21500000,-5500000,212450.5928853755
Чёрная Молния,12/31/2009,15000000,21500000,6500000,99221.45767858707
Married to the Mob,8/19/1988,10000000,21486757,11486757,179355.23372287146
Rhinestone,6/22/1984,28000000,21435321,-6564679,205910.86455331414
Our Family Wedding,3/12/2010,14000000,21409028,7409028,98373.06266110986
Battlefield Earth,5/10/2000,44000000,21400000,-22600000,124781.34110787172
The Fog,2/8/1980,1000000,21378361,20378361,270955.1457541191
Intersection,1/21/1994,45000000,21355893,-23644107,145575.27607361964
The King and I,6/29/1956,4550000,21300000,16750000,777372.2627737226
The Black Cauldron,7/24/1985,25000000,21288692,-3711308,197117.5185185185
To Die For,5/20/1995,20000000,21284514,1284514,139570.58360655737
Cujo,8/10/1983,5000000,21200000,16200000,211576.84630738522
ATL,3/31/2006,20000000,21170563,1170563,105064.8287841191
Fifty Shades of Black,1/28/2016,20000000,21164799,1164799,89261.14351506258
Mindhunters,5/7/2004,27000000,21148829,-5851171,111839.39185616077
Stir of Echoes,9/10/1999,12000000,21133087,9133087,125867.10541989279
The Jacket,3/4/2005,29000000,21126225,-7873775,109292.42110708742
Beasts of the Southern Wild,6/29/2012,1800000,21107746,19307746,92131.72183811718
The Wiz,10/24/1978,24000000,21049053,-2950947,312300.48961424327
Punchline,10/7/1988,15000000,21032267,6032267,174977.2628951747
Creepshow,11/12/1982,8000000,21028755,13028755,214579.1326530612
Yves Saint Laurent,1/8/2014,12000000,21026290,9026290,89888.20773269037
The Air Up There,1/7/1994,17080000,21011500,3931500,143717.51025991794
Flight of the Phoenix,12/17/2004,45000000,21009180,-23990820,110168.74672260095
Tea with Mussolini,3/25/1999,12000000,21001563,9001563,126363.19494584839
Mickey's Christmas Carol,10/19/1983,3000000,21000000,18000000,207509.8814229249
Arrambam,10/31/2013,9200000,21000000,11800000,90102.07277673137
Where Eagles Dare,12/4/1968,7700000,21000000,13300000,591549.2957746478
Flicka,10/20/2006,15000000,21000000,6000000,104218.36228287841
A Room with a View,12/13/1985,3000000,20966644,17966644,191826.5690759378
Super Mario Bros.,5/28/1993,48000000,20915465,-27084535,144843.9404432133
Amores perros,6/16/2000,2000000,20908467,18908467,120998.07291666666
Jason's Lyric,9/28/1994,7000000,20851521,13851521,139475.0568561873
EuroTrip,2/20/2004,25000000,20796847,-4203153,110975.70437566702
The Dead Zone,10/21/1983,10000000,20766616,10766616,205203.71541501975
Mao's Last Dancer,10/1/2009,25000000,20719451,-4280549,95844.84473371359
Once,3/23/2007,160000,20710513,20550513,100202.78586841875
The Man from Snowy River,3/2/1982,3500000,20659423,17159423,218618.2328042328
Pandorum,9/8/2009,33000000,20645327,-12354673,95593.93709282351
Boys and Girls,6/16/2000,16000000,20627372,4627372,119371.36574074073
Keanu,4/21/2016,15000000,20566327,5566327,85611.34167814876
Child's Play 3,8/30/1991,13000000,20560255,7560255,149856.0860058309
Country Strong,12/22/2010,15000000,20529194,5529194,93220.02697265953
Porky's Revenge,3/22/1985,9000000,20518905,11518905,191944.85500467726
The Circle,4/27/2017,18000000,20497844,2497844,83755.94627614584
Top Secret!,6/8/1984,9000000,20458340,11458340,197283.89585342334
My Life in Ruins,2/6/2009,17000000,20455276,3455276,96399.39112034798
The Adventures of Ford Fairlane,7/11/1990,49000000,20423389,-28576611,156621.08128834356
The Boy in the Striped Pyjamas,5/7/2008,12500000,20416563,7916563,94245.37002843531
Duel in the Sun,12/31/1946,6000000,20400000,14400000,948837.2093023256
Showgirls,9/22/1995,45000000,20350754,-24649246,132405.68640208198
The Way Back,9/3/2010,30000000,20348249,-9651751,93153.0038134216
Reno 911!: Miami,2/23/2007,10000000,20342161,10342161,99059.96045814017
The People vs. Larry Flynt,10/12/1996,36000000,20300385,-15699615,128239.95578016424
Down with Love,5/8/2003,35000000,20298207,-14701793,110616.931880109
Labor Day,12/27/2013,18000000,20275812,2275812,86679.8850869543
Action Jackson,2/12/1988,7000000,20256975,13256975,174629.0948275862
Mobsters,7/26/1991,23000000,20246790,-2753210,148219.54612005857
Le peuple migrateur,12/12/2001,35866397,20217080,-15649317,114414.714204867
Appaloosa,9/12/2008,20000000,20211394,211394,92381.00766512938
Love and Death,6/10/1975,3000000,20173742,17173742,376375.7835820895
The Neverending Story,4/5/1984,27000000,20158808,-6841192,195526.75072744908
Juice,1/17/1992,5000000,20146880,15146880,145359.88455988458
The Namesake,9/2/2006,12000000,20138836,8138836,99254.9827501232
Mulholland Drive,5/16/2001,15000000,20117339,5117339,113018.75842696629
Flipper,5/17/1996,25530000,20080020,-5449980,128143.07594128909
Reality Bites,2/18/1994,11500000,20079850,8579850,136412.02445652176
Life of Brian,8/17/1979,4000000,20045115,16045115,268701.27345844504
Dostana,11/13/2008,10000000,20000000,10000000,94150.87678004001
Breaking Away,5/24/1979,2300000,20000000,17700000,276625.17289073305
Barry Lyndon,12/18/1975,11000000,20000000,9000000,359712.23021582735
Sweet Charity,1/1/1969,8000000,20000000,12000000,561797.7528089888
Shane,4/23/1953,3100000,20000000,16900000,749063.670411985
Eyes of Laura Mars,8/2/1978,7000000,20000000,13000000,303030.30303030304
The Sand Pebbles,12/20/1966,12000000,20000000,8000000,607902.7355623101
Middle School: The Worst Years of My Life,10/7/2016,8500000,19985196,11485196,82676.03804260142
Ballistic: Ecks vs. Sever,9/20/2002,70000000,19924033,-50075967,109895.3833425262
Nighthawks,3/17/1981,5000000,19905359,14905359,223404.70258136926
Hard Rain,1/16/1998,70000000,19870567,-50129433,122733.58245830759
Altered States,12/25/1980,15000000,19853892,4853892,228205.6551724138
Blindness,5/14/2008,25000000,19844979,-5155021,91606.86786808966
My Soul to Take,10/8/2010,25000000,19829957,-5170043,90667.39670158336
Vampire in Brooklyn,10/26/1995,14000000,19800000,5800000,128906.25
Le scaphandre et le papillon,5/22/2007,14000000,19777647,5777647,94924.2003916449
Dad,10/27/1989,19000000,19738015,738015,156775.3375694996
Color of Night,8/19/1994,40000000,19726050,-20273950,132035.140562249
Fire in the Sky,3/12/1993,19885552,19724334,-161218,137356.08635097495
Broken City,1/18/2013,56000000,19701164,-36298836,84858.09291627542
Summer Catch,8/22/2001,34000000,19693891,-14306109,110453.6791923724
Left Behind,10/3/2014,16000000,19682924,3682924,82898.85567718052
Rockstar,11/11/2011,10920000,19660000,8740000,86902.70963179065
The Thing,6/25/1982,15000000,19629760,4629760,201330.87179487178
The Astronaut's Wife,8/26/1999,75000000,19598588,-55401412,116727.74270399047
The Serpent and the Rainbow,2/5/1988,7000000,19595031,12595031,168922.68103448275
The Guard,7/7/2011,6000000,19560274,13560274,86579.76646807305
Margin Call,9/28/2011,3500000,19504039,16004039,86140.59208288984
Valiant,3/25/2005,35000000,19478106,-15521894,100093.0421377184
Friday the 13th Part VI: Jason Lives,8/1/1986,3000000,19472057,16472057,177502.79854147675
Eega,6/6/2012,5990000,19450000,13460000,84757.58024734397
Seven Psychopaths,9/7/2012,15000000,19422261,4422261,83931.17321429343
Get Carter,10/6/2000,63600000,19412993,-44187007,111568.92528735632
Saving Silverman,2/9/2001,22000000,19351569,-2648431,110077.1843003413
Duplex,9/26/2003,40000000,19322135,-20677865,104443.97297297297
Joe,7/15/1970,106000,19319254,19213254,495365.4871794872
Celda 211,11/6/2009,5700000,19300483,13600483,89217.78301668746
Superman IV: The Quest for Peace,7/23/1987,17000000,19300000,2300000,168706.29370629368
Cursed,2/25/2005,35000000,19294901,-15705099,99818.42214174857
2046,5/20/2004,12000000,19271312,7271312,101588.36056931998
Best Defense,7/20/1984,18000000,19265302,1265302,184356.95693779906
Amelia,10/22/2009,40000000,19258519,-20741481,89023.80159940831
La migliore offerta,1/1/2013,13500000,19255873,5755873,83619.3894389439
The Replacement Killers,2/6/1998,30000000,19204929,-10795071,118622.16800494131
Martin Lawrence Live: Runteldat,8/1/2002,3000000,19184015,16184015,106164.99723298285
Beerfest,8/25/2006,17500000,19179969,1679969,94529.17200591424
Friday the 13th Part VII: The New Blood,5/13/1988,2800000,19170001,16370001,163148.94468085107
Species II,4/10/1998,35000000,19165560,-15834440,117941.9076923077
Tuck Everlasting,10/11/2002,15000000,19158074,4158074,105670.56811913954
Buried,9/24/2010,1987650,19152480,17164830,87569.80673125722
The Bling Ring,6/12/2013,15000000,19145732,4145732,81993.16499931479
The Way of the Gun,9/8/2000,8500000,19125401,10625401,110105.93552101325
Johnny Mnemonic,5/26/1995,25000000,19075720,-5924280,125086.68852459016
The Drop,9/12/2014,12600000,19054534,6454534,80050.64046279686
Три богатыря и Шамаханская царица,12/29/2010,3000000,19010585,16010585,86324.24860255286
சிவாஜி,6/14/2007,12000000,19000000,7000000,91191.82921210259
Die Welle,3/11/2008,7500000,19000000,11500000,88981.30455958938
Jane Austen's Mafia!,7/24/1998,10000000,19000000,9000000,116279.06976744186
Beneath the Planet of the Apes,5/1/1970,3000000,18999718,15999718,492220.67357512953
Akeelah and the Bee,4/28/2006,8000000,18948425,10948425,93572.46913580247
A Mighty Heart,1/1/2007,16000000,18928871,2928871,93514.69745474667
FearDotCom,8/9/2002,40000000,18902015,-21097985,104604.39955727725
Above the Law,4/8/1988,7500000,18869631,11369631,161141.16994022205
The Edge of Seventeen,11/18/2016,9000000,18803648,9803648,77883.82650187217
Cocktail,7/13/2012,6400000,18800000,12400000,82058.80298903554
Sex Drive,10/16/2008,19000000,18755936,-244064,88294.39096151582
A Mighty Wind,4/16/2003,6000000,18750246,12750246,102181.17711171662
The Choice,2/4/2016,10000000,18730891,8730891,78996.29709292273
3000 Miles to Graceland,2/23/2001,62000000,18720175,-43279825,106243.8989784336
Year of the Dragon,8/16/1985,24000000,18707466,-5292534,172737.45152354572
Eye in the Sky,9/11/2015,13000000,18704595,5704595,78608.90121666771
リン�?2,1/23/1999,6000000,18686644,12686644,113596.62006079027
Casualties of War,8/18/1989,22500000,18671317,-3828683,149370.536
Glee: The Concert Movie,8/11/2011,9000000,18663238,9663238,82382.034474387
Legends of Oz: Dorothy's Return,6/13/2013,70000000,18662027,-51337973,79921.65872961491
Anywhere But Here,11/12/1999,23000000,18653615,-4346385,110835.50207961972
Waiting...,10/7/2005,3000000,18637690,15637690,93562.70080321285
Geronimo: An American Legend,12/10/1993,35000000,18635620,-16364380,127816.32373113853
Paradise,9/18/1991,34000000,18634643,-15365357,135623.31149927218
The Fan,8/15/1996,55000000,18626419,-36373581,118413.34392879847
An Unfinished Life,9/9/2005,30000000,18618284,-11381716,93653.34004024144
Fired Up!,2/20/2009,20000000,18599102,-1400898,87439.18687032518
Empire,12/6/2002,4000000,18591272,14591272,102770.98949695965
Keeping Mum,12/2/2005,169000,18564702,18395702,94332.83536585365
The Thirteenth Floor,4/16/1999,16000000,18564088,2564088,111697.28038507822
The Quick and the Dead,2/9/1995,32000000,18552460,-13447540,122945.39430086149
An Ideal Husband,4/15/1999,14000000,18535191,4535191,111523.41155234657
Project X,4/17/1987,18000000,18532286,532286,163857.5243147657
Super Troopers,1/18/2001,3000000,18492362,15492362,105189.77246871444
[REC]²,9/15/2009,5600000,18469680,12869680,85520.05148887109
Ladyhawke,3/27/1985,20000000,18432000,-1568000,172422.82507015902
Repo Men,3/18/2010,32000000,18409891,-13590109,84445.55500002294
Sleeper,12/17/1973,2000000,18344729,16344729,393663.71244635194
The Dressmaker,10/1/2015,11930000,18340000,6410000,77111.31106046973
Walk Hard: The Dewey Cox Story,12/21/2007,35000000,18317151,-16682849,86778.24047754405
Good Guys Wear Black,6/1/1978,1000000,18300000,17300000,280674.84662576683
Crimes and Misdemeanors,10/13/1989,19000000,18254702,-745298,145339.98407643312
Simon Birch,9/11/1998,20000000,18253415,-1746585,111573.44132029341
Daddy Day Camp,8/8/2007,6000000,18197398,12197398,87522.41519452474
Antitrust,1/12/2001,30000000,18195610,-11804390,103915.53398058252
魔女の宅急便,7/29/1989,6900000,18172849,11272849,145849.51043338684
StreetDance 3D,5/19/2010,5773100,18144030,12370930,83242.86009221664
Kaminey,8/14/2009,9000000,18130000,9130000,83999.74054134196
Another Year,11/5/2010,8000000,18124262,10124262,82833.69972075337
New Nightmare,10/13/1994,14000000,18090181,4090181,121004.55518394649
Mere Brother Ki Dulhan,9/9/2011,5510000,18050000,12540000,79554.31951306586
Delhi Belly,7/1/2011,4090000,18035000,13945000,79828.43636299254
Everything You Always Wanted to Know About Sex *But Were Afraid to Ask,8/6/1972,2000000,18016290,16016290,428959.28571428574
रान्झाना,6/21/2013,6400000,18000000,11600000,77056.11397455436
Ayan,4/3/2009,3230939,18000000,14769061,84411.93021947102
स्पेशल 26,2/7/2013,7100000,18000000,10900000,77530.7323208394
Admission,3/21/2013,13000000,18000000,5000000,77409.03363422511
Dope,6/19/2015,700000,17986781,17286781,75367.607498722
The Howling,4/3/1981,1000000,17985893,16985893,201861.874298541
Turbo: A Power Rangers Movie,3/27/1997,10000000,17979739,7979739,112233.07740324594
The Crow: City of Angels,8/29/1996,13000000,17917287,4917287,113544.27756653991
Bedknobs and Broomsticks,10/7/1971,20000000,17900000,-2100000,437652.81173594133
Soul Kitchen,9/9/2009,5000000,17872796,12872796,82756.30298792882
City of Ember,10/7/2008,55000000,17869048,-37130952,82508.19815951203
Любовь-морковь 2,12/23/2008,3000000,17850711,14850711,84543.22899646212
The Quiet Ones,4/1/2014,200000,17834867,17634867,75229.74876830667
School for Scoundrels,9/29/2006,20000000,17807569,-2192431,88243.6521308226
Auf der anderen Seite,9/27/2007,3800000,17804565,14004565,85215.4008883103
Flyboys,9/22/2006,60000000,17800000,-42200000,88206.1446977205
Bad Santa 2,11/23/2016,26000000,17782178,-8217822,73652.94575698333
Halloween 4: The Return of Michael Myers,10/21/1988,5000000,17768757,12768757,147703.7157107232
Unforgettable,4/20/2017,12000000,17768012,5768012,72601.61890713553
The Rage: Carrie 2,3/11/1999,21000000,17762705,-3237295,107652.75757575757
Blackhat,1/13/2015,70000000,17752940,-52247060,75962.38024534995
Deception,4/24/2008,25000000,17741298,-7258702,81896.01720890727
Joyeux Noël,11/9/2005,22000000,17709155,-4290845,89621.22975708502
Shame,10/2/2011,6500000,17693675,11193675,78145.026300564
Nebraska,9/21/2013,12000000,17654912,5654912,75595.00912025897
Frantic,2/16/1988,20000000,17637950,-2362050,151398.71244635194
The Postman,12/25/1997,80000000,17626234,-62373766,109073.23019801981
Swing Vote,8/1/2008,21000000,17600000,-3400000,80333.75021680983
Cat on a Hot Tin Roof,2/17/1958,3000000,17570324,14570324,610080.6944444444
Каникулы строгого режима,8/25/2009,5000000,17566040,12566040,81335.93247178993
十三人の刺客,9/9/2010,6000000,17555141,11555141,80366.33110387798
Elle s'appelait Sarah,9/16/2010,10000000,17511906,7511906,80068.7025343947
Sabotage,3/28/2014,35000000,17508518,-17491482,73853.16697037187
Disturbing Behavior,7/24/1998,15000000,17507368,2507368,107144.23500611995
In the Land of Women,4/16/2007,10000000,17500000,7500000,84155.24960447031
Annapolis,1/27/2006,26000000,17496992,-8503008,88057.332662305
Half Baked,1/16/1998,8000000,17460020,9460020,107844.47189623224
Capitalism: A Love Story,9/6/2009,20000000,17436509,-2563491,80736.16583861574
A Guy Thing,1/17/2003,20000000,17432163,-2567837,95205.69634079738
Monte Carlo,7/1/2011,20000000,17425000,-2575000,77128.38944414444
Extreme Measures,9/27/1996,38000000,17380126,-20619874,109792.33101705622
Outland,5/22/1981,16000000,17374595,1374595,191772.57174392938
Valley Girl,4/8/1983,350000,17343596,16993596,175898.53955375255
Masters of the Universe,8/7/1987,22000000,17336370,-4663630,151541.6958041958
The Phantom,6/6/1996,45000000,17300889,-27699111,110407.71537970645
The Matador,5/12/2005,10000000,17297244,7297244,88977.59259259258
Max Keeble's Big Move,10/5/2001,12000000,17292381,5292381,97312.21722003377
A Bronx Tale,9/14/1993,22000000,17287898,-4712102,119144.71399035149
How to Lose Friends & Alienate People,10/2/2008,27000000,17286299,-9713701,79817.42414797781
12 Rounds,3/19/2009,20000000,17280326,-2719674,81036.98180453948
Our Idiot Brother,8/26/2011,10000000,17273593,7273593,76132.35106153229
Hudson Hawk,5/23/1991,65000000,17218080,-47781920,126603.5294117647
The Mission,9/29/1986,24500000,17218023,-7281977,156101.74977334542
Center Stage,5/12/2000,18000000,17200925,-799075,100296.9387755102
Fled,7/19/1996,25000000,17193231,-7806769,109302.16783216782
Angel Heart,3/6/1987,17000000,17185632,185632,153306.26226583408
Adventureland,4/3/2009,9500000,17164377,7664377,80493.23297692741
キャプテンハーロック,9/7/2013,30000000,17137302,-12862698,73189.72961661164
마더,5/28/2009,5000000,17112713,12112713,79338.2863607071
Rushmore,9/17/1998,9000000,17096053,8096053,104244.2256097561
Pet Sematary II,8/28/1992,8000000,17092453,9092453,120965.69709837224
Firestarter,5/11/1984,15000000,17080167,2080167,165185.3675048356
Norm of the North,1/14/2016,18000000,17062499,-937501,72019.19245639804
Ghosts of the Abyss,4/10/2003,13000000,17040871,4040871,92714.20565832427
कभी अलविदा ना कहना,8/11/2006,7400000,17000000,9600000,83374.20304070623
Kingdom of the Spiders,8/24/1977,500000,17000000,16500000,276872.9641693811
Punch-Drunk Love,10/25/2002,25000000,17000000,-8000000,93767.23662437948
Rock Star,9/4/2001,57000000,16991902,-40008098,95299.5064498037
Win a Date with Tad Hamilton!,1/23/2004,17000000,16980098,-19902,91192.79269602579
Death Sentence,8/31/2007,20000000,16974459,-3025541,81416.17823396805
Jason X,7/24/2001,11000000,16951798,5951798,95503.08732394366
Death Wish 3,11/1/1985,9000000,16945171,7945171,155460.28440366974
House of Sand and Fog,12/19/2003,16500000,16942795,442795,91483.77429805616
88 Minutes,2/14/2007,30000000,16930884,-13069116,83198.85601403446
Serving Sara,8/20/2002,29000000,16930185,-12069815,93536.93370165746
Crazy/Beautiful,6/29/2001,13000000,16929123,3929123,95375.34084507042
Michael Collins,10/25/1996,28000000,16900000,-11100000,106557.37704918033
Life or Something Like It,4/26/2002,40000000,16872671,-23127329,93841.32925472748
The Cold Light of Day,4/4/2012,20000000,16863583,-3136417,73292.8396027555
The Good Girl,1/12/2002,8000000,16856124,8856124,95178.56578204404
Death Warrant,9/14/1990,4000000,16853487,12853487,127004.42351168049
Femme Fatale,11/6/2002,35000000,16838910,-18161090,92878.70932156646
House of 1000 Corpses,4/11/2003,7000000,16829545,9829545,91564.44504896626
Taras Bulba,4/2/2009,25000000,16815892,-8184108,78858.99456012005
Стиляги,12/25/2008,15000000,16810383,1810383,79616.10377800827
Rebound,7/1/2005,45000000,16809014,-28190986,86023.6131013306
Jagten,8/28/2012,3800000,16800000,13000000,72599.35956993522
54,8/28/1998,13000000,16757163,3757163,102427.64669926651
Catch That Kid,2/6/2004,18000000,16702864,-1297136,89703.88829215897
The Last Godfather,12/29/2010,13400000,16700000,3300000,75832.2246086921
Dogville,5/19/2003,10000000,16680836,6680836,90804.76864452913
Hellraiser: Bloodline,3/8/1996,4000000,16675000,12675000,107096.98137443802
Baby's Day Out,7/1/1994,50000000,16671505,-33328495,112341.67789757412
Rough Cut,6/19/1980,14000000,16656125,2656125,201404.17170495767
Whip It,9/13/2009,15000000,16633035,1633035,77015.84486662438
Buffy the Vampire Slayer,7/24/1992,7000000,16624456,9624456,117987.62242725337
Paparazzi,9/3/2004,20000000,16605763,-3394237,87444.77619799894
Blue Valentine,12/27/2010,3500000,16566240,13066240,75224.84027553888
Shocker,10/27/1989,5000000,16554699,11554699,131490.85782366956
Battle of the Year,9/21/2013,20000000,16549477,-3450523,70861.74458136727
Krull,7/29/1983,27000000,16519460,-10480540,164864.87025948105
Belle,9/8/2013,10900000,16505460,5605460,70491.26838039026
Spacehunter: Adventures in the Forbidden Zone,5/20/1983,15000000,16500000,1500000,165829.14572864323
Trainspotting,2/23/1996,4000000,16491080,12491080,105915.73538856777
Terminal Velocity,9/23/1994,50000000,16478900,-33521100,110226.7558528428
Pride and Prejudice and Zombies,2/4/2016,28000000,16374328,-11625672,69057.64810573951
Sergeant York,7/2/1941,1400000,16361885,14961885,1113053.4013605444
Tales from the Darkside: The Movie,5/3/1990,3500000,16324573,12824573,126351.18421052632
Muppets from Space,7/14/1999,24000000,16290976,-7709024,97726.31073785243
The Neverending Story II: The Next Chapter,10/24/1990,32000000,16283667,-15716333,121701.54708520179
Cool Hand Luke,6/22/1967,3000000,16217773,13217773,485562.0658682635
Raw Deal,6/6/1986,8500000,16209459,7709459,148031.5890410959
Mohenjo Daro,8/11/2016,15050000,16180000,1130000,67179.0208803026
The Nutcracker: The Untold Story,11/24/2010,90000000,16178959,-73821041,73816.1913321988
Sunshine Cleaning,1/18/2008,5000000,16174377,11174377,76404.87403929274
Catch and Release,10/20/2006,25000000,16158487,-8841513,80191.00248138957
Mo' Better Blues,8/3/1990,10000000,16153593,6153593,122747.66717325228
Devil in a Blue Dress,9/15/1995,27000000,16140822,-10859178,105357.84595300262
Vanity Fair,9/1/2004,23000000,16123851,-6876149,84907.0616113744
No Holds Barred,6/2/1989,8000000,16093651,8093651,129682.92506043514
Over the Top,2/13/1987,25000000,16057580,-8942420,143885.12544802867
Suffragette,10/16/2015,14000000,16002420,2002420,67425.16938011932
Aashiqui 2,4/25/2013,1300000,16000000,14700000,68685.74126939836
Gabbar Singh,5/11/2012,7000000,16000000,9000000,69621.21706590084
Fire Down Below,9/5/1997,60000000,16000000,-44000000,99255.58312655088
Sinbad and the Eye of the Tiger,7/15/1977,3500000,16000000,12500000,262295.08196721313
Goemon,3/17/2009,9000000,16000000,7000000,75032.82686175201
Kahaani,3/9/2012,1200000,16000000,14800000,69749.59893980609
Breakout,5/21/1975,1000000,16000000,15000000,298507.46268656716
Before Sunset,2/10/2004,2700000,15992615,13292615,85889.44683136413
Armed and Dangerous,8/15/1986,12000000,15945534,3945534,145355.82497721058
Next of Kin,10/20/1989,12000000,15942628,3942628,126629.29308975377
Jason Goes to Hell: The Final Friday,8/13/1993,3000000,15938065,12938065,110069.50966850828
The Birth of a Nation,9/9/2016,8500000,15861566,7361566,65698.94958331263
Highlander: Endgame,9/1/2000,25000000,15843608,-9156392,91212.48128957974
The Next Karate Kid,7/18/1994,12000000,15826984,3826984,106221.36912751678
The Long Riders,5/12/1980,10000000,15795189,5795189,193095.22004889976
Kiss Kiss Bang Bang,9/5/2005,15000000,15785148,785148,79402.15291750502
Wishmaster,9/19/1997,5000000,15719109,10719109,97271.71410891089
Leviathan,3/17/1989,25000000,15704614,-9295386,127576.06823720553
High Plains Drifter,4/19/1973,5500000,15700000,10200000,357630.97949886107
The Bonfire of the Vanities,12/21/1990,47000000,15691192,-31308808,116576.46359583952
The Lobster,10/8/2015,4000000,15656193,11656193,65827.13023150212
The Man with the Iron Fists,11/2/2012,15000000,15608545,608545,67798.09400532531
Behind the Candelabra,5/26/2013,23000000,15600000,-7400000,66808.2773742634
A Ghost Story,7/7/2017,100000,15584255,15484255,63664.81334716854
Highlander II: The Quickening,1/30/1991,30000000,15556340,-14443660,115403.11572700295
The Water Diviner,12/25/2014,22500000,15520023,-6979977,66408.03655859688
Legend,7/19/1985,25000000,15502112,-9497888,143538.07407407407
It's Alive,8/15/2008,11000000,15500000,4500000,70748.47320230411
The Conspirator,9/10/2010,25000000,15478800,-9521200,70860.97262851414
The Greatest Story Ever Told,2/15/1965,20000000,15473333,-4526667,495940.16025641025
Before I Go to Sleep,9/3/2014,22000000,15447154,-6552846,64895.55562090652
The Infiltrator,7/13/2016,25000000,15436808,-9563192,64152.168492444776
The Greatest Game Ever Played,9/30/2005,25000000,15431177,-9568823,77465.74799196787
Drowning Mona,3/3/2000,16000000,15427192,-572808,90112.10280373832
Out of the Furnace,12/6/2013,22000000,15400000,-6600000,66080.52383833443
Anonymous,10/21/2011,30000000,15395087,-14604913,68050.59894797331
Mr. Destiny,10/12/1990,20000000,15379253,-4620747,115200.39700374533
Spaced Invaders,4/27/1990,3000000,15369573,12369573,118959.54334365326
Alex & Emma,6/16/2003,30000000,15368897,-14631103,83572.03371397499
No Escape,4/29/1994,20000000,15340000,-4660000,104000.0
Kuch Kuch Hota Hai,10/16/1998,1530000,15306000,13776000,93329.26829268293
The Fountain,9/6/2006,35000000,15304890,-19695110,75430.70478068014
Ida,10/25/2013,2159280,15298355,13139075,65638.73788448915
Brother,9/9/2000,12000000,15250000,3250000,87795.04893494531
Sweet Sweetback's Baadasssss Song,4/23/1971,150000,15200000,15050000,377171.21588089335
Dungeons & Dragons,12/8/2000,35000000,15185241,-19814759,87271.5
The Last Exorcism Part II,2/28/2013,5000000,15179302,10179302,65210.75038771679
Kandagar,2/4/2010,7000000,15172408,8172408,70002.48222532884
Grease 2,6/11/1982,13200000,15171476,1971476,156406.96907216494
The Corruptor,3/12/1999,25000000,15156200,-9843800,91855.75757575757
Extraordinary Measures,1/21/2010,31000000,15134293,-15865707,69826.62717252388
The Dreamers,9/1/2003,15000000,15121165,121165,81647.75917926566
Muriel's Wedding,9/29/1994,3000000,15119639,12119639,101134.70903010033
Halloween: The Curse of Michael Myers,9/29/1995,5000000,15116634,10116634,98351.55497722837
The Invasion,8/17/2007,80000000,15071514,-64928486,72288.90594273106
More American Graffiti,8/3/1979,2500000,15014674,12514674,203450.8672086721
Machete Kills,9/12/2013,12000000,15008161,3008161,64096.6265070532
The Cave,8/25/2005,30000000,15007991,-14992009,75492.91247484909
Parts Per Billion,3/25/2014,500000,15000000,14500000,63271.91739218465
24,5/5/2016,10000000,15000000,5000000,62440.42143121771
Josh,6/9/2000,6900000,15000000,8100000,87006.96055684454
Per qualche dollaro in più,12/18/1965,600000,15000000,14400000,471698.11320754717
Le Hussard sur le toit,9/20/1995,35000000,15000000,-20000000,97592.71307742356
The Egyptian,8/25/1954,5000000,15000000,10000000,559701.4925373134
올드보이,1/1/2003,3000000,14980005,11980005,82443.6158503027
Away We Go,6/5/2009,17000000,14899417,-2100583,69076.96123657234
Elegy,8/8/2008,13000000,14894347,1894347,67984.01997389153
Raise Your Voice,8/10/2004,15000000,14867514,-132486,78456.5382585752
Scouts Guide to the Zombie Apocalypse,10/23/2015,15000000,14860766,-139234,62614.88354063437
Music of the Heart,10/29/1999,27000000,14859394,-12140606,88291.11111111111
Supernova,1/14/2000,90000000,14828081,-75171919,87844.08175355449
Soul Plane,5/28/2004,16000000,14822346,-1177654,78135.71955719558
Little Children,10/6/2006,26000000,14821658,-11178342,73447.26461843408
Prom Night,7/18/1980,1000000,14796236,13796236,177625.88235294117
Surviving Christmas,9/21/2004,45000000,14793624,-30206376,77494.10162388685
The Space Between Us,1/26/2017,30000000,14793385,-15206615,60727.43357019412
Out Cold,11/21/2001,24000000,14782676,-9217324,83659.73967176005
My Left Foot: The Story of Christy Brown,7/21/1989,645180,14743391,14098211,118325.77046548958
Katyń,9/21/2007,5200000,14723313,9523313,70468.05241796531
Orca: The Killer Whale,7/22/1977,6000000,14717854,8717854,240487.81045751632
The Assassination of Jesse James by the Coward Robert Ford,9/2/2007,30000000,14711793,-15288207,70563.5426159528
Criminal,4/14/2016,31500000,14708696,-16791304,61475.52672604394
Flirting with Disaster,3/22/1996,7000000,14702438,7702438,94065.50223928342
Kickboxer,4/20/1989,1500000,14697005,13197005,118715.71082390954
City of Joy,4/15/1992,27000000,14683921,-12316079,105261.08243727598
It Follows,2/4/2015,2000000,14674076,12674076,62516.83267865815
The Secret of NIMH,6/17/1982,7000000,14665733,7665733,150417.77435897436
Reservoir Dogs,9/2/1992,1200000,14661007,13461007,103758.01132342532
Freedomland,2/17/2006,37665000,14655628,-23009372,73351.49149149148
Clue,12/13/1985,15000000,14643997,-356003,133979.84446477584
Pina,2/24/2011,4317946,14624826,10306880,65445.126126005176
Beyond the Lights,9/10/2014,7000000,14618727,7618727,61415.22322722671
Soldier,10/23/1998,75000000,14567883,-60432117,88828.55487804877
Hellraiser,9/11/1987,1000000,14564027,13564027,126643.71304347826
Wild at Heart,5/1/1990,9500000,14560247,5060247,112695.41021671827
Death on the Nile,10/6/1978,7920000,14560084,6640084,216990.81967213115
Per un pugno di dollari,9/12/1964,200000,14500000,14300000,466237.9421221865
King of Kings,10/11/1961,5037000,14483352,9446352,482778.4
Winnie the Pooh,4/13/2011,30000000,14460000,-15540000,64293.52707353294
Unfinished Business,3/5/2015,35000000,14431253,-20568747,61118.558862268605
Night of the Comet,11/16/1984,3000000,14418922,11418922,136931.83285849952
Trapeze,5/30/1956,4000000,14400000,10400000,529411.7647058824
Hit & Run,8/22/2012,2000000,14400000,12400000,62228.022488515904
Halloween III: Season of the Witch,10/22/1982,2500000,14400000,11900000,146938.77551020408
Bastille Day,4/22/2016,20000000,14397593,-5602407,59932.78496767667
Woodlawn,10/15/2015,12000000,14394097,2394097,60520.593849595105
Ishtar,5/15/1987,55000000,14375181,-40624819,127101.51193633954
Awake,11/28/2007,86000000,14373825,-71626175,68435.05399074445
The Buddy Holly Story,5/18/1978,1200000,14363400,13163400,220297.54601226992
Memoirs of an Invisible Man,2/28/1992,40000000,14358033,-25641967,103072.74228284278
Rapid Fire,7/24/1992,10000000,14356479,4356479,101891.26330731015
Barbecue,4/30/2014,6000000,14348529,8348529,60313.27868852459
Hardcore Henry,9/12/2015,10000000,14333790,4333790,60239.92939544853
Supergirl,11/19/1984,35000000,14296438,-20703562,135768.64197530865
The Wizard,12/15/1989,6000000,14278900,8278900,113234.73433782713
The Return of the Living Dead,5/15/1985,4000000,14237000,10237000,132684.06337371856
Scanners,1/14/1981,4100000,14225876,10125876,163515.816091954
Prince of Darkness,10/23/1987,3000000,14182492,11182492,122898.54419410745
Judy Moody and the Not Bummer Summer,6/10/2011,20000000,14166853,-5833147,62762.39356376427
Poltergeist III,6/10/1988,10500000,14144000,3644000,119864.40677966102
Cool World,7/10/1992,30000000,14110589,-15889411,100431.23843416371
Dragonslayer,6/26/1981,18000000,14110013,-3889987,154039.44323144105
Disaster Movie,8/29/2008,25000000,14109284,-10890716,64489.85524469452
The Perfect Weapon,3/15/1991,10000000,14061361,4061361,104158.22962962963
RRRrrrr!!!,1/28/2004,17820000,14054361,-3765639,75479.9194414608
Blues Brothers 2000,2/5/1998,28000000,14051384,-13948616,86790.51266213712
The Arrival,5/31/1996,25000000,14048372,-10951628,89651.38481174219
Love & Friendship,5/27/2016,3000000,14016568,11016568,58155.68961654316
In Too Deep,8/25/1999,7000000,14011454,7011454,83451.18522930316
Ghosts of Mars,8/24/2001,28000000,14010832,-13989168,78580.10095344923
Virus,1/14/1999,75000000,14010690,-60989310,85275.0456482045
Vaaranam Aayiram,11/14/2008,3000000,14000000,11000000,65905.613746028
Rangeela,1/1/1995,2800000,14000000,11200000,93147.03925482369
Arundhati,1/16/2009,2915739,14000000,11084261,65977.67127096558
Micmacs à tire-larigot,10/28/2009,33000000,14000000,-19000000,64715.94323487265
Creepshow 2,5/1/1987,3500000,14000000,10500000,123784.2617152962
Friday the 13th Part VIII: Jason Takes Manhattan,7/28/1989,5000000,14000000,9000000,112359.55056179776
Welcome to Mooseport,2/24/2004,30000000,14000000,-16000000,74706.51013874066
Star!,7/18/1968,14320000,14000000,-320000,400000.0
Children of the Corn,3/9/1984,800000,14000000,13200000,136452.2417153996
Jackie,12/2/2016,9000000,13960394,4960394,57823.29600053017
Vizontele Tuuba,1/21/2004,3000000,13954476,10954476,74943.48012889367
Drop Dead Fred,4/19/1991,6788000,13878334,7090334,102347.5958702065
The Pyramid,12/4/2014,6500000,13865435,7365435,59049.09033609866
My Stepmother is an Alien,12/9/1988,20000000,13854000,-6146000,114970.95435684647
The Spanish Prisoner,9/8/1997,10000000,13835130,3835130,85825.86848635237
Winter's Bone,6/11/2010,2000000,13831503,11831503,63457.44959053059
A United Kingdom,11/25/2016,14000000,13819139,-180861,57238.2244275821
House of the Dead,4/11/2003,7000000,13818181,6818181,75180.52774755168
The Man Who Knew Too Little,11/14/1997,20000000,13801755,-6198245,85459.78328173375
Paranoia,8/14/2013,35000000,13785015,-21214985,58941.30247950846
The Ladies Man,10/13/2000,24000000,13700000,-10300000,78735.63218390805
Nixon,12/22/1995,44000000,13681765,-30318235,88612.46761658031
Mutiny on the Bounty,11/8/1962,19000000,13680000,-5320000,450000.0
American Outlaws,8/17/2001,35000000,13678913,-21321087,76718.52495793605
The Pagemaster,11/23/1994,27000000,13670688,-13329312,91320.5611222445
The Gunman,2/16/2015,40000000,13644292,-26355708,57785.6589262194
Sing Street,3/11/2016,4000000,13624522,9624522,57214.15853392236
Sydney White,9/21/2007,16500000,13620075,-2879925,65187.784776199405
The Crush,4/2/1993,6000000,13609396,7609396,94509.69444444444
Osmosis Jones,8/7/2001,75000000,13596911,-61403089,76602.31549295774
The Little Vampire,10/27/2000,22000000,13555988,-8444012,77863.2280298679
Red Lights,3/2/2012,14000000,13551174,-448826,59074.3094789705
Hoodwinked Too! Hood VS. Evil,4/29/2011,30000000,13521829,-16478171,59840.633906285955
Nefes: Vatan Sağolsun,10/15/2009,2000000,13500000,11500000,62448.826655934725
Mrs. Miniver,6/4/1942,1344000,13500000,12156000,828220.8588957054
Charade,12/5/1963,4000000,13474588,9474588,436070.8090614887
Secrets & Lies,5/24/1996,4500000,13417292,8917292,85624.07147415444
Lords of Dogtown,6/3/2005,25000000,13411957,-11588043,68956.07712082262
Tenacious D in The Pick of Destiny,11/22/2006,22000000,13405595,-8594405,66430.10406342913
The History Boys,10/2/2006,4000000,13401952,9401952,66412.05153617443
Alfie,10/22/2004,60000000,13395939,-46604061,70135.80628272251
One Night with the King,10/13/2006,20000000,13391174,-6608826,66358.64222001981
"\"花木�?\"\"When barbarian hordes threaten her homeland\"",11/26/2009,12000000,13380561,1380561,61961.671505772196
Friends with Money,9/7/2006,6500000,13368437,6868437,65886.82602267126
Transamerica,12/23/2005,1000000,13350369,12350369,67324.09984871406
Mr. Saturday Night,9/23/1992,43000000,13300000,-29700000,93794.0761636107
The Pick-up Artist,9/18/1987,15000000,13290368,-1709632,115267.71899392888
Sugar & Spice,1/24/2001,11000000,13276953,2276953,75523.05460750853
North by Northwest,7/7/1959,4000000,13275000,9275000,454623.2876712329
Body of Evidence,1/15/1993,30000000,13273595,-16726405,93082.71388499299
Lone Star,6/21/1996,5000000,13269963,8269963,84522.05732484076
The Mod Squad,3/26/1999,50000000,13260050,-36739950,79783.69434416367
The Words,9/7/2012,6000000,13231461,7231461,57178.3092127723
ДухLess,10/4/2012,2800000,13218980,10418980,57146.599687874215
Brideshead Revisited,7/25/2008,20000000,13204291,-6795709,60269.89857864035
I Think I Love My Wife,3/16/2007,11000000,13196245,2196245,63846.82561953882
Critters,4/11/1986,2000000,13167232,11167232,121245.23020257827
The Zookeeper's Wife,3/31/2017,20000000,13162475,-6837525,53828.96975348023
Rosewood,2/21/1997,30000000,13130349,-16869651,82064.68125
To Kill a Mockingbird,12/25/1962,2000000,13129846,11129846,431902.8289473684
Frailty,11/17/2001,11000000,13110448,2110448,74196.08375778155
Silent House,1/21/2011,2000000,13101672,11101672,59200.80972757547
Sphere,2/13/1998,75000000,13100000,-61900000,80914.14453366275
Whiplash,10/10/2014,3300000,13092000,9792000,55139.76574444159
Shut In,11/11/2016,10000000,13082071,3082071,54203.05941919098
Clockers,9/15/1995,25000000,13071518,-11928482,85323.22454308094
25th Hour,12/16/2002,15000000,13060843,-1939157,71881.35938359934
The Concorde... Airport '79,8/17/1979,14000000,13015688,-984312,174473.02949061664
They Live,11/23/1988,4000000,13008928,9008928,107957.90871369294
In Cold Blood,12/14/1967,3500000,13007551,9507551,383703.56932153396
Wicker Park,9/3/2004,30000000,13001257,-16998743,68463.7019483939
Hillary's America: The Secret History of the Democratic Party,7/1/2016,5000000,13000000,8000000,54025.30046378643
दि�?से,8/22/1998,5200000,13000000,7800000,79462.10268948655
Suspect Zero,8/27/2004,27000000,13000000,-14000000,68457.08267509216
Torn Curtain,7/13/1966,3000000,13000000,10000000,400000.0
Brokedown Palace,8/13/1999,25000000,13000000,-12000000,77797.72591262717
Jodhaa Akbar,2/15/2008,8376800,13000000,4623200,61409.6828898452
Bølgen,8/28/2015,5904067,12975143,7071076,54530.00903570153
Man's Best Friend,11/19/1993,6000000,12974636,6974636,88989.27297668038
La peggior settimana della mia vita,10/27/2011,11000000,12935800,1935800,57179.861203200286
Gods and Generals,2/21/2003,56000000,12923936,-43076064,70162.51900108578
Perfect,6/7/1985,19000000,12918858,-6081142,120063.73605947956
Living Out Loud,10/30/1998,12000000,12902790,902790,78675.5487804878
Office Space,2/19/1999,10000000,12827813,2827813,77744.32121212121
Marvin's Room,12/18/1996,23000000,12803305,-10196695,80473.31866750472
The Nun's Story,6/18/1959,3500000,12800000,9300000,438356.16438356164
The Sugarland Express,4/5/1974,3000000,12800000,9800000,266666.6666666667
Street Fighter: The Legend of Chun-Li,2/27/2009,50000000,12764201,-37235799,60007.80879041319
Labyrinth,6/27/1986,25000000,12729917,-12270083,116254.9497716895
Atlantic City,9/2/1980,7200000,12729678,5529678,151543.7857142857
Bon Cop Bad Cop,7/6/2006,8000000,12671300,4671300,62266.83046683047
The Spitfire Grill,8/23/1996,6000000,12643776,6643776,80125.32319391634
Triple 9,2/19/2016,20000000,12639297,-7360703,53076.85233399963
Narc,1/14/2002,6500000,12633747,6133747,71336.79841897234
Macbeth,8/16/2015,15000000,12601706,-2398294,52960.58332808002
Frenzy,5/25/1972,3500000,12600000,9100000,302158.2733812949
Hellraiser III: Hell on Earth,9/11/1992,5000000,12534961,7534961,88711.68435951875
Gattaca,9/7/1997,36000000,12532777,-23467223,77746.75558312656
Zoom,8/11/2006,35000000,12506188,-22493812,61334.90926924963
War and Peace,8/21/1956,6000000,12500000,6500000,456204.3795620438
The Weather Man,10/20/2005,20000000,12482775,-7517225,63171.938259109316
The Marrying Man,4/5/1991,26000000,12454768,-13545232,92121.0650887574
People Like Us,6/29/2012,16000000,12434778,-3565222,54275.69138906348
Снежная королева,10/11/2012,7000000,12400000,5400000,53606.09034355451
Roommates,3/1/1995,22000000,12400000,-9600000,81902.24570673711
Undisputed,8/23/2002,20000000,12398628,-7601372,68500.70718232045
Less Than Zero,11/6/1987,1,12396383,12396382,107420.99653379549
Mary Reilly,2/23/1996,47000000,12379402,-34620598,79508.04110468851
The Andromeda Strain,3/12/1971,6500000,12376563,5876563,309414.075
Ready to Rumble,4/7/2000,24000000,12372410,-11627590,72226.56158785755
Seeking Justice,9/2/2011,17000000,12355798,-4644202,54457.45717068698
Escape from the Planet of the Apes,5/20/1971,2500000,12348905,9848905,304160.2216748768
The Interview,12/25/2014,44000000,12342632,-31657368,52812.418969050996
Hot Tub Time Machine 2,2/20/2015,14000000,12314651,-1685349,52154.426369754234
Club Paradise,7/11/1986,15000000,12308521,-2691479,112406.58447488585
Enemy Mine,12/12/1985,40000000,12303411,-27696589,112565.51692589204
A Hard Day's Night,7/6/1964,560000,12299668,11739668,395487.7170418006
True Romance,9/9/1993,12500000,12281551,-218449,84641.97794624398
Lone Wolf McQuade,4/14/1983,5000000,12232628,7232628,124063.16430020284
Whiteout,9/9/2009,40000000,12206028,-27793972,56517.50019678751
Hideaway,3/3/1995,15000000,12201255,-2798745,80589.53104359313
Solomon and Sheba,12/25/1959,5000000,12200000,7200000,416382.25255972694
Their Finest,4/6/2017,32745300,12173470,-20571830,49784.35654577874
Shaft,7/2/1971,4000000,12121618,8121618,297828.45208845206
Cien años de perdón,3/3/2016,6700000,12118661,5418661,50890.518703912116
Foxcatcher,5/19/2014,24000000,12096300,-11903700,50751.64783526263
Hellbound: Hellraiser II,12/23/1988,3000000,12090735,9090735,99840.91659785302
Stoker,2/28/2013,12000000,12077441,77441,51885.059693349314
Sous les jupes des filles,6/4/2014,5000000,12058187,7058187,50591.73963573506
The Three Burials of Melquiades Estrada,11/17/2005,15000000,12036149,-2963851,61159.29369918699
Chasing Amy,4/4/1997,250000,12021272,11771272,75039.15106117354
The Gift,12/22/2000,10000000,12008642,2008642,68581.62193032553
A Most Violent Year,12/30/2014,20000000,12007070,-7992930,51376.595480665965
О чём говорят мужчины,3/4/2010,1950000,12005838,10055838,55166.0287367149
Shootout at Lokhandwala,5/25/2007,11000000,12000000,1000000,57594.839502380586
ദൃശ്യം,12/19/2013,750000,12000000,11250000,51300.46683424819
Soodhu Kavvum,5/1/2013,310000,12000000,11690000,51514.305952048766
Harper,2/23/1966,3500000,12000000,8500000,373831.7757009346
Knockaround Guys,9/7/2001,15000000,12000000,-3000000,67302.29949523274
The King and I,3/19/1999,25000000,12000000,-13000000,72202.16606498195
Hombre,3/21/1967,5860000,12000000,6140000,362537.76435045316
Fantastic Voyage,8/24/1966,5115000,12000000,6885000,366972.4770642202
Sorcerer,6/24/1977,22000000,12000000,-10000000,196721.31147540984
Blow Out,7/24/1981,18000000,12000000,-6000000,130010.83423618635
Roman Holiday,9/2/1953,1500000,12000000,10500000,446096.65427509294
Dhoom,8/27/2004,1500000,12000000,10500000,63191.1532385466
Tales from the Hood,5/24/1995,6000000,12000000,6000000,78688.52459016393
Frankenstein,11/21/1931,291000,12000000,11709000,821917.8082191781
The Night of the Iguana,8/6/1964,3000000,12000000,9000000,387096.77419354836
The Return,11/10/2006,15000000,11992014,-3007986,59513.71712158809
Phantasm,3/28/1979,300000,11988469,11688469,169808.342776204
Bachelorette,8/6/2012,3000000,11947954,8947954,51862.16625647303
L'Empire des loups,4/20/2005,24000000,11875866,-12124134,61089.845679012345
Layer Cake,9/30/2004,6500000,11850214,5350214,62075.50550026191
Most Wanted,10/10/1997,25000000,11838218,-13161782,73256.2995049505
Bananas,4/28/1971,2000000,11833696,9833696,293640.09925558313
Bloodsport,2/26/1988,1500000,11806119,10306119,101340.07725321889
Let's Do It Again,10/11/1975,70000,11800000,11730000,214936.24772313298
This Must Be the Place,10/1/2011,25000000,11790979,-13209021,52075.46561493855
The Hoax,10/14/2006,25000000,11772461,-13227539,58337.269573835474
The Great Escape,6/20/1963,4000000,11744471,7744471,382556.0586319218
Gallipoli,8/13/1981,3000000,11740000,8740000,127193.93282773565
Los amantes pasajeros,3/8/2013,5000000,11724119,6724119,50367.17746474033
Dave Chappelle's Block Party,9/12/2005,3000000,11718595,8718595,58946.65492957746
Used Cars,7/11/1980,8000000,11715321,3715321,141660.4715840387
Torrente 5: Operación Eurovegas,10/3/2014,9272437,11672363,2399926,49160.66005989058
Rock-A-Doodle,8/2/1991,18000000,11657385,-6342615,85339.56808199122
Halloween 5: The Revenge of Michael Myers,10/12/1989,5000000,11642254,6642254,92693.10509554141
English Vinglish,9/14/2012,2840000,11620000,8780000,50214.55703587186
Shopgirl,10/21/2005,10284523,11588205,1303682,58644.76214574899
So I Married an Axe Murderer,7/30/1993,20000000,11585483,-8414517,80010.24171270718
Graveyard Shift,10/26/1990,10500000,11582891,1082891,86568.69207772794
The Order,9/5/2003,35000000,11560806,-23439194,62423.3585313175
Boys Don't Cry,9/2/1999,2000000,11540607,9540607,68735.00297796307
Fair Game,11/3/1995,50000000,11534477,-38465523,75094.25130208334
Shattered,10/11/1991,22000000,11511031,-10488969,83777.51819505094
Rang De Basanti,1/26/2006,2200000,11502151,9302151,57887.02063412179
The River,12/1/1984,18000000,11500000,-6500000,109211.77587844255
Samson and Delilah,12/21/1949,3000000,11500000,8500000,489361.7021276596
Turbulence,1/9/1997,55000000,11466088,-43533912,72068.43494657449
The Ref,3/9/1994,11000000,11439193,439193,77711.90896739131
Fun Size,10/25/2012,14000000,11417362,-2582638,49593.051893615266
The Powerpuff Girls Movie,7/3/2002,10000000,11411644,1411644,63362.820655191565
The Birds,3/28/1963,2500000,11403529,8903529,373886.1967213115
Jennifer Eight,11/6/1992,20000000,11390479,-8609521,80214.64084507042
Thumbelina,3/30/1994,28000000,11373501,-16626499,77160.79375848033
Connie and Carla,4/16/2004,20000000,11341016,-8658984,59973.64357482814
해운대,6/6/2009,16000000,11301649,-4698351,52396.92062329329
Prêt-à-Porter,12/23/1994,15000000,11300653,-3699347,75187.3120425815
Lars and the Real Girl,10/12/2007,12000000,11293663,-706337,54053.21725313014
Manhattan Murder Mystery,8/18/1993,13500000,11285588,-2214412,77778.00137835975
Chill Factor,9/1/1999,70000000,11263966,-58736034,67087.3496128648
Il Divo,5/23/2008,7275000,11260366,3985366,51460.66768731577
Space Battleship Yamato,12/1/2010,12000000,11212294,-787706,51155.87715976439
Stop-Loss,3/28/2008,25000000,11207130,-13792870,52169.13458987166
Deep Rising,1/30/1998,45000000,11203026,-33796974,69197.19579987647
Before Midnight,4/5/2013,3000000,11176469,8176469,48064.425818493015
Бой с тенью 2: Реванш,10/18/2007,6000000,11171900,5171900,53154.72197243276
For Love or Money,10/1/1993,30000000,11146270,-18853730,76501.50995195608
Return to Oz,6/21/1985,25000000,11137801,-13862199,103319.11873840446
The Astronaut Farmer,10/15/2006,13000000,11130889,-1869111,55158.02279484638
Vals Im Bashir,6/25/2008,2000000,11125849,9125849,50580.317688349
We Are Your Friends,8/26/2015,6000000,11122090,5122090,46742.27237386791
Inherent Vice,12/25/2014,20000000,11110975,-8889025,47542.328642274304
Jaane Tu... Ya Jaane Na,7/4/2008,2300000,11100000,8800000,50462.80300412795
The Squid and the Whale,10/5/2005,1500000,11098131,9598131,55713.509036144584
The Warrior's Way,12/2/2010,42000000,11087569,-30912431,50586.821730184005
"\"대�?\"\"While the Kingdom of Korea is under occupation by the Japanese\"",12/16/2015,5000,11083449,11078449,46782.18862381604
The Super,10/4/1991,22000000,11000863,-10999137,80064.50509461426
Dil To Pagal Hai,10/30/1997,1300000,11000000,9700000,68111.45510835914
Kismat Konnection,7/18/2008,4180000,11000000,6820000,50208.59388550615
Garv: Pride and Honour,7/9/2004,1300000,11000000,9700000,58078.14149947202
Wake Up Sid,10/2/2009,3000000,11000000,8000000,50884.22912705792
പ്രേമം,5/29/2015,6200000,11000000,4800000,46094.92201577284
Big Trouble in Little China,5/30/1986,25000000,11000000,-14000000,100456.62100456622
Wait Until Dark,10/26/1967,4000000,11000000,7000000,325443.78698224854
Pat Garrett & Billy the Kid,5/23/1973,4638783,11000000,6361217,248868.77828054296
The Green Berets,7/4/1968,7000000,11000000,4000000,315186.2464183381
Show Boat,7/13/1951,2300000,11000000,8700000,424710.42471042473
The Birth of a Nation,2/8/1915,100000,11000000,10900000,1100000.0
The Great Dictator,10/15/1940,2000000,11000000,9000000,785714.2857142857
The Lost Weekend,11/25/1945,1250000,11000000,9750000,604395.6043956045
Battle Beyond the Stars,9/8/1980,2000000,11000000,9000000,130952.38095238095
The Man Who Loved Women,12/18/1983,19000000,11000000,-8000000,107948.96957801766
Extreme Ops,11/27/2002,40000000,10959475,-29040525,60583.056937534544
Cookie's Fortune,1/22/1999,10000000,10920544,920544,66386.28571428571
Black Snake Moan,12/8/2006,15000000,10903846,-4096154,54032.933597621406
The Darkness,5/13/2016,4000000,10898293,6898293,45366.267186726
Extract,9/3/2009,8000000,10848783,2848783,50233.05659608555
Danny Collins,3/19/2015,10000000,10835752,835752,45797.961952501915
The End of the Affair,12/3/1999,23000000,10827816,-12172184,64336.399286987515
Låt den rätte komma in,1/26/2008,4000000,10785801,6785801,50950.201470998094
Missing in Action 2: The Beginning,3/1/1985,2410000,10755447,8345447,101085.02819548872
The African Queen,12/3/1951,1300000,10750000,9450000,405660.37735849054
Stay Tuned,8/14/1992,25000000,10736401,-14263599,76198.72959545777
Glengarry Glen Ross,9/15/1992,12500000,10725228,-1774772,75903.94904458598
Abandon,10/14/2002,25000000,10719357,-14280643,59124.96966354109
Il peggior Natale della mia vita,12/22/2012,6843500,10703234,3859734,46479.216605871115
RoboCop 3,4/17/1993,22000000,10696210,-11303790,74176.21359223302
Deconstructing Harry,8/26/1997,20000000,10686841,-9313159,66295.53970223326
Fear and Loathing in Las Vegas,5/22/1998,18500000,10680275,-7819725,65523.15950920245
Universal Soldier: The Return,8/5/1999,45000000,10667893,-34332107,63841.370436864156
Win Win,3/18/2011,10831173,10654385,-176788,47372.6134473958
南京!南京!,4/22/2009,12000000,10652498,-1347502,49811.54608708664
I Love You Phillip Morris,1/18/2009,13000000,10652035,-2347965,50199.747399772845
Le passé,5/17/2013,11000000,10631747,-368253,45531.327086473895
The Purple Rose of Cairo,3/1/1985,15000000,10631333,-4368667,99918.5432330827
The Boondock Saints II: All Saints Day,11/24/2009,8000000,10629321,2629321,49221.44117361043
Wolfen,7/24/1981,17000000,10626725,-6373275,115132.44853737812
The Dark Half,4/23/1993,15000000,10611160,-4388840,73586.40776699029
After Hours,9/13/1985,4500000,10609321,6109321,97962.33610341644
The House on Sorority Row,1/21/1983,425000,10604986,10179986,108324.6782431052
Broadway Danny Rose,1/27/1984,8000000,10600497,2600497,103520.478515625
Play Misty for Me,11/3/1971,725000,10600000,9875000,259168.70415647922
The Bad Lieutenant: Port of Call - New Orleans,9/11/2009,25000000,10589102,-14410898,49030.6571776505
Drop Dead Gorgeous,7/23/1999,10000000,10571408,571408,63263.961699581094
Smart People,4/11/2008,7000000,10569964,3569964,49203.130018666525
Mad City,11/7/1997,50000000,10541523,-39458477,65272.58823529412
Jonah Hex,6/18/2010,47000000,10539000,-36461000,48341.597442330894
Getaway,8/29/2013,18000000,10501938,-7498062,44851.51762339365
Silent Rage,4/2/1982,4500000,10500000,6000000,110642.78187565858
American Ninja,8/30/1985,1000000,10499694,9499694,96950.08310249308
Bandidas,1/18/2006,35000000,10496317,-24503683,52824.947156517366
Casablanca,11/26/1942,878000,10462500,9584500,619082.8402366864
Home Fries,11/25/1998,15000000,10443316,-4556684,63717.608297742525
Alone in the Dark,1/28/2005,20000000,10442808,-9557192,54446.33993743482
Moms' Night Out,3/25/2014,5000000,10429707,5429707,43993.837315246
Head Over Heels,2/2/2001,14000000,10424470,-3575530,59297.32650739476
The Virgin Suicides,4/21/1999,6000000,10409377,4409377,62631.63056558364
Elmer Gantry,6/19/1960,3000000,10400000,7400000,351351.35135135136
A Rage in Harlem,5/3/1991,8000000,10400000,2400000,76696.16519174042
Moby Dick,6/27/1956,4500000,10400000,5900000,379562.04379562044
Stardust Memories,9/26/1980,10000000,10389003,389003,122511.82783018869
The Scarlet Letter,10/13/1995,50000000,10382407,-39617593,67549.8178269356
Town & Country,4/27/2001,90000000,10372291,-79627709,58369.673607203156
Queen of Katwe,9/23/2016,15000000,10367161,-4632839,42887.53521505487
Thief of Hearts,10/19/1984,9000000,10364904,1364904,98432.13675213675
Code Name: The Cleaner,1/5/2007,20000000,10337477,-9662523,51070.45391668643
Only God Forgives,5/30/2013,4800000,10337387,5537387,44270.70628340414
Harry Brown,11/11/2009,7300000,10329747,3029747,47749.95146304257
Straw Dogs,9/16/2011,25000000,10324441,-14675559,45598.42505774641
White Squall,2/2/1996,38000000,10300000,-27700000,66494.51258876694
Someone to Watch Over Me,10/9/1987,17000000,10278549,-6721451,89146.13183000867
The Man Who Knew Too Much,6/1/1956,2500000,10250000,7750000,376838.23529411765
The Wash,11/16/2001,7000000,10229331,3229331,57890.9507640068
Brainstorm,9/30/1983,15000000,10219460,-4780540,101182.77227722772
Facing the Giants,9/29/2006,100000,10178331,10078331,50437.71555996036
The Great Raid,8/12/2005,80000000,10166502,-69833498,51764.26680244399
Cyborg,4/7/1989,500000,10166459,9666459,82586.9943135662
La vie d'Adèle - Chapitres 1 et 2,10/9/2013,4300000,10165694,5865694,43527.58771291309
Prom,4/29/2011,8000000,10130000,2130000,44830.14993538794
Shark Night,9/2/2011,28000000,10126458,-17873542,44631.771482971846
Possession,10/2/2002,25000000,10113733,-14886267,55784.517374517374
Punisher: War Zone,12/5/2008,20500000,10089373,-10410627,47992.52716098712
The Loft,10/14/2014,14000000,10076790,-3923210,42440.56217964647
Mrs. Winterbourne,4/19/1996,25000000,10070000,-14930000,64303.95913154534
Cry_Wolf,9/16/2005,1000000,10047674,9047674,50440.13052208836
Gojira ni-sen mireniamu,12/11/1999,1000000,10037390,9037390,59639.86928104575
What's Eating Gilbert Grape,12/17/1993,11000000,10032765,-967235,68623.56361149112
Before I Fall,3/2/2017,5000000,10025571,5025571,41121.94371639165
Cutthroat Island,12/22/1995,98000000,10017322,-87982678,64879.02849740932
Den Skaldede Frisør,9/4/2012,5500000,10016934,4516934,43287.082931804136
Kissing Jessica Stein,4/21/2001,1000000,10013424,9013424,56350.163196398425
Elephant,5/18/2003,3000000,10012022,7012022,54502.02504082744
Moonlight Mile,9/9/2002,21000000,10011050,-10988950,55309.668508287294
The Unbearable Lightness of Being,2/5/1988,17000000,10006806,-6993194,86265.56896551725
Nurse 3-D,9/28/2013,10,10000000,9999990,42818.11720175041
Khatta Meetha,7/23/2010,7500000,10000000,2500000,45806.00241855693
Heropanti,5/23/2014,4200000,10000000,5800000,41956.34023235421
Shaft's Big Score!,6/8/1972,1978000,10000000,8022000,239808.1534772182
The Hollywood Knights,5/30/1980,2500000,10000000,7500000,120918.98428053204
55 Days at Peking,5/6/1963,17000000,10000000,-7000000,327868.8524590164
The Two Jakes,8/10/1990,19000000,10000000,-9000000,75987.84194528876
Sylvia,10/17/2003,7000000,10000000,3000000,54200.54200542005
Hud,5/29/1963,2500000,10000000,7500000,326797.38562091504
Once Bitten,11/15/1985,3200000,10000000,6800000,91743.11926605504
Sabrina,9/28/1954,2238813,10000000,7761187,373134.32835820894
The Bellboy,7/20/1960,900000,10000000,9100000,337837.8378378378
Billu,2/13/2009,5750000,10000000,4250000,47126.9080506897
King Kong,4/7/1933,672000,10000000,9328000,793650.7936507937
Judgment at Nuremberg,12/1/1961,3000000,10000000,7000000,333333.3333333333
Tot yeshchyo Karloson!,3/15/2012,4000000,9938268,5938268,43324.3879472693
Whatever It Takes,3/31/2000,15000000,9902115,-5097885,57805.69176882662
Very Bad Things,9/11/1998,30000000,9898412,-20101588,60503.74083129584
Tsotsi,8/18/2005,3000000,9879971,6879971,49698.043259557344
Explorers,7/12/1985,25000000,9873044,-15126956,91586.67903525046
Jade,10/13/1995,50000000,9851610,-40148390,64096.35653871178
Samyy Luchshiy Film 3-DE,1/19/2011,6500000,9816332,3316332,44355.77405347275
La Pianiste,5/14/2001,3000000,9801375,6801375,55156.86550365786
Alan Partridge: Alpha Papa,7/24/2013,4000000,9800000,5800000,41902.36748376283
Bad Dreams,4/8/1988,4000000,9797098,5797098,83664.37233134074
The Express,10/10/2008,40000000,9793496,-30206504,45220.29985270555
Faithful,4/3/1996,13000000,9789900,-3210100,62635.316698656425
The Swan Princess,11/18/1994,35000000,9771658,-25228342,65274.936539746166
Moon,6/12/2009,5000000,9760104,4760104,45249.98029606895
Gitler kaput!,9/18/2008,3000000,9713500,6713500,44850.927862660625
Singam,5/28/2010,2200000,9700000,7500000,44502.55775009749
Conquest of the Planet of the Apes,6/29/1972,1700000,9700000,8000000,231503.57995226732
SpaceCamp,6/6/1986,18000000,9697739,-8302261,88563.82648401827
It's a Wonderful Life,12/20/1946,3180000,9644124,6464124,448563.9069767442
Seeking a Friend for the End of the World,6/22/2012,10000000,9636289,-363711,42060.7627976814
Wolf Creek 2,8/30/2013,8000000,9630444,1630444,41129.55425818603
The Apparition,8/23/2012,17000000,9627492,-7372508,41604.15199194493
For Greater Glory - The True Story of Cristiada,6/1/2012,12000000,9622846,-2377154,41933.63198215079
I Know Who Killed Me,7/27/2007,12000000,9620399,-2379601,46270.38193125141
Trespass,10/13/2011,36000000,9612469,-26387531,42453.96407577036
Bachna Ae Haseeno,8/14/2008,2400000,9600000,7200000,43818.409209168996
On the Waterfront,6/22/1954,910000,9600000,8690000,356877.32342007436
Mr. Smith Goes to Washington,10/19/1939,1500000,9600000,8100000,685714.2857142857
Banlieue 13,11/9/2004,12000000,9584131,-2415869,50178.69633507854
I Could Never Be Your Woman,5/11/2007,24000000,9576495,-14423505,46052.132974912114
Scenes from a Mall,2/22/1991,3000000,9563393,6563393,70839.94814814815
La science des rêves,2/11/2006,6000000,9524340,3524340,47933.266230498244
Running Scared,1/6/2006,17000000,9500000,-7500000,47907.21129601613
Breakfast at Tiffany's,10/5/1961,2500000,9500000,7000000,316666.6666666667
The Red Violin,9/10/1998,18000000,9495408,-8504592,58040.39119804401
The Young and Prodigious T.S. Spivet,10/16/2013,33000000,9494789,-23505211,40738.103308462305
Bullet to the Head,1/31/2013,55000000,9489829,-45510171,40875.18844275217
She's the One,8/26/1996,3500000,9482579,5982579,60092.38910012674
Stone,10/7/2010,22000000,9479718,-12520282,43343.58125562957
Never Let Me Go,9/15/2010,15000000,9455232,-5544768,43285.45726724624
All the King's Men,9/10/2006,55000000,9450897,-45549103,46579.088220798425
Goya's Ghosts,11/8/2006,50000000,9448082,-40551918,46888.74441687345
Dr. Strangelove or: How I Learned to Stop Worrying and Love the Bomb,1/29/1964,1800000,9440272,7640272,305510.42071197415
Rock Dog,7/8/2016,60000000,9420546,-50579454,39149.832937147796
Chandni Chowk To China,1/16/2009,10500000,9400000,-1100000,44299.29356764832
Chéri,2/10/2009,23000000,9366227,-13633773,44140.131861088725
The Frisco Kid,7/6/1979,9200000,9346177,146177,127854.67852257183
Miracle at St. Anna,9/15/2008,45000000,9323833,-35676167,42616.80752160817
Secretary,1/11/2002,4000000,9304609,5304609,52538.72953133823
Aitraaz,11/12/2004,3500000,9250000,5750000,48429.319371727746
Lolita,6/13/1962,2000000,9250000,7250000,306291.3907284768
Ringmaster,11/25/1998,3500000,9247881,5747881,56423.92312385601
Havana,12/11/1990,40000000,9243140,-30756860,69081.76382660687
Dark Blue,12/14/2002,15000000,9237470,-5762530,51063.957987838585
Dark Angel,1/26/1990,7000000,9229401,2229401,72104.6953125
Bernie,4/27/2012,5000000,9206470,4206470,40060.352892544004
Return of the Living Dead Part II,1/15/1988,6200000,9205924,3005924,79567.19101123595
Wazir,1/7/2016,5200000,9200000,4000000,38832.32875787199
Boom Town,8/30/1940,2000000,9172000,7172000,655142.8571428572
Pennies from Heaven,12/11/1981,22000000,9171289,-12828711,97566.90425531915
The Sessions,5/2/2012,1000000,9138338,8138338,39763.88834497313
The Valley of Decision,6/1/1945,2160000,9132000,6972000,504530.3867403315
Filth,9/23/2013,5000000,9114264,4114264,39025.56241596945
Lyubov V Bolshom Gorode,3/5/2009,3500000,9112193,5612193,42838.77504007823
Suite Française,11/5/2014,15000000,9104716,-5895284,38554.63665197268
Kongens nei,9/29/2016,7500000,9100000,1600000,37645.46248071187
Beasts of No Nation,9/11/2015,6000000,9077700,3077700,38150.412910546554
Red River,8/26/1948,3000000,9012000,6012000,367836.7346938776
Wizards,2/9/1977,1200000,9000000,7800000,152284.26395939087
Doctor Dolittle,12/19/1967,18000000,9000000,-9000000,263929.61876832845
Love Me Tender,11/15/1956,1000000,9000000,8000000,327272.7272727273
3 Strikes,3/1/2000,6000000,9000000,3000000,52570.09345794393
Witness for the Prosecution,12/17/1957,3000000,9000000,6000000,314685.31468531466
Ben-Hur: A Tale of the Christ,12/30/1925,3900000,9000000,5100000,502793.2960893855
Loving,11/4/2016,9000000,8996802,-3198,37276.528570185576
In the Mouth of Madness,12/12/1994,8000000,8946600,946600,59763.52705410822
Teaching Mrs. Tingle,8/11/1999,13000000,8946237,-4053763,53538.22262118492
Ong Bak 2,12/4/2008,8500000,8936663,436663,42509.38504861388
Tutto tutto niente niente,11/30/2012,5579750,8927600,3347850,38883.10590981747
Bolero,8/31/1984,7000000,8914881,1914881,84903.62857142858
Stargate: The Ark of Truth,3/11/2008,7000000,8900000,1900000,41680.716346333975
Nightbreed,2/16/1990,11000000,8862354,-2137646,68860.55944055945
Battle for the Planet of the Apes,6/15/1973,1700000,8844595,7144595,200103.95927601808
Avalon,1/20/2001,8000000,8826094,826094,50205.31285551763
Ratchet & Clank,4/13/2016,20000000,8821329,-11178671,36869.063491333734
Morgan,9/1/2016,8000000,8810591,810591,36493.65856487234
Body Double,10/25/1984,10000000,8801940,-1198060,83589.17378917379
New Kids Turbo,12/9/2010,1500000,8786756,7286756,40089.4063756108
Banlieue 13 - Ultimatum,2/18/2009,15000000,8786375,-6213625,41307.02038935823
On the Road,5/22/2012,25000000,8784318,-16215682,38279.564925613784
The Rocker,8/20/2008,15000000,8762890,-6237110,40052.88345072515
To Catch a Thief,8/3/1955,2500000,8750000,6250000,326492.53731343284
Damnation Alley,9/10/1977,17000000,8720000,-8280000,142019.54397394139
The Station Agent,1/26/2003,500000,8679814,8179814,47404.773347897324
Manhunter,8/14/1986,15000000,8620929,-6379071,78586.40838650866
The Bounty,5/4/1984,25000000,8613462,-16386538,83302.3404255319
Boat Trip,10/1/2002,20000000,8586376,-11413624,47360.04412575841
The Lost City of Z,10/15/2016,30000000,8574339,-21425661,35470.87440894555
Leprechaun,1/8/1993,900000,8556940,7656940,60006.591865357645
The Fifth Estate,10/11/2013,28000000,8555008,-19444992,36630.933520591236
Blue Velvet,8/1/1986,6000000,8551228,2551228,77951.03008204194
Badmaa$h Company,5/7/2010,6250000,8500000,2250000,38959.015116097864
Modern Times,2/5/1936,1,8500000,8499999,615942.0289855072
Niagara,1/26/1953,1250000,8500000,7250000,320754.71698113205
Big Trouble,4/5/2002,40000000,8493890,-31506110,47240.76751946607
Piranha 3DD,5/11/2012,5000000,8493728,3493728,36958.980049169986
Nothing but Trouble,2/14/1991,40000000,8479793,-31520207,62906.476261127595
Wise Guys,4/17/1986,13000000,8475466,-4524534,77827.97061524334
Chloe,3/25/2009,15000000,8459458,-6540542,39671.06546614144
Barney's Version,10/26/2010,30000000,8454301,-21545699,38638.871496277476
Play It to the Bone,12/25/1999,24000000,8434146,-15565854,49965.31990521327
Death Defying Acts,9/13/2007,20000000,8380329,-11619671,40195.3522950741
The Last Temptation of Christ,8/12/1988,7000000,8373585,1373585,70366.26050420168
La grande bellezza,5/21/2013,12400000,8371085,-4028915,35849.85696176511
Hummingbird,5/7/2013,20000000,8352885,-11647115,35857.756122689905
Smoke,6/9/1995,7000000,8349430,1349430,54750.360655737706
A Simple Wish,7/11/1997,28000000,8345056,-19654944,51994.118380062304
Stay,9/24/2005,50000000,8342132,-41657868,41878.17269076306
Atrapa la bandera,8/28/2015,14000000,8306690,-5693310,34910.12628968879
Bel Ami,3/9/2012,9000000,8303261,-696739,36196.820290158335
Shadow of the Vampire,5/15/2000,8000000,8279017,279017,48274.15160349854
Cry-Baby,4/5/1990,11000000,8266343,-2733657,64129.891388673386
Бой с Тенью,3/5/2005,3500000,8262833,4762833,42746.16140713916
Christopher Columbus: The Discovery,8/21/1992,40000000,8251071,-31748929,58393.99150743099
The Blob,8/5/1988,19000000,8247943,-10752057,69310.44537815126
Trumbo,10/27/2015,15000000,8235661,-6764339,34700.42892776486
Mine vaganti,2/12/2010,7000000,8220215,1220215,37926.44215907466
The Machinist,2/9/2004,5000000,8203235,3203235,44056.04189044039
Lucas,3/28/1986,6000000,8200000,2200000,75506.44567219153
The Misfits,1/1/1961,4000000,8200000,4200000,275167.7852348993
Alone in the Dark,11/12/1982,20000000,8178569,-11821431,83454.78571428571
This Is England,9/12/2006,2380000,8176544,5796544,40298.393297190734
Nick of Time,11/22/1995,8169363,8175346,5983,53259.58306188925
Cheetah,8/18/1989,5000000,8153677,3153677,65229.416
Promised Land,9/23/2012,15000000,8138788,-6861212,35184.5649044385
Iron Sky,3/10/2012,7500000,8135031,635031,35463.44685080561
Spartan,3/12/2004,19250000,8112712,-11137288,43290.88580576307
Ernest et Célestine,12/12/2012,12516654,8109160,-4407494,35318.487288818425
Upside Down,9/27/2012,60000000,8106475,-51893525,35044.87348530372
लगान,6/15/2001,5200000,8100000,2900000,45505.61797752809
Streets of Fire,6/1/1984,14500000,8089290,-6410710,78006.6538090646
The Adventures of Baron Munchausen,12/7/1988,46630000,8083123,-38546877,67079.85892116182
Bug,5/19/2006,4000000,8059140,4059140,39719.76343026121
Dead Ringers,9/23/1988,13000000,8038508,-4961492,66876.10648918469
The Ice Storm,9/27/1997,18000000,8038061,-9961939,49740.476485148516
Woo,5/8/1998,13000000,8026971,-4973029,49305.71867321867
The Texas Chainsaw Massacre 2,8/22/1986,4700000,8025872,3325872,72830.05444646098
The Chase,3/4/1994,26000000,8009329,-17990671,54411.202445652176
Beremennyy,7/21/2011,2000000,8000000,6000000,35313.07245801055
Mickey,8/1/1918,250000,8000000,7750000,519480.51948051946
The Man Who Shot Liberty Valance,4/22/1962,3200000,8000000,4800000,264900.66225165565
Ποτέ την Κυριακή,5/24/1960,151000,8000000,7849000,270270.27027027024
Zulu,1/22/1964,3500000,8000000,4500000,258899.67637540455
High Noon,3/27/1952,730000,8000000,7270000,303030.30303030304
A Streetcar Named Desire,9/18/1951,1800000,8000000,6200000,305343.5114503817
Annie Get Your Gun,5/17/1950,3768785,8000000,4231215,336134.45378151257
Death Race 2000,4/27/1975,300000,8000000,7700000,150375.93984962406
Hell's Angels,11/15/1930,3950000,8000000,4050000,487804.87804878055
Dazed and Confused,9/24/1993,6900000,7993039,1093039,54859.56760466713
Metallica: Through the Never,9/25/2013,18000000,7972967,-10027033,34138.743545168836
Strange Days,10/13/1995,42000000,7959291,-34040709,51784.586857514645
Funny Games,10/20/2007,15000000,7938872,-7061128,37772.315714849865
Runaway Train,11/15/1985,9000000,7936012,-1063988,72807.4495412844
La Folle histoire de Max et Léon,11/1/2016,12156348,7900000,-4256348,32732.13923174769
The Alamo,10/23/1960,12000000,7900000,-4100000,265100.6711409396
Family Plot,4/9/1976,2000000,7900000,5900000,140819.96434937613
Fat Pizza,4/10/2003,400000,7888102,7488102,42916.76822633297
Inside Job,10/8/2010,2000000,7871522,5871522,35990.51716648911
What If,9/7/2013,11000000,7847000,-3153000,33512.84865619755
Hoop Dreams,9/12/1994,700000,7830611,7130611,52413.728246318606
Dead Calm,4/7/1989,10000000,7825000,-2175000,63566.206336311945
Serial Mom,4/13/1994,13000000,7820688,-5179312,53057.584803256446
Solomon Kane,9/16/2009,45000000,7810000,-37190000,36127.80268021113
Tupac: Resurrection,1/23/2003,300000,7808524,7508524,42646.226105953036
Bad Words,9/6/2013,9500000,7800000,-1700000,33312.12176861742
Gentleman's Agreement,11/11/1947,2000000,7800000,5800000,337662.33766233764
Sands of Iwo Jima,12/14/1949,1000000,7800000,6800000,330508.47457627114
P2,11/9/2007,8000000,7766240,-233760,36950.95086522312
Expelled: No Intelligence Allowed,4/18/2008,3500000,7700000,4200000,35544.148602237896
Surviving the Game,4/15/1994,7400000,7690013,290013,52171.051560379914
A Scanner Darkly,5/25/2006,8700000,7659918,-1040082,37752.183341547556
Last Night,5/11/2010,7000000,7644937,644937,35039.907781719514
Cavalcade,2/8/1933,1180280,7630000,6449720,600787.4015748032
Losing Isaiah,3/17/1995,17000000,7603766,-9396234,50057.709019091504
The Hustler,9/25/1961,2000000,7600000,5600000,253333.33333333334
En kongelig affære,3/29/2012,8000000,7594693,-405307,33008.2056631245
While We're Young,4/3/2015,10000000,7587485,-2412515,32068.964788524045
Hackers,9/14/1995,20000000,7563728,-12436272,49371.592689295045
Батальонъ,2/20/2015,10000000,7547762,-2452238,31965.923962069974
12,6/6/2007,4000000,7537453,3537453,36176.532982644756
Proof,9/5/2005,20000000,7535331,-12464669,37904.07947686117
My Old Lady,9/9/2014,5000000,7527232,2527232,31622.906260108975
Big Game,9/5/2014,8500000,7500000,-1000000,31508.500993568065
The Cowboys,1/13/1972,6000000,7500000,1500000,182481.7518248175
F.C. De Kampioenen: Kampioen zijn blijft plezant,12/17/2013,3849796,7471304,3621508,31940.115255048822
The Big Year,10/13/2011,41000000,7448385,-33551615,32896.17570808362
Harley Davidson and the Marlboro Man,8/23/1991,23000000,7434726,-15565274,54188.96501457726
Maximum Overdrive,7/25/1986,10000000,7433663,-2566337,67763.56426618049
You Can't Take It With You,8/23/1938,1644736,7433101,5788365,527170.2836879432
Kids,7/28/1995,1500000,7412216,5912216,48477.540876389794
Clifford,4/1/1994,19000000,7411659,-11588341,50282.62550881954
Requiem for a Dream,10/27/2000,4500000,7390108,2890108,42447.48994830557
It's a Boy Girl Thing,12/26/2006,15500000,7385434,-8114566,36486.41411746107
Tasogare Seibei,11/2/2002,5000000,7338987,2338987,40479.795918367345
Bones,10/24/2001,10000000,7316658,-2683342,41243.84441939121
American Dreamz,3/4/2006,17000000,7314027,-9685973,36606.74174174174
Outside Providence,8/16/1999,7000000,7292175,292175,43431.65574746873
Phantasm II,7/8/1988,3000000,7282851,4282851,61458.6582278481
Lola rennt,8/20/1998,1530000,7267585,5737585,44422.89119804401
Gigli,8/1/2003,54000000,7266209,-46733791,39361.91224268689
Off Limits,3/11/1988,12000000,7242035,-4757965,62163.390557939914
Johnny Handsome,9/12/1989,20000000,7237794,-12762206,57902.352
Force 10 from Navarone,11/1/1978,5000000,7230000,2230000,107270.0296735905
Gold,12/22/2016,20000000,7227038,-12772962,29760.615057713134
The Big Red One,5/28/1980,4500000,7206220,2706220,87136.88029020556
Белый тигр,5/3/2012,11000000,7200000,-3800000,31329.547679655374
Singin' in the Rain,4/10/1952,2540800,7200000,4659200,272727.27272727276
1492: Conquest of Paradise,10/9/1992,47000000,7191399,-39808601,50715.08462623413
Mujeres al borde de un ataque de nervios,3/14/1988,700000,7179298,6479298,61624.875536480686
Rescue Dawn,9/9/2006,10000000,7177143,-2822857,35372.8092656481
10 to Midnight,3/11/1983,4520000,7175592,2655592,73295.11746680285
Bluffmaster!,1/1/2005,1823152,7133082,5309930,37404.729942317776
The Adventures of Pluto Nash,8/15/2002,100000000,7103973,-92896027,39313.63032650803
Incendies,9/4/2010,6800000,7103838,303838,32520.923461469793
Cinderfella,12/18/1960,3000000,7100000,4100000,238255.03355704696
Tau man ji D,5/12/2005,1549000,7096000,5547000,36502.05761316873
Grandma,6/4/2015,600000,7087452,6487452,29699.595202775752
The Secret of Moonacre,9/6/2008,12000000,7070330,-4929670,32316.63337645064
Quills,11/22/2000,13500000,7060876,-6439124,40579.747126436785
Outlander,4/24/2008,50000000,7033683,-42966317,32468.347243251228
The Joneses,9/13/2009,10000000,7022728,-2977272,32517.29646384435
Hard Candy,1/14/2005,950000,7022209,6072209,36823.32983744101
Black Nativity,11/27/2013,17500000,7018189,-10481811,30114.64970885951
Bound,9/13/1996,4500000,7011317,2511317,44431.666666666664
Our Brand Is Crisis,9/11/2015,28000000,7002261,-20997739,29428.065309210113
Spellbound,12/28/1945,1500000,7000000,5500000,384615.3846153846
An American Carol,10/3/2008,20000000,7000000,-13000000,32321.665212191732
Voyage to the Bottom of the Sea,7/12/1961,1580000,7000000,5420000,233333.33333333334
Strangers on a Train,6/18/1951,1200000,7000000,5800000,270270.2702702703
Marnie,7/9/1964,2135161,7000000,4864839,225080.38585209002
Crossover,9/1/2006,5800000,7000000,1200000,34499.75357318876
Parasite,3/12/1982,800000,7000000,6200000,74074.07407407407
The Trouble with Harry,10/3/1955,1200000,7000000,5800000,260223.04832713757
Eraserhead,3/19/1977,10000,7000000,6990000,116666.66666666667
Children of the Corn II: The Final Sacrifice,1/29/1993,900000,6980986,6080986,48783.96925227114
Red Sonja,4/9/1985,17900000,6948633,-10951367,65001.2441534144
喜宴,8/4/1993,1000000,6933459,5933459,47883.0041436464
Take Me Home Tonight,3/4/2011,19000000,6928068,-12071932,31002.644685792533
Trapped,9/20/2002,30000000,6916869,-23083131,38151.51130722559
A Cry in the Dark,11/11/1988,15000000,6908797,-8091203,57429.73399833749
PEEPLI [Live],8/13/2010,2270000,6900000,4630000,31606.141668804277
The Amateur,12/11/1981,10000000,6892098,-3107902,73320.1914893617
Bathing Beauty,7/1/1944,2361000,6892000,4531000,389378.5310734463
Son of Rambow,1/22/2007,4000000,6870249,2870249,33760.6032462076
Bee Season,9/3/2005,14000000,6856989,-7143011,34491.896378269616
The Spectacular Now,8/2/2013,2500000,6854611,4354611,29308.615212269695
200 Cigarettes,2/26/1999,6000000,6852450,852450,41530.0
The Green Inferno,9/4/2014,5000000,6833445,1833445,28708.214476265697
Flawless,9/1/2007,20000000,6819587,-13180413,32709.420116072713
Centurion,2/15/2010,12000000,6814789,-5185211,31442.0852538283
The Big Bounce,1/30/2004,50000000,6808550,-43191450,36565.78947368421
Woman Thou Art Loosed,9/30/2004,3000000,6804016,3804016,35641.781037192246
The Train,9/21/1964,5800000,6800000,1000000,218649.51768488745
Hang 'em High,7/31/1968,1800000,6800000,5000000,194285.7142857143
A Patch of Blue,12/10/1965,800000,6792000,5992000,213584.90566037735
La Princesse de Montpensier,11/3/2010,14734000,6775121,-7958879,30964.479463261472
Running with Scissors,10/27/2006,12000000,6754898,-5245102,33523.06699751861
Scaramouche,5/8/1952,3005000,6746000,3741000,255530.30303030304
Fortress,9/30/1992,8000000,6739141,-1260859,47525.677009873056
Nine 1/2 Weeks,2/14/1986,17000000,6735922,-10264078,61627.83165599268
Conviction,9/11/2010,12500000,6732980,-5767020,30823.158868150836
Roger & Me,9/1/1989,160000,6706368,6546368,53650.944
Paris Can Wait,9/12/2016,5000000,6700000,1700000,27751.544974070945
Into the Night,2/15/1985,11400000,6700000,-4700000,63207.54716981132
Mighty Aphrodite,9/13/1995,15000000,6700000,-8300000,43733.681462140994
U Turn,10/3/1997,19000000,6682098,-12317902,41349.61633663366
The Babadook,5/22/2014,2000000,6676471,4676471,28012.028882744617
What Just Happened,10/17/2008,25000000,6673422,-18326578,31415.426621160408
City Island,3/6/2009,6000000,6670712,670712,31360.741670545205
Against the Ropes,2/20/2004,39000000,6614280,-32385720,35294.98399146211
99,5/15/2009,3000000,6600000,3600000,30861.888373484962
Donovan's Reef,6/12/1963,2686000,6600000,3914000,215686.27450980392
Once Upon a Forest,6/18/1993,13000000,6582052,-6417948,45582.07756232687
Beröringen,7/14/1971,6900000,6530000,-370000,160442.26044226042
Madras Cafe,8/23/2013,5400000,6500000,1100000,27760.101473847848
Белка и Стрелка. Звёздные собаки,3/18/2010,25000000,6500000,-18500000,29815.282855294965
It's Kind of a Funny Story,7/6/2010,8000000,6491240,-1508760,29774.82787565765
The Young Messiah,3/10/2016,18500000,6490401,-12009599,27255.47595451262
Little Boy,4/23/2015,20000000,6485961,-13514039,27274.28355164946
Switchback,10/31/1997,37000000,6482195,-30517805,40137.43034055728
Mio fratello è figlio unico,4/20/2007,5000000,6463286,1463286,31081.11123400449
El espinazo del diablo,4/20/2001,4500000,6459020,1959020,36347.88970174451
Gods and Monsters,1/21/1998,10000000,6451628,-3548372,39849.46263125386
Hot to Trot,8/26/1988,9000000,6436211,-2563789,53724.632721202004
D-Tox,1/4/2002,55000000,6416302,-48583698,36229.82495765104
Slackers,2/1/2002,14000000,6413915,-7586085,36073.762654668164
Post Grad,8/21/2009,15000000,6405245,-8594755,29658.16853344693
Article 99,3/13/1992,18000000,6375979,-11624021,45771.564967695616
Incarnate,12/1/2016,5000000,6341855,1341855,26267.665429603367
Knock Knock,6/26/2015,2500000,6341684,3841684,26572.711959573273
Affliction,8/28/1997,6000000,6330054,330054,39268.32506203474
The Sweeney,9/11/2012,3730500,6294161,2563661,27199.527239884705
Steal Big Steal Little,9/29/1995,25000000,6278139,-18721861,40846.70787247886
Max Steel,10/14/2016,10000000,6272403,-3727597,25948.078219824678
Rambling Rose,9/10/1991,7500000,6266621,-1233379,45675.08017492712
College,8/28/2008,7000000,6230276,-769724,28476.965760593834
Midnight Special,2/18/2016,18000000,6212282,-11787718,26087.55648127929
Bleed for This,11/4/2016,6000000,6174491,174491,25582.82267052823
Barton Fink,8/1/1991,9000000,6153939,-2846061,45050.79795021962
MacGruber,5/21/2010,10000000,6110000,-3890000,28032.023490009862
All Is Lost,10/18/2013,9000000,6108720,-2891280,26209.92066727021
Дуэлянт,9/29/2016,12823507,6101904,-6721603,25242.74704317645
Battle for Terra,9/6/2007,4000000,6101046,2101046,29263.01501271044
ना तु�?जानो ना हम,5/9/2002,350000,6100000,5750000,33926.5850945495
Cosmopolis,5/25/2012,20500000,6063556,-14436444,26423.256259859332
Racing with the Moon,3/23/1984,9000000,6045657,-2954343,58638.76818622697
We Need to Talk About Kevin,9/28/2011,7000000,6038942,-961058,26671.298156973073
"\"அலைபாயுத�?\"\"After a difficult romance in a class-divided society\"",4/14/2000,2000000,6000000,4000000,35026.2697022767
The Legend of Bhagat Singh,6/7/2002,3000000,6000000,3000000,33351.86214563646
Company,4/15/2002,1500000,6000000,4500000,33370.41156840934
Aadukalam,1/14/2011,4000000,6000000,2000000,27245.110637853446
La lengua de las mariposas,9/24/1999,3000000,6000000,3000000,35671.8192627824
How Green Was My Valley,10/28/1941,1250000,6000000,4750000,389610.3896103896
Rebecca,4/12/1940,1288000,6000000,4712000,428571.4285714286
Vixen!,10/15/1968,76000,6000000,5924000,169971.671388102
El Dorado,12/17/1966,4653000,6000000,1347000,182370.82066869302
Pink Flamingos,3/12/1972,12000,6000000,5988000,144927.53623188406
Topaz,12/18/1969,4000000,6000000,2000000,158730.15873015873
A Sound of Thunder,5/15/2005,80000000,5989640,-74010360,30810.905349794237
Harsh Times,9/11/2005,2000000,5967038,3967038,30015.281690140844
Transsiberian,1/18/2008,15000000,5926410,-9073590,27995.304521169805
Evil Dead II,3/13/1987,3600000,5923044,2323044,52837.145405887604
Never Die Alone,3/26/2004,3000000,5923000,2923000,31505.31914893617
The Good German,12/8/2006,32000000,5914908,-26085092,29310.743310208127
Sarkar,7/1/2005,1900000,5900000,4000000,30194.47287615148
Anjaana Anjaani,9/24/2010,6400000,5900000,-500000,26976.238049297932
Flaskepost fra P,3/3/2016,5210000,5900000,690000,24776.174558648145
Highlander,3/7/1986,16000000,5900000,-10100000,54227.94117647059
Ed Wood,9/27/1994,18000000,5887457,-12112543,39380.98327759197
Captain Fantastic,7/2/2016,5000000,5879736,879736,24434.96184982629
The Opposite of Sex,5/22/1998,5000000,5879254,879254,36069.04294478527
The Immigrant,7/3/2013,16000000,5867686,-10132314,25118.94895460539
Zohi Sdom,8/5/2010,2745000,5850000,3105000,26796.511414855802
The Transformers: The Movie,8/8/1986,6000000,5849647,-150353,53324.03828623518
The Hitcher,2/21/1986,6000000,5844868,-155132,53721.21323529412
十月圍城,12/18/2009,23000000,5837674,-17162326,26940.582499180844
Night of the Living Dead,10/18/1990,4200000,5835247,1635247,43611.71150971599
Stanley & Iris,2/9/1990,23000000,5820015,-17179985,45468.8671875
20th Century Women,12/25/2016,7000000,5816211,-1183789,23950.89339027092
Il capitale umano,1/9/2014,6000000,5809330,-190670,24835.11174951692
Screamers,9/8/1995,20000000,5781885,-14218115,37740.7637075718
The Tie That Binds,9/8/1995,14000000,5780000,-8220000,37728.45953002611
Sheena,8/17/1984,25000000,5778353,-19221647,55031.933333333334
La piel que habito,8/17/2011,13000000,5774854,-7225146,25452.33131619426
Get on the Bus,10/16/1996,2400000,5731103,3331103,36135.580075662045
Gymkata,5/3/1985,8500000,5730596,-2769404,53407.23205964585
Hardware,9/14/1990,1500000,5728953,4228953,43172.21552373776
The Devil's Double,2/11/2011,19100000,5728213,-13371787,25883.326028313353
One Eight Seven,7/29/1997,20000000,5716080,-14283920,35547.761194029845
Kundun,12/25/1997,28000000,5684789,-22315211,35178.14975247525
Nadine,8/7/1987,12000000,5669831,-6330169,49561.45979020979
Anomalisa,12/30/2015,8000000,5659286,-2340714,23887.310270306774
Something Wicked This Way Comes,4/29/1983,19000000,5656087,-13343913,57017.0060483871
Mildred Pierce,9/24/1945,1453000,5638000,4185000,311491.7127071823
Albert Nobbs,12/21/2011,8000000,5634828,-2365172,24859.7180861624
Batman: Mask of the Phantasm,12/25/1993,6000000,5617391,-382609,38422.64705882353
L'illusionniste,2/16/2010,18000000,5602431,-12397569,25742.798590274364
Bordello of Blood,8/16/1996,15000000,5600000,-9400000,35487.95944233207
Central do Brasil,1/16/1998,2900000,5596708,2696708,34568.919085855465
Loose Cannons,2/9/1990,1500000,5585154,4085154,43634.015625
Pawn Sacrifice,9/16/2015,19000000,5578519,-13421481,23455.120712417698
The Contract,4/5/2006,25000000,5549200,-19450800,27539.454094292803
Delirious,8/9/1991,18000000,5546827,-12453173,40606.346998535875
For Your Consideration,11/22/2006,12000000,5542025,-6457975,27462.958374628342
Before Sunrise,1/27/1995,2500000,5535405,3035405,36682.60437375745
The Brothers Bloom,9/9/2008,20000000,5530764,-14469236,25279.678951289636
Wind,9/11/1992,29000000,5519569,-23480431,39062.76716206652
"#Pellichoopulu",7/29/2016,200000,5500000,5300000,22835.88472445391
The Frozen Ground,7/18/2013,27220000,5496951,-21723049,23503.598045126284
Wish I Was Here,1/18/2014,5500000,5483299,-16701,23354.95206170857
Tucker and Dale vs Evil,1/22/2010,5000000,5476793,476793,25268.836998998802
Made,7/13/2001,5000000,5476060,476060,30851.042253521126
Troll,1/17/1986,1100000,5450815,4350815,49870.219579139986
Black Gold,12/21/2011,40000000,5446000,-34554000,24026.647254759228
Black Gold,12/21/2011,40000000,5446000,-34554000,24026.647254759228
Virgin Territory,12/17/2007,38000000,5410749,-32589251,25633.641273450823
Monkeybone,2/23/2001,75000000,5409517,-69590483,30701.004540295122
She Wore a Yellow Ribbon,10/22/1949,1600000,5400000,3800000,226890.756302521
Under the Skin,3/14/2014,13300000,5380251,-7919749,22769.404933705187
The Lookout,3/9/2007,16000000,5367030,-10632970,26135.75713896139
Diary of the Dead,9/8/2007,2000000,5364858,3364858,25731.967960094007
A Guy Named Joe,3/1/1944,2627000,5363000,2736000,308218.3908045977
Equilibrium,12/6/2002,20000000,5359645,-14640355,29627.667219458264
Monkey Shines,7/29/1988,7000000,5344577,-1655423,44912.41176470588
Bommarillu,8/9/2006,1333333,5333333,4000000,26156.61108386464
Beginners,9/11/2010,3200000,5332926,2132926,24413.79973356406
Recep İvedik,2/22/2008,500000,5330000,4830000,24961.597542242704
C'era una volta il West,12/21/1968,5000000,5321508,321508,149480.5617977528
Whisper,11/27/2007,12000000,5285197,-6714803,25163.291054866786
San Francisco,6/26/1936,1300000,5273000,3973000,379352.5179856115
Glitter,9/21/2001,22000000,5271666,-16728334,29666.10016882386
А зори здесь тихие...,4/30/2015,3300000,5249225,1949225,22073.652782742163
Black and White,9/4/1999,10000000,5241315,-4758685,31216.885050625373
Justice League: The New Frontier,2/26/2008,3500000,5231128,1731128,24498.557566220825
The In Crowd,7/19/2000,15000000,5217498,-9782502,30193.854166666664
Bandslam,8/6/2009,20000000,5210988,-14789012,24143.49917065893
Kelly's Heroes,6/22/1970,4000000,5200000,1200000,133333.33333333334
Shortbus,5/20/2006,2000000,5179037,3179037,25525.071463775257
La isla mínima,9/25/2014,4000000,5169755,1169755,21773.5319016312
The House of Mirth,9/23/2000,10000000,5164404,-4835596,29680.48275862069
Justice League: War,2/2/2014,3500000,5155325,1655325,21958.01619381466
Rabbit Hole,12/16/2010,5000000,5129058,129058,23290.292112994553
Gossip,4/21/2000,14000000,5108820,-8891180,29789.037900874635
�?காதல�?கண்மணி,4/17/2015,940000,5100000,4160000,21446.142848131873
Top Dog,4/28/1995,6000000,5093707,-906293,33467.19448094613
Miller's Crossing,9/21/1990,14000000,5080409,-8919591,38055.49812734083
The Proposition,10/6/2005,2000000,5048693,3048693,25344.844377510042
Monty Python and the Holy Grail,3/13/1975,400000,5028948,4628948,95425.95825426944
Solitary Man,9/7/2009,15000000,5024782,-9975218,23266.218762878005
Club Dread,2/27/2004,8500000,5001655,-3498345,26689.727854855922
Miss Julie,9/7/2014,5500000,5000000,-500000,21005.667329045376
Atithi Tum Kab Jaoge,2/26/2010,3750000,5000000,1250000,22974.66813091885
Hard Times,9/4/1975,2700000,5000000,2300000,91575.09157509157
The Ballad of Cable Hogue,5/13/1970,3716946,5000000,1283054,129533.67875647669
Macabre,10/1/1958,90000,5000000,4910000,173010.38062283737
Love Story 2050,7/4/2008,20000000,5000000,-15000000,22730.99234420178
Sunset Boulevard,8/10/1950,1752000,5000000,3248000,205761.31687242797
Pocketful of Miracles,12/18/1961,2900000,5000000,2100000,166666.66666666666
Stop Making Sense,11/16/1984,1200000,4978922,3778922,47283.20987654321
Girl 6,3/22/1996,12000000,4939939,-7060061,31605.495841330772
From Justin to Kelly,6/20/2003,12000000,4922166,-7077834,26765.448613376833
Half Nelson,8/11/2006,700000,4911725,4211725,24088.891613536045
The Magnificent Seven,10/22/1960,2000000,4905000,2905000,164597.3154362416
Titanic,4/11/1953,1805000,4905000,3100000,184398.4962406015
Hey Ram,2/18/2000,3900000,4900000,1000000,28621.495327102806
Invaders from Mars,1/1/1986,12000000,4884663,-7115337,44568.093065693436
The Company Men,10/21/2010,15000000,4882577,-10117423,22314.945407512696
Band of the Hand,4/11/1986,8700000,4865912,-3834088,44805.81952117864
Galaxina,6/6/1980,5500000,4865000,-635000,58827.085852478835
Legok na Pomine,2/27/2014,2153912,4864560,2710648,20586.983109952474
Oldboy,11/14/2013,30000000,4861022,-25138978,20856.578953013915
Little Buddha,12/1/1993,35000000,4858139,-30141861,33320.569272976674
Intermission,8/29/2003,5000000,4856298,-143702,26221.911447084236
Romanzo criminale,9/30/2005,818418,4851244,4032826,24353.63453815261
90 Minutes in Heaven,9/11/2015,5000000,4842699,-157301,20352.178024333356
Diggstown,8/14/1992,17000000,4836637,-12163363,34326.73527324343
만추,9/10/2010,6200000,4820000,-1380000,22065.656773744617
Te3n,6/10/2016,5069632,4817642,-251990,19988.722833979205
Collide,8/4/2016,21500000,4811525,-16688475,19977.35095433238
Ostrov Vezeniya,12/5/2013,2000000,4803665,2803665,20612.253217134592
Svinalängorna,12/10/2010,3000000,4800080,1800080,21900.273292605587
Vamp,7/18/1986,1900000,4790926,2890926,43672.98085688241
Igby Goes Down,9/13/2002,9000000,4777465,-4222535,26394.834254143647
The Fall of the Roman Empire,3/24/1964,19000000,4750000,-14250000,153721.68284789645
This Is Spinal Tap,5/4/1984,2500000,4736202,2236202,45804.66150870406
Drugstore Cowboy,9/9/1989,2500000,4729352,2229352,37834.816
The Other Side of Heaven,4/12/2001,7000000,4720371,-2279629,26683.83832673827
King Kong Lives,11/21/1986,10000000,4711220,-5288780,42635.47511312217
Your Friends & Neighbors,2/4/1998,5000000,4710749,-289251,29096.658431130327
Glyanets,8/23/2007,2500000,4684165,2184165,22467.096743249076
Radio Flyer,2/21/1992,35000000,4651977,-30348023,33395.384063173005
London Boulevard,11/10/2010,25000000,4644108,-20355892,21225.065469851877
Fire with Fire,8/31/2012,20000000,4636169,-15363831,20034.696443927798
Locke,4/10/2014,2000000,4635300,2635300,19552.287912532902
Курочка Ряба,10/1/1994,2700000,4635143,1935143,31004.30100334448
Dylan Dog: Dead of Night,3/16/2011,20000000,4634062,-15365938,20604.4391879274
Let's Go to Prison,11/17/2006,4000000,4630045,630045,22943.731417244795
Atlas Shrugged Part I,4/14/2011,15000000,4627375,-10372625,20574.7067663824
Joe's Apartment,7/26/1996,13000000,4619014,-8380986,29364.361093452
Love in the Time of Cholera,10/4/2007,45000000,4607608,-40392392,22052.724279205115
Dutch,7/19/1991,17000000,4603929,-12396071,33703.7262079063
Thirteen,8/20/2003,2000000,4601043,2601043,24843.644708423326
Anthropoid,8/12/2016,9000000,4600000,-4400000,19099.10358772509
Jab We Met,10/26/2007,2300000,4600000,2300000,21886.31486794464
Sunset,4/29/1988,16000000,4594452,-11405548,39101.71914893617
Шпион,4/5/2012,6000000,4588176,-1411824,19941.221722406935
Meet the Deedles,3/27/1998,24000000,4562146,-19437854,28074.744615384614
Italiano medio,1/29/2015,1816720,4541800,2725080,19349.69879261424
Swingers,10/18/1996,200000,4505922,4305922,28410.605296343
It Happened One Night,2/22/1934,325000,4500000,4175000,338345.8646616541
Hunting Elephants,7/3/2013,2300000,4500000,2200000,19264.02849363859
An American in Paris,8/8/1951,2723903,4500000,1776097,173745.17374517376
Suspicion,11/14/1941,1103000,4500000,3397000,292207.7922077922
Curse of the Pink Panther,8/12/1983,11000000,4491986,-6508014,44830.199600798405
Mutiny on the Bounty,11/8/1935,1950000,4460000,2510000,323188.40579710144
Bright Star,11/5/2009,8500000,4440055,-4059945,20524.45338140803
The Conversation,4/7/1974,1600000,4420000,2820000,92083.33333333333
Run,2/1/1991,16000000,4409328,-11590672,32710.14836795252
कट्यार काळजात घुसली,11/12/2015,1500000,4400000,2900000,18539.11753800519
Simply Irresistible,2/5/1999,6000000,4398989,-1601011,26741.574468085106
Beyond a Reasonable Doubt,2/5/2009,25000000,4388563,-20611437,20681.940497565894
The Lost City,9/3/2005,9600000,4386236,-5213764,22063.561368209255
Pumpkinhead,6/9/1988,3500000,4385516,885516,37165.38983050847
For Me and My Gal,10/21/1942,802000,4371000,3569000,260178.57142857142
The Broadway Melody,2/8/1929,379000,4358000,3979000,254853.80116959062
PCU,4/29/1994,9000000,4350774,-4649226,29496.772881355933
Burke & Hare,10/29/2010,10000000,4349187,-5650813,19877.181757105707
The Treasure of the Sierra Madre,1/24/1948,3800000,4307000,507000,183276.59574468085
Lootera,4/4/2013,4100000,4300000,200000,18492.158034842665
Four Rooms,12/9/1995,4000000,4300000,300000,28013.029315960914
One-Eyed Jacks,3/30/1961,6000000,4300000,-1700000,144295.30201342283
La doppia ora,10/9/2009,3906840,4300000,393160,19891.107749668095
Four Lions,5/7/2010,967686,4270000,3302314,19571.175828910338
The Meddler,4/5/2016,3200000,4267218,1067218,17834.99191259754
Tutta la vita davanti,3/28/2008,5940000,4250000,-1690000,19783.72893032869
Men with Brooms,9/20/2002,7500000,4245870,-3254130,23419.029233314945
Monsters,6/18/2010,500000,4242978,3742978,19462.219796248814
Dabba,9/19/2013,1000000,4235151,3235151,18134.119188511042
The Book of Henry,6/16/2017,10000000,4219536,-5780464,17237.652480125496
Detroit Rock City,8/13/1999,6500000,4217115,-2282885,25237.073608617597
�?깡패 같은 애인,5/20/2010,800000,4214668,3414668,19336.443924483287
A Hologram for the King,4/22/2016,30000000,4212494,-25787506,17535.3267090984
Swiss Army Man,6/24/2016,3000000,4210454,1210454,17497.772495303954
रावण,6/18/2010,4500000,4200000,-300000,19265.08295452982
Parrish,5/4/1961,1500000,4200000,2700000,140939.59731543623
Red Scorpion,12/24/1988,16000000,4192440,-11807560,34619.653179190755
Lovely & Amazing,8/31/2001,250000,4186931,3936931,23482.507010656194
Twin Peaks: Fire Walk with Me,6/3/1992,10000000,4160851,-5839149,29677.967189728963
Trolljegeren,10/29/2010,3500000,4159678,659678,19011.06474774112
Idle Hands,4/30/1999,25000000,4152230,-20847770,24983.333333333336
Kama Sutra - A Tale of Love,9/11/1996,3000000,4109095,1109095,26039.892268694548
Serbuan maut,9/8/2011,1100000,4105187,3005187,18093.37164869165
Thank You,4/8/2011,13100000,4100000,-9000000,18229.838243532853
Heist,11/13/2015,8900000,4100000,-4800000,17275.086796777563
Grave,10/7/2016,3500000,4100000,600000,16961.142436364687
Godzilla 1985,12/15/1984,2000000,4100000,2100000,38936.37226970561
S. Darko,4/28/2009,4000000,4100000,100000,19171.779141104296
Dil Chahta Hai,7/24/2001,2079000,4099000,2020000,23092.957746478874
Denial,9/30/2016,10000000,4073489,-5926511,16851.470034625552
The Visual Bible: The Gospel of John,9/11/2003,10000000,4069090,-5930910,21971.328293736504
Tank Girl,3/31/1995,25000000,4064495,-20935505,26757.702435813033
Bottle Shock,8/6/2008,5000000,4040588,-959412,18442.931086422683
Safety Not Guaranteed,6/8/2012,750000,4007792,3257792,17464.82015705209
I'm Not There.,10/1/2007,20000000,4001121,-15998879,19149.98372707432
The Derby Stallion,7/4/2005,750000,4000000,3250000,20470.829068577277
Playing God,10/17/1997,12000000,4000000,-8000000,24767.80185758514
Alexander's Ragtime Band,5/24/1938,2000000,4000000,2000000,283687.94326241134
Human Traffic,6/4/1999,600000,4000000,3400000,24067.38868832732
The Lords of Flatbush,5/1/1974,160000,4000000,3840000,82304.52674897118
Cat People,12/5/1942,134000,4000000,3866000,236686.3905325444
Willy Wonka & the Chocolate Factory,6/29/1971,3000000,4000000,1000000,98280.09828009827
Blood Feast,6/6/1963,24500,4000000,3975500,130718.954248366
The Pebble and the Penguin,4/11/1995,28000000,3983912,-24016088,26227.20210664911
The Adventures of Robin Hood,5/13/1938,2033000,3981000,1948000,282340.4255319149
Playing by Heart,12/30/1998,20000000,3970078,-16029922,24163.590992087644
Attack the Block,5/12/2011,14350531,3964682,-10385849,17545.635587969766
Joysticks,3/4/1983,300000,3952448,3652448,40372.29826353422
Mechenosets,10/12/2006,5000000,3919731,-1080269,19423.84043607532
Brick,1/30/2005,475000,3919254,3444254,20434.066736183522
Earth Girls Are Easy,9/8/1988,10000000,3916303,-6083697,32690.34223706177
The Manhattan Project,6/13/1986,18000000,3900000,-14100000,35616.438356164384
L'Auberge espagnole,5/17/2002,5300000,3897799,-1402201,21666.475819899944
Rules Don't Apply,11/23/2016,25000000,3885342,-21114658,16092.904006096956
The Perfect Game,4/1/2010,12500000,3878993,-8621007,17792.81130595526
Tarif Novogodniy,12/4/2008,3200000,3877492,677492,18444.222463230395
West Is West,10/19/2010,3837625,3867000,29375,17673.432265553947
特務迷城,1/18/2001,25697387,3849941,-21847446,21899.550625711036
Trailer Park Boys: The Movie,10/6/2006,5000000,3833507,-1166493,18996.565906838452
Choke,9/26/2008,3000000,3830137,830137,17685.200832975486
Critters 2,4/29/1988,4500000,3813293,-686707,32453.55744680851
Bad Day at Black Rock,1/7/1955,1271000,3788000,2517000,141872.65917602996
Atanarjuat,2/1/2002,1934000,3786801,1852801,21298.093363329583
Paris is Burning,3/13/1990,500000,3779620,3279620,29367.67676767677
Batman: The Killing Joke,7/21/2016,3500000,3775000,275000,15673.720879057004
Pa Negre,10/10/2010,6000000,3770657,-2229343,17240.36285326298
The Monster Squad,8/14/1987,12000000,3769990,-8230010,32954.45804195804
Napola �?Elite für den Führer,7/4/2004,4500000,3764219,-735781,19874.440337909185
When Time Ran Out...,3/28/1980,20000000,3763988,-16236012,46468.98765432099
Escobar: Paradise Lost,10/11/2014,17000000,3758328,-13241672,15829.004392818186
Mannequin Two: On the Move,1/7/1991,13000000,3752426,-9247574,27878.350668647847
The Big Kahuna,4/28/2000,7000000,3728888,-3271112,21742.78717201166
By the Sea,11/12/2015,10000000,3727746,-6272254,15706.618464961068
The Gun in Betty Lou's Handbag,8/21/1992,13000000,3721911,-9278089,26340.48832271762
Gåten Ragnarok,11/11/2013,6500000,3721345,-2778655,15966.709429396446
Watership Down,10/14/1978,1000000,3713768,2713768,55346.76602086439
Na Igre,11/26/2009,3500000,3704408,204408,17154.08730765134
The Double,10/27/2011,17000000,3696232,-13303768,16338.381293374001
Lost Highway,1/15/1997,15000000,3675201,-11324799,23099.9434318039
Killer Joe,9/10/2011,10000000,3665069,-6334931,16153.577299913173
The Keep,12/16/1983,6000000,3661757,-2338243,35934.808635917565
The Cat's Meow,8/3/2001,7000000,3646994,-3353006,20546.445070422535
Empire State,9/3/2013,11000000,3639345,-7360655,15542.8594612832
피에타,9/5/2012,103000,3623330,3520330,15657.823661341272
Colonia,2/18/2016,14000000,3621046,-10378954,15206.04538659231
After.Life,4/9/2010,4500000,3606395,-893605,16542.413386603308
Phoenix Forgotten,4/21/2017,2800000,3600000,800000,14709.908349098814
The New Adventures of Pippi Longstocking,7/6/1988,5000000,3569939,-1430061,30126.067510548524
Cats Don't Dance,3/26/1997,32000000,3566637,-28433363,22263.65168539326
The To Do List,7/24/2013,1500000,3566225,2066225,15248.292906100214
Free Fire,3/31/2017,10000000,3565109,-6434891,14579.791758682175
Mr. Nobody,9/11/2009,47000000,3547209,-43452791,16424.621126180147
Like Crazy,10/28/2011,250000,3542353,3292353,15658.19298943553
The Midnight Meat Train,8/7/2008,15000000,3533227,-11466773,16127.123595300474
Born into Brothels,12/8/2004,350000,3515061,3165061,18471.156069364162
Miss Sloane,11/25/2016,13000000,3500605,-9499395,14499.341429470825
The Wraith,11/21/1986,2700000,3500000,800000,31674.20814479638
Mommy,5/22/2014,4900000,3494070,-1405930,14659.838971566189
Veronica Mars,3/13/2014,6000000,3485127,-2514873,14749.17581138671
Heaven's Gate,11/19/1980,44000000,3484331,-40515669,40374.63499420626
Talk Radio,12/21/1988,4000000,3468572,-531428,28642.21304706854
Добрыня Никитич и Змей Горыныч,3/16/2006,4500000,3468423,-1031577,17213.017369727047
Wild Target,6/17/2010,8000000,3453043,-4546957,15838.847581085358
The Homesman,5/18/2014,16000000,3442853,-12557147,14444.95118379814
Les Invasions barbares,5/21/2003,8000000,3432342,-4567658,18684.49646162221
The Grand Seduction,5/30/2014,12700000,3430018,-9269982,14391.100221109913
Disconnect,9/11/2012,10000000,3428048,-6571952,14813.933891368886
C.H.U.D.,8/31/1984,1250000,3412497,2162497,32499.97142857143
Everybody Wants Some!!,3/30/2016,10000000,3400278,-6599722,14211.584838314644
Demonic,2/12/2015,3000000,3387000,387000,14429.836146590435
Dear Zindagi,11/24/2016,4300000,3376375,-923625,13984.786606580736
Starchaser: The Legend of Orin,1/1/1985,15000000,3360800,-11639200,31855.924170616112
Somebody Up There Likes Me,7/3/1956,1920000,3360000,1440000,122627.73722627737
The Work and the Glory,11/24/2004,7500000,3347647,-4152353,17591.41881240147
Robinson Crusoe,2/4/2016,13500000,3342697,-10157303,14097.604075728246
Unknown,11/3/2006,3700000,3338228,-361772,16566.888337468983
Robot & Frank,8/16/2012,2500000,3325038,825038,14368.787461053467
Child 44,3/15/2015,50000000,3324330,-46675670,14079.044888382552
Table 19,1/20/2017,5000000,3305592,-1694408,13569.586581446041
風の谷のナウシカ,3/11/1984,1000000,3301446,2301446,32177.836257309944
Only the Strong,8/27/1993,6000000,3283371,-2716629,22628.332184700208
Romeo Is Bleeding,9/13/1993,11500000,3275585,-8224415,22574.672639558925
The Sweet Hereafter,5/14/1997,5000000,3263585,-1736415,20384.665833853844
Pinocchio and the Emperor of the Night,8/6/1987,8000000,3261638,-4738362,28510.821678321678
Straw Dogs,12/29/1971,2200000,3251794,1051794,79119.07542579075
Treehouse,10/20/2014,3250000,3250000,0,13762.380849541183
Drona,10/2/2008,15000000,3250000,-11750000,15006.487419946161
Forbidden Planet,3/15/1956,1900000,3250000,1350000,121268.65671641791
Barfly,9/2/1987,3000000,3221568,221568,28013.634782608697
Pi,7/10/1998,60000,3221152,3161152,19737.450980392157
Green Room,4/15/2016,5000000,3220371,-1779629,13459.657027263114
Balada triste de trompeta,12/17/2010,7000000,3218666,-3781334,14615.485212716201
Top Hat,9/6/1935,609000,3202000,2593000,233722.62773722628
Der Himmel über Berlin,1/1/1987,2500000,3200000,700000,28776.978417266186
The Silver Chalice,12/20/1954,4500000,3200000,-1300000,119850.1872659176
Point Blank,8/30/1967,2500000,3200000,700000,95238.09523809524
Your Sister's Sister,9/11/2011,125000,3200000,3075000,14103.812877662645
The Limey,5/15/1999,10000000,3193102,-6806898,19212.406738868835
Silent Fall,10/28/1994,30000000,3180674,-26819326,21246.98730794923
Riding Giants,7/9/2004,2600000,3166000,566000,16715.945089757126
Clerks,9/13/1994,27000,3151130,3124130,21091.90093708166
Two Lovers,11/19/2008,12000000,3148182,-8851818,14975.084194303327
Flypaper,8/19/2011,5000000,3142154,-1857846,13848.860015249747
Night of the Demons,10/14/1988,1200000,3109904,1909904,25872.745424292843
Shabd,2/4/2005,2500000,3100000,600000,16162.669447340979
Birdman of Alcatraz,7/3/1962,2650000,3100000,450000,102310.23102310231
Take Shelter,11/25/2011,5000000,3099314,-1900686,13733.710872416605
Jawbreaker,1/30/1999,3000000,3076820,76820,18704.072948328267
Waterloo,10/26/1970,25000000,3052000,-21948000,77070.70707070707
Heavenly Creatures,9/2/1994,5000000,3049135,-1950865,20409.20348058902
Catfish,9/17/2010,30000,3045943,3015943,13926.793805524185
Mambo Italiano,6/6/2003,4361898,3031801,-1330097,16504.08818726184
Rock the Kasbah,10/22/2015,15000000,3020664,-11979336,12727.373849732025
Original Gangstas,5/10/1996,4800000,3014000,-1786000,19246.487867177522
Basquiat,8/9/1996,2962051,3011195,49144,19143.00699300699
Isn't She Great,1/28/2000,36000000,3003296,-32996704,17687.25559481743
Predestination,8/28/2014,5500000,3000000,-2500000,12603.400397427225
Tentacoli,2/25/1977,750000,3000000,2250000,50420.16806722689
Warlords of the 21st Century,1/1/1982,1000000,3000000,2000000,31813.36161187699
Fort Apache,3/26/1948,2500000,3000000,500000,126050.42016806723
Myra Breckinridge,6/24/1970,5000000,3000000,-2000000,76923.07692307692
Marty,4/11/1955,343000,3000000,2657000,112359.55056179776
Dial M for Murder,5/29/1954,1400000,3000000,1600000,111524.16356877323
The Fly,7/16/1958,700000,3000000,2300000,103806.22837370243
Mean Streets,10/2/1973,500000,3000000,2500000,65789.47368421052
The Runaways,3/19/2010,10000000,2995811,-7004189,13741.68497630832
"\"नीरज�?\"\"Neerja is a portrayal on the life of the courageous Neerja Bhanot\"",2/19/2016,10721568,2978994,-7742574,12509.843280197538
In a World...,8/9/2013,1000000,2963902,1963902,12672.90926427139
The Pirate,6/11/1948,3700000,2956000,-744000,122655.60165975103
Gracie,6/1/2007,9000000,2955039,-6044961,14182.916410689602
Scarlet Street,12/28/1945,1202007,2948386,1746379,161999.23076923078
The Legend of the Lone Ranger,8/20/1981,18000000,2945600,-15054400,31605.150214592275
Shattered Glass,11/14/2003,6000000,2944752,-3055248,15960.71544715447
Love! Valour! Compassion!,5/16/1997,2000000,2900000,900000,18091.079226450405
The Wackness,7/3/2008,6000000,2899975,-3100025,13183.86190467531
Tadpole,11/1/2002,150000,2891288,2741288,15947.534473248757
Home Run,4/19/2013,1200000,2861020,1661020,12281.95496791088
eXistenZ,4/14/1999,15000000,2856712,-12143288,17188.399518652226
Airborne,9/17/1993,2600000,2850263,250263,19562.54632807138
I'm No Angel,10/6/1933,225000,2850000,2625000,215909.0909090909
Things We Lost in the Fire,9/26/2007,16000000,2849142,-13150858,13636.43412336792
3 Godfathers,12/1/1948,1243000,2841000,1598000,117883.81742738589
The Perez Family,5/12/1995,11000000,2832826,-8167174,18612.52299605782
Sid & Nancy,11/7/1986,4000000,2826523,-1173477,25602.5634057971
Raising Victor Vargas,5/16/2002,800000,2816116,2016116,15653.78543635353
Return to the Blue Lagoon,8/2/1991,11000000,2807854,-8192146,20555.300146412887
Happiness,10/16/1998,3000000,2807390,-192610,17118.231707317074
Barfi!,9/14/2012,4437508,2804874,-1632634,12120.955718712052
Captive,9/17/2015,2000000,2801508,801508,11779.059696095663
Pizza,10/19/2012,240000,2800000,2560000,12162.22672996816
Phoonk,8/22/2008,750000,2760000,2010000,12615.239758116491
Aquí Entre Nos,3/30/2012,1,2755584,2755583,11976.373948758068
Oh Boy,7/3/2012,300000,2750275,2450275,12004.482680354773
The Charge of the Light Brigade,10/20/1936,1200000,2736000,1536000,195428.57142857142
Shadows and Fog,12/5/1991,14000000,2735731,-11264269,19838.51341551849
Sukiyaki Western Django,9/15/2007,3800000,2725258,-1074742,13071.408700657104
Everything is Illuminated,9/16/2005,7000000,2697930,-4302070,13543.82530120482
Sankofa,5/28/1993,1000000,2691899,1691899,18641.959833795012
One Night Stand,11/14/1997,24000000,2642983,-21357017,16365.219814241485
హ్యాపీ డేస్,9/28/2007,440141,2640850,2200709,12639.51640693801
Find Me Guilty,3/16/2006,13000000,2636637,-10363363,13085.047146401985
The Raid 2: Berandal,3/27/2014,4500000,2627209,-1872791,11081.90338800027
Captivity,3/9/2007,17000000,2626800,-14373200,12791.694261560637
Shalako,11/6/1968,1455000,2620000,1165000,74011.29943502825
Утомлённые солнцем,5/1/1994,2800000,2616503,-183497,17739.00338983051
Everything Must Go,10/15/2010,5000000,2614773,-2385227,11955.379473368967
Queen Christina,12/26/1933,1114000,2610000,1496000,197727.27272727274
But I'm a Cheerleader,9/12/1999,1200000,2600000,1400000,15485.407980941036
Swing Time,8/27/1936,886000,2600000,1714000,185714.2857142857
Grand Hotel,5/25/1932,700000,2594000,1894000,190735.29411764708
Calendar Girl,9/3/1993,13000000,2570145,-10429855,17712.92212267402
Bride Flight,10/15/2008,6400000,2556911,-3843089,11806.23161705291
King of New York,7/18/1990,1000000,2554476,1554476,19410.911854103346
Truth,9/12/2015,9600000,2541554,-7058446,10681.266679274622
Machine Gun Preacher,9/23/2011,30000000,2527904,-27472096,11164.618122877295
Full Frontal,8/2/2002,2000000,2506446,506446,13870.75816270061
Ridicule,5/9/1996,3000000,2503829,-496171,15988.690932311623
ആക്ഷ�?ഹീറോ ബിജു,2/4/2016,300000,2500000,2200000,10543.585071970512
Double Indemnity,4/24/1944,927262,2500000,1572738,142857.14285714287
Young Adam,9/26/2003,6400000,2500000,-3900000,13513.513513513513
The Miracle Worker,5/22/1962,500000,2500000,2000000,82781.45695364238
The Gold Rush,6/25/1925,923000,2500000,1577000,141242.93785310735
From Prada to Nada,1/28/2011,93,2500000,2499907,11296.422648875554
The Kid,1/21/1921,250000,2500000,2250000,135869.56521739133
Barbarella,10/10/1968,9000000,2500000,-6500000,70821.5297450425
Rumble Fish,10/20/1983,10000000,2494480,-7505520,24649.011857707508
Jefferson in Paris,3/31/1995,14000000,2474000,-11526000,16287.03094140882
Wonderland,10/23/2003,5000000,2466444,-2533556,13368.260162601626
Class of 1999,5/11/1990,5200000,2459895,-2740105,19039.434984520125
My Beautiful Laundrette,9/7/1985,860000,2451545,1591545,22636.611265004616
Kill the Messenger,10/9/2014,5000000,2450846,-2549154,10322.263543820784
Table For Five,2/18/1983,8000000,2439705,-5560295,24920.37793667007
Son of the Pink Panther,1/1/1993,25000000,2438031,-22561969,17096.991584852734
THX 1138,3/11/1971,777000,2437000,1660000,60925.0
You Kill Me,2/9/2007,4000000,2426851,-1573149,11925.616342095047
Farewell to the King,3/3/1989,16000000,2420917,-13579083,19794.905968928862
Blood Ties,8/22/2013,25500000,2415472,-23084528,10315.961204190495
FC Venus,12/30/2005,2196531,2411594,215063,12161.341401916288
BloodRayne,10/22/2005,25000000,2405420,-22594580,12173.178137651823
Lowriders,4/28/2017,916000,2403885,1487885,9822.480008825945
Sidewalks of New York,11/23/2001,1000000,2402459,1402459,13596.259196378043
The East,5/31/2013,6500000,2401510,-4098490,10284.663217760724
Unfriend,1/7/2016,9900000,2400000,-7500000,10130.172719444867
Desert Hearts,10/1/1985,350000,2400000,2050000,22079.116835326586
Kalifornia,9/1/1993,9000000,2395231,-6604769,16507.450034458994
La vida precoz y breve de Sabina Rivas,11/9/2012,4620000,2395000,-2225000,10403.047506526338
El hombre de las mil caras,9/23/2016,5000000,2387127,-2612873,9875.21977090047
Buffalo '66,1/20/1998,1500000,2375097,875097,14670.148239654107
The Guest,9/17/2014,5000000,2367161,-2632839,9969.806219017575
Joe,4/11/2014,4000000,2365467,-1634533,9977.842174529256
Cake,9/7/2014,7000000,2360281,-4639719,9915.85549781331
Fish Tank,5/14/2009,3000000,2357852,-642148,11025.418973514888
Ballerina,12/14/2016,30000000,2351359,-27648641,9739.218496305379
At Close Range,4/18/1986,6500000,2347000,-4153000,21551.882460973367
Elle,5/25/2016,9804690,2341534,-7463156,9715.183098357798
Double Dragon,11/4/1994,3500000,2341309,-1158691,15640.006680026721
Me and Orson Welles,11/25/2009,25000000,2336172,-22663828,10818.165400163927
Jem and the Holograms,10/22/2015,5000000,2333684,-2666316,9832.827721036841
ആനന്ദം,10/21/2016,450000,2300000,1850000,9529.610156078441
Jackson County Jail,3/31/1976,445000,2300000,1855000,40998.217468805706
Mio min Mio,7/1/1987,7200000,2300000,-4900000,20210.896309314587
Repo Man,2/20/1984,1500000,2300000,800000,22417.153996101366
Under the Rainbow,7/31/1981,20000000,2297493,-17702507,24891.581798483207
The Rover,5/18/2014,12250000,2295423,-9954577,9630.75483651712
Na Igre 2. Novyy Uroven,4/15/2010,3500000,2294357,-1205643,10524.138911696307
The Company,9/10/2003,15000000,2281585,-12718415,12319.57343412527
Fur: An Imaginary Portrait of Diane Arbus,8/30/2006,16800000,2281089,-14518911,11242.429768358797
42nd Street,2/2/1933,439000,2281000,1842000,179606.29921259845
Noises Off...,3/20/1992,12000000,2280148,-9719852,16345.146953405017
Ninotchka,10/6/1939,1365000,2279000,914000,162785.7142857143
Showdown in Little Tokyo,8/23/1991,8000000,2275557,-5724443,16585.692419825074
The Women,1/1/1939,1688000,2270000,582000,162142.85714285713
Bronson,10/9/2008,230000,2260712,2030712,10438.568057883485
Leprechaun 2,4/7/1994,2000000,2260622,260622,15336.648575305291
Na Maloom Afraad,10/6/2014,884130,2259444,1375314,9516.132972249014
ലോഹം,8/20/2015,1050255,2250547,1200292,9458.265565571875
Touch of Evil,4/23/1958,829000,2247465,1418465,77766.95501730104
Пиковая дама: Черный обряд,9/10/2015,1000000,2228115,1228115,9363.991678749291
Mata Hari,12/26/1931,558000,2227000,1669000,155734.26573426573
She Done Him Wrong,2/9/1933,200000,2200000,2000000,173228.34645669293
Legend of the Lost,12/17/1957,1750000,2200000,450000,76923.07692307692
The Molly Maguires,1/27/1970,11000000,2200000,-8800000,57894.73684210526
Rope,8/23/1948,1500000,2200000,700000,89795.91836734694
Austenland,8/15/2013,4900000,2159041,-2740959,9231.523407603141
Heartbeeps,12/18/1981,10000000,2154696,-7845304,22849.374337221634
Shadow Conspiracy,1/31/1997,45000000,2154540,-42845460,13499.624060150376
Paterson,11/17/2016,5000000,2152738,-2847262,8916.539646774247
Антикиллер Д.К.: Любовь без памяти,12/3/2009,2500000,2141028,-358972,9914.50759207035
Setup,11/4/2011,20000000,2128186,-17871814,9407.178535119127
Mallrats,10/20/1995,6000000,2122561,-3877439,13818.756510416668
Videodrome,2/4/1983,5952000,2120439,-3831561,21659.233912155258
The Nutcracker,11/24/1993,19000000,2119994,-16880006,14540.425240054868
Stolen,5/17/2012,35000000,2106557,-32893443,9179.77758216474
"\"இறுதிச்சுற்ற�?\"\"A grumpy boxing coach takes on a young\"",1/28/2016,300000,2100000,1800000,8856.61146045523
It Came from Hollywood,12/10/1982,5000000,2091037,-2908963,21424.55942622951
Equals,7/15/2015,16000000,2084628,-13915372,8734.938446453862
The Sheltering Sky,10/24/1990,25000000,2075084,-22924916,15508.849028400597
Ayurveda: Art of Being,9/20/2001,300000,2074000,1774000,11671.356218345527
Auto Focus,10/18/2002,7000000,2062066,-4937934,11373.778268063981
Two Girls and a Guy,9/7/1997,1000000,2057193,1057193,12761.743176178661
Man of Tai Chi,7/4/2013,25000000,2054941,-22945059,8796.987105943595
Trick,7/23/1999,450000,2049595,1599595,12265.679233991623
Testament,11/4/1983,1500000,2044892,544892,20206.442687747036
Big Bully,1/26/1996,15000000,2042530,-12957470,13186.120077469335
El Mariachi,9/4/1992,220000,2040920,1820920,14443.878273177635
Wabash Avenue,3/31/1950,2115000,2039000,-76000,86398.30508474576
We Don't Live Here Anymore,1/20/2004,3000000,2037545,-962455,10942.776584317939
Mutant Chronicles,8/7/2008,8000000,2033165,-5966835,9280.21416247501
This Is Elvis,4/4/1981,5000000,2028612,-2971388,22767.811447811448
Novocaine,11/23/2001,6000000,2025238,-3974762,11461.448783248445
The Work and the Glory II: American Zion,10/21/2005,6500000,2025032,-4474968,10248.137651821862
Re-Animator,10/18/1985,900000,2023414,1123414,18563.43119266055
Bad Lieutenant,9/16/1992,1000000,2019469,1019469,14241.671368124118
Maurice Richard,10/25/2005,8000000,2019009,-5980991,10217.656882591093
The Gorgeous Hussy,8/28/1936,1119000,2019000,900000,144214.2857142857
Night on Earth,10/3/1991,3500000,2015810,-1484190,14671.106259097525
Voditel dlya Very,7/27/2004,3300000,2011837,-1288163,10616.554089709762
I'm Not Ashamed,10/21/2016,1500000,2000000,500000,8286.617527024731
I Was a Teenage Werewolf,6/19/1957,82000,2000000,1918000,70671.37809187279
Roar,11/12/1981,17000000,2000000,-15000000,21344.71718249733
Youth,5/20/2015,13360000,2000000,-11360000,8380.8949119587
The Wrong Man,12/22/1956,1200000,2000000,800000,72463.76811594203
Red Rock West,7/8/1993,8000000,2000000,-6000000,13850.415512465373
Passengers,9/26/2008,25000000,2000000,-23000000,9234.761489197637
The War of the Worlds,8/13/1953,2000000,2000000,0,74349.44237918216
The Pit and the Pendulum,8/12/1961,200000,2000000,1800000,66889.63210702341
Laura,10/11/1944,1020000,2000000,980000,112994.35028248587
Capone,4/16/1975,970000,2000000,1030000,37593.984962406015
A Countess from Hong Kong,1/5/1967,3500000,2000000,-1500000,60790.273556231004
Wilson,8/1/1944,2995000,2000000,-995000,112994.35028248587
Dillinger,7/20/1973,1000000,2000000,1000000,44345.89800443459
Limbo,6/4/1999,8000000,1997807,-6002193,12020.499398315284
Surviving Picasso,9/4/1996,16000000,1985001,-14014999,12579.22053231939
Død snø,1/9/2009,800000,1984662,1184662,9399.610690385189
Zero Effect,1/30/1998,5000000,1980338,-3019662,12231.859172328597
Demolition,4/6/2016,10000000,1978592,-8021408,8269.59680014712
The Iceman,9/1/2012,20000000,1969193,-18030807,8509.651825571396
Felix The Cat: The Movie,10/1/1988,9000000,1964253,-7035747,16341.539101497503
Na Kryuchke!,2/3/2011,3000000,1957000,-1043000,8842.839649539785
A Dirty Shame,9/12/2004,15000000,1914166,-13085834,10079.86308583465
Permanent Record,4/22/1988,8000000,1893139,-6106861,16111.821276595745
Vibes,8/5/1988,1884000,1883811,-189,15830.344537815126
Запрещeнная реальность,10/8/2009,7000000,1877122,-5122878,8683.264177040111
A Quiet Passion,10/7/2016,8138338,1864266,-6274072,7712.214918358988
Bitter Moon,9/2/1992,5000000,1862805,-3137195,13183.333333333332
Clouds of Sils Maria,8/20/2014,6600000,1851517,-4748483,7778.470031214421
Crooked Arrows,5/18/2012,13000000,1832541,-11167459,7985.693617688841
Renaissance,3/16/2006,18000000,1831348,-16168652,9088.575682382134
Tusk,9/19/2014,2800000,1826705,-973295,7693.559867415229
Delicatessen,4/17/1991,4000000,1794187,-2205813,13231.46755162242
The Vatican Tapes,7/24/2015,13000000,1784763,-11215237,7489.060742879203
Paws,9/25/1997,137731,1778391,1640660,11004.8948019802
Saul fia,6/11/2015,1000000,1777043,777043,7446.605318515911
Another Earth,7/22/2011,100000,1776935,1676935,7843.629301021872
Он - дракон,12/4/2015,18000000,1776333,-16223667,7510.127893457351
A Better Life,6/24/2011,10000000,1759252,-8240748,7786.9884296350065
Flipped,8/6/2010,14000000,1755212,-12244788,8039.924511708014
Carnosaur,5/21/1993,1000000,1753979,753979,12146.668975069251
Murderball,7/22/2005,300000,1750211,1450211,8911.461303462322
Hard Contract,4/30/1969,4000000,1750000,-2250000,48076.92307692308
Chalet Girl,2/2/2011,8000000,1749457,-6250543,7905.042271213552
Third Person,9/9/2013,28000000,1749201,-26250799,7470.461116639405
The Broken Hearts Club: A Romantic Comedy,2/1/2000,1000000,1744858,744858,10275.959952885747
La Cité des Enfants Perdus,5/16/1995,18000000,1738611,-16261389,11400.727868852458
Алеша Попович и Тугарин Змей,12/23/2004,4000000,1730000,-2270000,9071.840587309911
Mary and Max,2/9/2009,590235,1725381,1135146,8131.187173940704
Mrs Palfrey at The Claremont,11/25/2005,750000,1720953,970953,8744.67987804878
A Home of Our Own,11/5/1993,12000000,1703282,-10296718,11682.318244170096
Death Wish 5: The Face of Death,1/14/1994,5000000,1702394,-3297606,11644.281805745555
Steel,8/15/1997,16000000,1686429,-14313571,10487.742537313432
Matewan,8/28/1987,4000000,1680358,-2319642,14611.808695652175
Who Killed the Electric Car?,8/4/2006,1000000,1678874,678874,8233.810691515448
Marci X,8/22/2003,20000000,1675706,-18324294,9048.088552915768
Nothing Left to Fear,9/26/2013,3000000,1675381,-1324619,7173.666001558579
L.I.E. Long Island Expressway,1/20/2001,700000,1667192,967192,9483.458475540387
Out on a Limb,9/4/1992,11000000,1659542,-9340458,11744.81245576787
2 Days in New York,3/28/2012,8000000,1653792,-6346208,7187.743659951757
I Saw the Light,2/5/2016,13000000,1646788,-11353212,6945.21974940007
Ondine,9/14/2009,12000000,1644755,-10355245,7615.699475387672
Pirates,5/8/1986,40000000,1641825,-38358175,15076.446280991735
Gun Shy,2/4/2000,10000000,1631839,-8368161,9610.359246171967
2 Coelhos,1/20/2012,2000000,1620436,-379564,7117.695892613205
Laitakaupungin valot,2/3/2006,1380000,1615018,235018,8127.92148968294
Space Truckers,3/1/1996,25000000,1614266,-23385734,10367.797045600515
Cabin in the Sky,4/9/1943,662141,1606624,944483,92334.71264367817
Dumbo,10/22/1941,812000,1600000,788000,103896.10389610389
Бумер,8/2/2003,700000,1600000,900000,8667.38894907909
Lovelace,8/8/2013,10000000,1585582,-8414418,6779.555065269351
Solarbabies,11/26/1986,25000000,1579260,-23420740,14291.945701357467
Lay the Favorite,6/22/2012,26350000,1576687,-24773313,6881.970633424122
9 Songs,7/16/2004,1000000,1574623,574623,8309.356200527705
Veronica Guerin,7/11/2003,17000000,1569918,-15430082,8536.802610114191
Hamlet,5/12/2000,2000000,1568749,-431251,9147.224489795919
Valentino,3/8/1951,1300000,1550000,250000,60077.51937984496
A Home at the End of the World,7/23/2004,6500000,1548955,-4951045,8173.905013192612
Beowulf,4/1/1999,20000000,1531251,-18468749,9213.303249097473
キャシャーン,4/24/2004,6000000,1530216,-4469784,8092.099418297197
Josh and S.A.M.,11/24/1993,18000000,1528163,-16471837,10481.22770919067
The Messenger,11/13/2009,6500000,1521261,-4978739,7032.131465816114
ഓം ശാന്തി ഓശാന,2/7/2014,220000,1500000,1280000,6388.932664909
बॉम्बे वेलवेट,5/15/2015,18000000,1500000,-16500000,6307.6890729799625
Aanrijding in Moscou,1/30/2008,560000,1500000,940000,7085.7326411359845
Heavy Traffic,8/8/1973,950000,1500000,550000,33259.42350332594
Cannonball,7/6/1976,780000,1500000,720000,26269.70227670753
The Private Life of Sherlock Holmes,10/29/1970,10000000,1500000,-8500000,37878.78787878788
At Long Last Love,3/1/1975,6000000,1500000,-4500000,28462.99810246679
The Raven,1/25/1963,350000,1499275,1149275,49318.256578947374
Dans les forêts de Sibérie,6/15/2016,3500000,1492523,-2007477,6192.578977503755
Il cartaio,1/2/2004,2600000,1479042,-1120958,7986.187904967603
Les triplettes de Belleville,6/11/2003,8000000,1477676,-6522324,8043.96298312466
Glukhar v kino,5/6/2010,2500000,1477030,-1022970,6769.83930552118
The Diary of a Teenage Girl,8/7/2015,2000000,1477002,-522998,6197.661927860488
"\"アップルシー�?\"\"In a utopian society created at the end of the third world war\"",4/17/2004,10000000,1461989,-8538011,7731.3008989952405
Shaft in Africa,6/14/1973,2142000,1458000,-684000,32986.42533936651
House of Usher,6/21/1960,270000,1450000,1180000,48986.48648648649
Night Of The Living Dead 3D,5/6/2007,3000000,1449945,-1550055,6972.599050728784
Nieve negra,1/19/2017,4000000,1440000,-2560000,5911.257250526472
Anna Karenina,8/30/1935,1152000,1439000,287000,105036.49635036496
The Kid Stays in the Picture,1/18/2002,40000,1434436,1394436,8067.6940382452185
A Prayer for the Dying,9/11/1987,6000000,1432687,-4567313,12458.147826086957
No End in Sight,7/27/2007,2000000,1431623,-568377,6885.5504840874
Infinitely Polar Bear,1/18/2014,6700000,1430655,-5269345,6093.572307810257
I Hope They Serve Beer in Hell,9/25/2009,7000000,1429299,-5570701,6611.707073370433
Poulet aux Prunes,10/25/2011,12000000,1428291,-10571709,6313.446492507625
The Thin Man,5/25/1934,226408,1423000,1196592,106194.02985074627
Антидурь,9/6/2007,5000000,1413000,-3587000,6777.30346779222
99 Homes,10/9/2014,8000000,1411927,-6588073,5946.633366044316
Universal Soldier: Day of Reckoning,10/4/2012,11500000,1402307,-10097693,6062.2738493063625
From a Whisper to a Scream,9/25/1987,1100000,1400000,300000,12142.237640936688
இன்ற�?நேற்று நாளை,6/26/2015,620000,1400000,780000,5866.233124104352
Birdy,12/14/1984,12000000,1400000,-10600000,13295.346628679963
Goodbye Pork Pie,2/5/1981,300000,1400000,1100000,15927.189988623435
Jane Got a Gun,1/1/2016,25000000,1397284,-23602716,5897.803440882
Toni Erdmann,7/14/2016,3537415,1390172,-2147243,5777.266153564839
Snow Cake,2/9/2006,12000000,1381665,-10618335,6953.522898842477
Gimme Shelter,10/17/2013,7500000,1359910,-6140090,5834.7957042764165
The Paperboy,9/14/2012,12500000,1353868,-11146132,5850.592246561253
At Play in the Fields of the Lord,12/6/1991,36000000,1345903,-34654097,9759.992748368382
The Neon Demon,6/8/2016,7000000,1333124,-5666876,5531.221734476263
Snow Flower and the Secret Fan,7/15/2011,134005,1332231,1198226,5896.8626340064275
Dikari,11/23/2006,800000,1328612,528612,6583.8057482656095
The Work and the Glory III: A House Divided,11/22/2006,6500000,1325092,-5174908,6566.3627353815655
El Abrazo de la Serpiente,5/25/2015,1400000,1320005,-79995,5531.4115941300215
The Year of Living Dangerously,12/17/1982,6000000,1317657,-4682343,13472.9754601227
Трудно быть богом,2/27/2013,7000000,1310673,-5689327,5630.6917039347345
Personal Shopper,10/19/2016,6000000,1305195,-4694805,5407.825881592522
Native Son,12/24/1986,2000000,1301121,-698879,11700.728417266188
ബാംഗ്ലൂർ ഡെയ്സ്,5/30/2014,7400000,1300000,-6100000,5454.324230206048
Ace in the Hole,6/29/1951,1821052,1300000,-521052,50193.05019305019
Julia,2/9/2008,6000000,1300000,-4700000,6140.96828898452
Paper Heart,7/31/2009,1000000,1296971,296971,6009.113485363751
Tumbleweeds,11/28/1999,312000,1281176,969176,7612.45395127748
The Rapture,10/4/1991,1227401,1277401,50000,9296.950509461427
Mary of Scotland,8/28/1936,864000,1276000,412000,91142.85714285714
Blue in the Face,9/15/1995,2000000,1275000,-725000,8322.454308093995
Donnie Darko,1/18/2001,6000000,1270522,-4729478,7227.087599544937
Zid,11/28/2014,1556288,1268395,-287893,5401.74692945846
From Beyond,6/5/1986,4500000,1261000,-3239000,11515.981735159818
The Last Wave,1/1/1977,810000,1258000,448000,21504.273504273504
Boris - Il film,4/1/2011,3347850,1248748,-2099102,5552.310743154918
Losin' It,4/8/1983,7000000,1246141,-5753859,12638.346855983773
Slow Burn,9/12/2005,15500000,1237615,-14262385,6225.427565392354
The Funeral,1/26/1996,12500000,1227324,-11272676,7923.3311814073595
The Thief of Bagdad,3/18/1924,1135654,1213880,78226,71404.70588235294
Lights of New York,7/18/1928,75000,1200000,1125000,70175.43859649122
Mindscape,10/13/2013,4357373,1200000,-3157373,5138.1740642100485
Five Graves to Cairo,5/3/1943,855000,1200000,345000,68571.42857142857
Seraphim Falls,9/13/2006,18000000,1196307,-16803693,5896.042385411532
Cool as Ice,10/18/1991,6000000,1193062,-4806938,8657.924528301886
Repentance,2/28/2014,5000000,1189612,-3810388,5034.4783806545265
The Lair of the White Worm,9/14/1988,2500000,1189315,-1310685,9927.504173622705
Videocracy,9/4/2009,700000,1179676,479676,5462.246896545337
The Lords of Salem,9/10/2012,1500000,1165882,-334118,5038.231341316382
4.3.2.1,6/2/2010,4600000,1163967,-3436033,5340.155529557498
Tarnation,10/19/2003,218,1162014,1161796,6298.178861788618
Trois,2/11/2000,200000,1160268,960268,6833.144876325088
Infamous,11/16/2006,13000000,1151330,-11848670,5705.302279484638
Living in Oblivion,1/20/1995,500000,1148752,648752,7612.670642809808
Miracle Mile,5/19/1989,3000000,1145404,-1854596,9229.685737308622
The Other Man,12/25/2008,15000000,1143856,-13856144,5417.446943540634
Valmont,11/17/1989,33000000,1132112,-31867888,8977.890563045203
The Painted Veil,11/23/1934,947000,1120000,173000,83582.0895522388
Surveillance,2/8/2008,3500000,1115493,-2384507,5269.390107372468
The Messengers,2/2/2007,16000000,1109660,-14890340,5452.901488459403
Red State,8/19/2011,4000000,1104682,-2895318,4868.821317913164
Stagecoach,3/2/1939,531374,1103757,572383,79406.97841726619
Bad Moon,11/1/1996,7000000,1100000,-5900000,6935.687263556117
Casino Jack,9/16/2010,12500000,1083683,-11416317,4954.862809826666
Coriolanus,2/14/2011,7700000,1072602,-6627398,4846.626210411687
Vanishing on 7th Street,9/11/2010,10000000,1068682,-8931318,4892.3589652031005
What Maisie Knew,5/2/2013,6000000,1066471,-4933529,4578.209448582284
50 to 1,3/21/2014,10000000,1064454,-8935546,4490.003037052034
The Mother,1/1/2003,2500000,1062253,-1437747,5846.19152449092
Lolita,9/27/1997,62000000,1060056,-60939944,6559.752475247525
Undiscovered,8/26/2005,9000000,1046166,-7953834,5262.404426559356
Money for Nothing,9/10/1993,11000000,1044824,-9955176,7200.716747070986
Invisible Agent,7/31/1942,322000,1040000,718000,63030.30303030303
Crossing Over,2/27/2009,25000000,1037335,-23962665,4876.780014009751
Phantom,1/3/2013,10000000,1034589,-8965411,4492.74361646691
My Best Girl,10/31/1927,483103,1027757,544654,59407.919075144506
5 Flights Up,9/5/2014,6000000,1020921,-4979079,4289.025379047267
Horsemen,2/6/2009,20000000,1017401,-18982599,4794.696337767975
The Hollars,8/25/2016,3800000,1016985,-2783015,4212.373875441125
"\"रम�?राघव �?�?\"\"Set in present day Mumbai the story follows the life of a serial killer Ramanna who is inspired by an infamous serial killer from the 1960s Raman Raghav. His strange obsession with Raghavan\"",6/24/2016,521873,1013926,492053,4213.665907541932
Dracula,2/12/1931,355000,1012189,657189,64470.63694267516
The Girlfriend Experience,1/20/2009,1700000,1007962,-692038,4750.213249258929
Ruby in Paradise,10/8/1993,800000,1001437,201437,6873.280713795471
12 Angry Men,3/25/1957,350000,1000000,650000,35842.29390681004
Animal Kingdom,6/3/2010,5000000,1000000,-4000000,4587.892551556442
Louis C.K.: Live at the Beacon Theater,12/10/2011,250000,1000000,750000,4431.209897550427
Redd Inc.,11/3/2012,500000,1000000,500000,4343.652403560058
The Maltese Falcon,11/18/1941,375000,1000000,625000,64516.12903225807
Robot Monster,6/25/1953,16000,1000000,984000,37313.432835820895
Halo Legends,2/16/2010,100000,1000000,900000,4594.93362618377
Zabriskie Point,2/9/1970,7000000,1000000,-6000000,26315.78947368421
Leaves of Grass,9/13/2009,9000000,985117,-8014883,4561.38149456635
Conversations with Other Women,6/7/2006,450000,973525,523525,4798.053228191227
Rampart,11/23/2011,12000000,972512,-11027488,4309.404799886561
The Beaver,2/11/2011,21000000,970816,-20029184,4386.699140116308
TEKKEN,3/20/2010,30000000,967000,-29033000,4435.596695549267
Sparrows,5/14/1926,463455,966878,503423,54318.988764044945
'N Beetje Verliefd,12/14/2006,800000,966214,166214,4787.978196233895
Гороскоп на удачу,7/16/2015,2800000,964206,-1835794,4045.913828698031
Pelle Svanslös,12/25/1981,48740,955401,906661,10131.50583244963
The Informer,5/9/1935,243000,950000,707000,68840.57971014493
Lookin' to Get Out,10/8/1982,17000000,946461,-16053539,9638.095723014256
Honky Tonk Freeway,8/21/1981,24000000,939423,-23060577,10079.64592274678
Simpatico,9/15/1999,10000000,929606,-9070394,5536.664681357951
Плюс один,8/21/2008,336029,927277,591248,4238.341187386589
La battaglia di Algeri,9/8/1966,800000,921548,121548,28181.89602446483
West of Zanzibar,11/24/1928,259000,921000,662000,53859.649122807015
Elles,9/9/2011,4000000,911466,-3088534,4017.233096359894
Battle in Seattle,9/7/2007,8000000,908847,-7091153,4359.187491006763
Go Go Tales,5/23/2007,4000000,907456,-3092544,4355.398556289357
بچه‌ها�?آسمان,8/1/1997,180000,900000,720000,5597.014925373134
Universal Soldier: Regeneration,10/1/2009,14000000,875386,-13124614,4049.394708965339
Carlos,5/19/2010,18000000,871279,-17128721,3997.3344344275456
Edge of Seventeen,5/14/1998,1500000,870751,-629249,5348.593366093366
Beastmaster 2: Through the Portal of Time,6/8/1991,6000000,869325,-5130675,6392.095588235294
W.E.,9/1/2011,15000000,868439,-14131561,3827.5941098951466
The Disappearance of Alice Creed,9/12/2009,800000,867714,67714,4017.7710689960136
Mirrormask,1/25/2005,4000000,866999,-3133001,4520.328467153285
The Castle,4/10/1997,786675,861789,75114,5379.456928838952
Tough Guys Don't Dance,9/18/1987,5000000,858250,-4141750,7443.625325238509
Black Rose,4/17/2014,7000000,855450,-6144550,3595.838587641866
Down in the Valley,5/13/2005,8000000,852872,-7147128,4387.201646090535
Brigham City,3/30/2001,1000000,852206,-147794,4817.444884115319
An Awfully Big Adventure,7/21/1995,4000000,851545,-3148455,5569.293655984303
Shelter,3/27/2010,22000000,851517,-21148483,3905.8800324757235
Atlas Shrugged Part III: Who is John Galt?,9/12/2014,5000000,846704,-4153296,3557.1165100344074
Sholem Aleichem: Laughing In The Darkness,2/24/2012,500000,845188,345188,3684.4702517960523
Higher Ground,8/26/2011,2000000,841733,-1158267,3709.8889765480035
Miranda,4/6/1948,784170,834332,50162,35055.96638655462
Narco,12/1/2004,823258,823258,0,4326.106148187073
Latter Days,7/10/2003,850000,819939,-30061,4458.6133768352365
Charly,9/23/1968,950000,814666,-135334,23078.356940509915
Tim,7/13/1979,600000,809000,209000,11067.031463748292
Zvezda,5/6/2002,1300000,809000,-491000,4499.443826473859
Bulletproof,4/20/1988,5000000,807947,-4192053,6876.144680851064
Le Moine,7/12/2011,11000000,807535,-10192465,3574.397358380326
Razorback,4/19/1984,5500000,801000,-4699000,7746.615087040618
Claire of the Moon,9/18/1992,130000,799674,669674,5639.449929478138
Little Monsters,8/25/1989,7000000,793775,-6206225,6350.2
Antichrist,5/18/2009,11000000,791867,-10208133,3671.268886797439
Anna Karenina,4/4/1997,35000000,791830,-34208170,4942.759051186018
The Boost,12/23/1988,8000000,784990,-7215010,6482.163501238646
Redacted,1/1/2007,5000000,782102,-4217898,3863.8348747134614
31,9/15/2016,1500000,779820,-720180,3230.0313136835825
Panic,12/1/2000,1000000,779137,-220863,4477.798850574713
Without Limits,9/11/1998,25000000,777423,-24222577,4751.974327628362
Princess Kaiulani,5/14/2010,9000000,771499,-8228501,3536.098965065222
The D Train,5/8/2015,447524,771317,323793,3243.485208469124
The Zero Theorem,1/2/2014,8500000,770706,-7729294,3294.7981326630074
Морфий,11/27/2008,3600000,766075,-2833925,3644.0198260935745
Fire and Ice,3/25/1983,1200000,760883,-439117,7716.866125760649
Enter the Void,5/5/2009,13000000,754249,-12245751,3526.9012793655543
The Time That Remains,8/12/2009,6500000,753808,-5746192,3492.5359303909486
Hobo with a Shotgun,5/6/2011,3000000,748453,-2251547,3312.2665557345417
Another Gay Movie,4/28/2006,500000,745327,245327,3680.627160493827
Life During Wartime,10/10/2009,4500000,744816,-3755184,3445.3989092271613
Party Monster,9/5/2003,5000000,742898,-4257102,4011.328293736501
Blitz,5/20/2011,15774948,741875,-15033073,3286.675645262757
Vampire's Kiss,9/17/1988,2000000,725131,-1274869,6032.703826955075
Zombadings 1: Patayin sa Shokot si Remington,8/31/2011,22361,721651,699290,3180.6345834306644
The Ballad of Jack and Rose,3/25/2005,1500000,712294,-787706,3660.298047276465
How About You...,11/16/2007,9000000,706000,-8294000,3361.3285341560495
Human Nature,5/18/2001,6000000,705308,-5294692,3962.4044943820227
The Unholy Three,9/16/1925,103000,704000,601000,39774.01129943503
Tangerine,7/10/2015,100000,702354,602354,2942.9802140337056
ഗോഡ്ഫാദർ,3/3/1991,18000,700000,682000,5185.185185185185
Tosun Paşa,1/1/1976,64200,698200,634000,12557.553956834532
Космос как предчувствие,6/23/2005,2000000,696681,-1303319,3565.4094165813713
Salton Sea,1/1/2002,18000000,676698,-17323302,3820.993788819876
Manderlay,5/16/2005,14200000,674918,-13525082,3470.0154241645246
Apartment Zero,9/30/1988,4000000,670774,-3329226,5580.482529118136
Bliss,10/4/1985,3400000,660537,-2739463,6076.697332106715
Flesh and the Devil,12/25/1926,373000,658000,285000,37600.0
Parkland,10/2/2013,10000000,653651,-9346349,2798.8105127041354
Inside Deep Throat,2/11/2005,2000000,653621,-1346379,3407.8258602711157
Metropolis,1/10/1927,92620000,650422,-91969578,37166.97142857143
تین بہادر,5/21/2015,143149,645135,501986,2703.4043195132376
Vượt Sóng,2/22/2006,1300000,639000,-661000,3198.198198198198
The Wild Bunch,6/17/1969,6244087,638641,-5605446,17354.375
Ride with the Devil,11/24/1999,38000000,635096,-37364904,3773.5947712418297
Strangeland,10/2/1998,1100000,631221,-468779,3848.9085365853657
The House of Yes,10/10/1997,1500000,626057,-873943,3874.1150990099013
Fiza,9/8/2000,1000000,623791,-376209,3591.197466896949
Sherrybaby,9/8/2006,2000000,622806,-1377194,3069.5219319862
Howl,8/26/2010,30000,617000,587000,2824.5871845229103
The Bronze,1/22/2016,3500000,615816,-2884184,2597.163353872237
Guinevere,9/4/1999,2600000,614202,-1985798,3658.141751042287
The Ledge,5/6/2011,10000000,610986,-9389014,2703.908587208582
Not Fade Away,12/21/2012,20000000,610792,-19389208,2652.3883967344104
Poison,4/5/1991,250000,609524,359524,4508.313609467456
Mean Creek,1/15/2004,500000,603943,103943,3261.0313174946004
The Signal,3/15/2014,4000000,600896,-3399104,2543.012277130512
Swept Away,10/11/2002,10000000,598645,-9401355,3301.958080529509
Across to Singapore,4/7/1928,290000,596000,306000,34853.80116959064
Tracers,1/15/2015,11000000,593683,-10406317,2540.2876251032276
Prefontaine,1/24/1997,8000000,589304,-7410696,3692.3809523809523
Powaqqatsi,4/29/1988,2500000,589244,-1910756,5014.842553191489
Freeheld,10/2/2015,7000000,573335,-6426665,2410.6114245831195
I Spit on Your Grave,6/17/2010,2000000,572809,-1427191,2627.4316433574454
Forever Fever,5/28/1998,1070000,570000,-500000,3496.9325153374234
The Hand,4/24/1981,6500000,566736,-5933264,6311.09131403118
Tideland,9/9/2005,12000000,566611,-11433389,2850.155935613682
The Virginity Hit,9/10/2010,2000000,563706,-1436294,2580.6106052490627
Bottle Rocket,2/21/1996,7000000,560069,-6439931,3597.103403982017
Le dernier souffle,3/25/1999,3800000,559298,-3240702,3365.210589651023
The Lazarus Project,10/21/2008,9750000,558000,-9192000,2626.809462163116
Bitter Harvest,2/23/2017,20000000,557241,-19442759,2285.638697134138
Los cronocrímenes,9/20/2007,2600000,553198,-2046802,2647.691159015201
"\"アキ�?\"\"Childhood friends Tetsuo and Kaneda are pulled into the post-apocalyptic underworld of Neo-Tokyo and forced to fight for their very survival. Kaneda is a bike gang leader\"",7/16/1988,8000000,553171,-7446829,4648.495798319328
Kaappari,1/17/2013,1800000,532269,-1267731,2292.6225200933814
Oorlogswinter,11/17/2008,4000000,530048,-3469952,2521.300683067907
Le Mépris,10/21/1963,900000,528428,-371572,17156.753246753247
Shikshanachya Aaicha Gho,1/15/2010,380000,520000,140000,2399.774790365827
Mishima: A Life in Four Chapters,5/15/1985,5000000,502758,-4497242,4685.535880708295
Cube,9/9/1997,250000,501818,251818,3113.014888337469
தீணா,1/14/2001,500000,500000,0,2855.5111364934323
Villan,12/5/2002,500000,500000,0,2763.957987838585
Citizen,6/8/2001,500000,500000,0,2808.9887640449438
Bikini Spring Break,6/26/2012,500000,500000,0,2182.414973112647
Amarkalam,8/25/1999,500000,500000,0,2977.9630732578917
Vaali,5/1/1999,500000,500000,0,3008.423586040915
காதல�?கோட்டை,7/12/1996,500000,500000,0,3184.7133757961783
முகவரி,2/2/2000,500000,500000,0,2944.6407538280328
Varalaru,10/20/2006,500000,500000,0,2481.3895781637716
Beyond the Mat,10/22/1999,2053648,500000,-1553648,2970.8853238265
Kandukondain Kandukondain,5/5/2000,500000,500000,0,2915.451895043732
Поводир,11/12/2014,722083,499168,-222915,2113.766191970392
The Ward,9/13/2010,10000000,498974,-9501026,2284.2715815399265
Idiocracy,9/1/2006,30000000,495303,-29504697,2441.118777723016
Tape,1/26/2001,100000,490475,390475,2789.960182025028
Poslednyaya skazka Rity,11/1/2012,200000,486937,286937,2115.085070432324
Meet the Applegates,2/1/1991,5000000,485772,-4514228,3603.649851632047
Weekend,9/22/2011,8000,484592,476592,2140.2255091179704
DOA: Dead or Alive,9/7/2006,21000000,480314,-20519686,2367.2449482503694
Attack of the 50 Foot Woman,5/19/1958,88000,480000,392000,16608.996539792388
Party Girl,6/9/1995,150000,472370,322370,3097.5081967213114
On the Job,5/23/2013,1052753,466088,-586665,1996.0600246676718
Blue Car,1/11/2002,1000000,464000,-536000,2619.988706945229
Foolproof,10/3/2003,8256269,460978,-7795291,2491.772972972973
The Myth Of Fingerprints,9/17/1997,2000000,458815,-1541185,2839.2017326732675
Brooklyn Rules,4/30/2007,8000000,458232,-7541768,2203.5787621003224
The Extra Man,8/1/2010,7000000,453079,-6546921,2075.3737769797353
Ken Park,8/31/2002,1300000,447741,-852259,2473.707182320442
Jagal,8/31/2012,1000000,444575,-555425,1921.1821595716638
Upstream Color,4/5/2013,100000,444098,344098,1909.8442788273392
3 Generations,2/11/2016,5000000,443962,-4556038,1872.380446288869
Song to Song,3/17/2017,10000000,443684,-9556316,1814.4803782041845
Sphinx,2/11/1981,14000000,439564,-13560436,5000.728100113765
Lieksa!,9/14/2007,1400000,435000,-965000,2086.4310038850786
Dark Tide,3/28/2012,25000000,432274,-24567726,1878.7578503596496
Manny & Lo,1/22/1996,500000,431326,-68674,2784.5448676565525
Body Snatchers,6/9/1993,13000000,428868,-12571132,2970.0
Fido,9/7/2006,8000000,426224,-7573776,2100.6604238541154
Primer,10/8/2004,7000,424760,417760,2225.039287585123
Shadow Dancer,2/12/2012,6300000,419953,-5880047,1844.6256089043893
Killing Zoe,10/1/1993,1500000,418961,-1081039,2875.5044612216884
The Believer,1/19/2001,1500000,416925,-1083075,2371.5870307167233
Tiny Furniture,11/12/2010,65000,416498,351498,1903.5296590997382
The Death and Life of Bobby Z,7/23/2007,22000000,413454,-21586546,1988.553124564129
Jude,2/6/1996,7000000,405000,-6595000,2614.5900581020014
Я остаюсь,4/19/2007,1000000,404785,-595215,1946.5590120654583
Foolish Wives,1/11/1922,1100000,400200,-699800,23680.473372781067
A Girl Walks Home Alone at Night,1/19/2014,1000000,395000,-605000,1682.4189350927034
Шапито-шоу,12/12/2011,2000000,393816,-1606184,1745.081357013719
While She Was Out,10/27/2008,6000000,391410,-5608590,1842.579734023773
Subway,4/10/1985,2000000,390659,-1609341,3654.434050514499
Search and Destroy,1/1/1995,4000000,389503,-3610497,2591.5036593479704
Hesher,1/22/2010,7000000,382946,-6617054,1766.8369159503739
The Informers,11/5/2008,18000000,382174,-17617826,1799.1008591267505
The Quiet,9/12/2005,900000,381420,-518580,1918.6116700201205
Smashed,9/12/2012,500000,376597,-123403,1627.4226795213626
Southland Tales,5/15/2006,17000000,374743,-16625257,1850.5827160493827
Session 9,8/10/2001,1500000,373967,-1126033,2106.856338028169
Abre los ojos,12/19/1997,2900000,368234,-2531766,2278.6757425742576
She Hate Me,7/30/2004,8000000,365134,-7634866,1926.8284960422163
Dracula: Prince of Darkness,1/9/1966,280379,364937,84558,11476.006289308176
Killer of Sheep,11/14/1978,100000,362222,262222,5374.213649851632
Ladri di biciclette,11/24/1948,133000,361712,228712,15008.796680497924
Revolution,12/25/1985,28000000,358574,-27641426,3271.660583941606
Another Happy Day,11/18/2011,4000000,355688,-3644312,1576.1281860399163
Prison,3/4/1988,1300000,354704,-945296,3044.6695278969955
Like Dandelion Dust,2/5/2009,2500000,352810,-2147190,1662.6844429363832
The Face of Love,10/25/2013,4000000,350006,-3649994,1501.7269563948873
Meet Bill,9/7/2007,5000000,346592,-4653408,1662.3914816058323
Bacalaureat,5/20/2016,2000000,343617,-1656383,1425.6901974126413
Антикиллер,8/1/2002,5000000,340312,-4659688,1883.2982844493638
Swoon,9/11/1992,250000,340147,90147,2407.2682236376504
Nobel Son,4/28/2007,4000000,333912,-3666088,1605.7398689101653
Waking the Dead,3/23/2000,8500000,327418,-8172582,1911.3718622300057
Super,9/9/2010,2500000,324138,-2175862,1483.8833724746955
Adore,4/3/2013,16000000,318982,-15681018,1371.7826870395775
The Yellow Handkerchief,12/17/2008,15000000,317000,-14683000,1501.3521641730958
Rapa Nui,9/9/1994,20000000,305070,-19694930,2041.9678714859438
In the Land of Blood and Honey,12/23/2011,10000000,303877,-9696123,1340.6436812035383
Shooting Fish,8/22/1997,3000000,302204,-2697796,1874.7146401985112
Орлеан,9/17/2015,2500000,302000,-2198000,1269.7718615191854
The Angrez,6/2/2006,50000,300000,250000,1478.5608674223756
Ten Canoes,6/29/2006,2000000,300000,-1700000,1474.2014742014742
Dingo,6/2/1991,200000,300000,100000,2205.8823529411766
Love's Labour's Lost,3/31/2000,13000000,299792,-12700208,1750.0992410974898
Black Dynamite,10/16/2009,2900000,296557,-2603443,1370.8547127074376
World's Greatest Dad,8/20/2009,10000000,295750,-9704250,1369.4094985854451
Wet Hot American Summer,7/27/2001,5000000,295206,-4704794,1663.132394366197
Mickey,5/2/2004,6000000,293793,-5706207,1553.6382866208355
Ma vie de courgette,10/12/2016,8000000,292279,-7707721,1209.1184756483499
Mala noćna muzika,1/1/2002,200000,286000,86000,1614.9068322981368
Aquarius,9/1/2016,762241,285930,-476311,1184.328246930762
L'avenir,3/16/2016,2100000,282382,-1817618,1180.2257785430972
Fehér Isten,6/12/2014,2200000,282358,-1917642,1184.670831532707
JCVD,6/4/2008,6000000,276891,-5723109,1265.4114206064485
Taxi to the Dark Side,4/30/2007,1000000,274661,-725339,1320.8094292350527
Нирвана,7/3/2008,2000000,273137,-1726863,1241.7350111836483
七人の侍,4/26/1954,2000000,271841,-1728159,10105.613382899628
ആമേൻ,3/21/2013,110000,270000,160000,1161.1355045133766
Life of Crime,9/14/2013,12000000,265452,-11734548,1133.688377913209
The TV Set,4/28/2006,2000000,265198,-1734802,1309.6197530864197
Under Suspicion,9/24/2000,25000000,260562,-24739438,1497.4827586206898
Closet Land,3/6/1991,4000000,259012,-3740988,1918.6074074074074
Walker,12/4/1987,5800000,257043,-5542957,2227.409012131716
The Music Never Stopped,3/18/2011,4000000,253899,-3746101,1128.9116341938409
Batalla en el cielo,5/15/2005,1601792,253527,-1348265,1304.1512345679012
Tanu Weds Manu,3/25/2011,400000,252000,-148000,1120.4681066756777
Dominion: Prequel to the Exorcist,5/20/2005,30000000,251495,-29748505,1293.0334190231363
Camilla,11/25/1994,8500000,250993,-8249007,1676.6399465597863
Mustang,6/17/2015,1300000,250000,-1050000,1047.5416293043486
The Fast and the Furious,2/15/1955,66000,250000,184000,9363.295880149813
The Signal,2/22/2007,50000,249905,199905,1216.9591725427558
Love,7/6/2015,3000000,249083,-2750917,1043.6992466080603
The Foot Fist Way,6/24/2006,79000,245000,166000,1203.931203931204
Four Eyed Monsters,1/21/2005,250000,245000,-5000,1277.3722627737225
Braindead,8/13/1992,3000000,242623,-2757377,1721.9517388218594
The Ottoman Lieutenant,3/10/2017,40000000,240978,-39759022,988.4208842457579
幸福时光,12/31/2000,1900000,240093,-1659907,1371.1764705882354
King Solomon's Mines,3/20/1985,12500000,238227,-12261773,2228.5032740879324
Big Fan,1/18/2009,250000,232732,-17268,1096.7939564453116
Jimmy Vestvood: Amerikan Hero,3/13/2016,2500000,230069,-2269931,966.1406278870542
A Place Called Chiapas,2/20/1998,891000,229000,-662000,1411.8372379778052
Life in a Day,1/27/2011,45202,225861,180659,1020.5685263590726
Hard Eight,2/28/1996,3000000,222559,-2777441,1429.4091201027618
Boy Culture,1/31/2007,500000,220151,-279849,1081.8284119332282
Dead & Buried,5/29/1981,3000000,216166,-2783834,2385.938189845475
Bizim Aile,9/7/1975,65700,214600,148900,3930.4029304029305
Bopha!,9/16/1993,12000000,212483,-11787517,1458.359643102265
The Awakening,8/17/2011,4798235,209696,-4588539,924.2228578732331
Levity,3/16/2003,7500000,209151,-7290849,1137.9270946681174
Dark Places,3/31/2015,20000000,208588,-19791412,881.6098123829771
Der Räuber,2/14/2010,3900000,208475,-3691525,961.8623149288782
Tamara,5/12/2005,4750000,206871,-4543129,1064.1512345679012
Onegin,12/22/1999,14000000,206128,-13793872,1221.1374407582937
Frankenhooker,6/1/1990,2500000,205068,-2294932,1578.6605080831407
Henry's Crime,1/14/2010,12000000,204940,-11795060,945.7881644953319
17 filles,6/13/2011,4141459,201607,-3939852,893.1650437263536
White Girl,9/2/2016,700000,200242,-499758,829.4066968205842
The Indian Runner,5/19/1991,7000000,191125,-6808875,1405.3308823529412
Waste Land,1/24/2010,1500000,187716,-1312284,866.0844048887842
Stonewall,9/18/2015,13500000,187674,-13312326,789.0833256250053
Maggie,5/8/2015,4000000,187112,-3812888,786.8295452156178
Nothing But the Truth,12/19/2008,11500000,186702,-11313298,884.244327304244
Texas Chainsaw Massacre: The Next Generation,1/1/1994,600000,185898,-414102,1271.532147742818
Bande à part,8/5/1964,120000,182857,62857,5898.612903225807
Кавказская пленница!,8/21/2014,3500000,179000,-3321000,752.0028903798244
Canadian Bacon,6/8/1995,11000000,178104,-10821896,1167.8950819672132
The Heart is Deceitful Above All Things,9/15/2004,74050,176153,102103,927.6092680358083
The Afflicted,10/22/2011,180000,175742,-4258,776.8288909516864
Stateside,5/23/2004,16000000,174318,-15825682,918.9140748550343
My Name Is Bruce,10/1/2007,1500000,173066,-1326934,828.320634069763
Kill List,9/2/2011,500000,171760,-328240,757.0221562085425
ಲೂಸಿಯಾ,10/19/2013,79000,170000,91000,729.397732002111
Death of a President,10/27/2006,2000000,167000,-1833000,828.7841191066998
Kidulthood,3/3/2006,994000,165000,-829000,825.8258258258257
Country of My Skull,5/4/2004,12000000,163536,-11836464,864.8122686409307
Restless,9/16/2011,8000000,163265,-7836735,721.0682754691481
Down,5/11/2001,15000000,163169,-14836831,918.2273494653912
Louder Than Bombs,5/18/2015,11000000,161789,-10838211,677.968303455443
Gemma Bovery,9/10/2014,9700000,154701,-9545299,649.9195482941298
Citizen Ruth,12/13/1996,3000000,153155,-2846845,965.6683480453972
Pushing Hands,2/1/1992,400000,152322,-247678,1099.004329004329
Samba,10/15/2014,20000000,151530,-19848470,638.2010925187316
May,1/13/2002,500000,150277,-349723,848.5431959345003
Rane,5/27/1998,10000,150000,140000,920.2453987730062
Los lunes al sol,9/27/2002,4000000,146402,-3853598,807.5124103695532
Dahmer,6/21/2002,250000,144008,-105992,799.600222098834
10th & Wolf,2/19/2006,8000000,143451,-7856549,717.9729729729729
Manglehorn,6/3/2015,4000000,143101,-3856899,599.6572213981009
Man-Thing,4/21/2005,7500000,143000,-7357000,735.59670781893
Theeviravaathi: The Terrorist,9/12/1998,24554,140021,115467,855.8740831295844
The Cheat,12/13/1915,17311,137365,120054,13336.40776699029
Cameron's Closet,12/2/1988,7000000,136203,-6863797,1130.3153526970955
Momentum,8/1/2015,20000000,133332,-19866668,559.4756541734504
"\"一個人的武�?\"\"A martial arts instructor working at a police academy gets imprisoned after killing a man by accident. But when a vicious killer starts targeting martial arts masters\"",10/31/2014,25000000,129115,-24870885,546.7476318118491
Gaby: A True Story,10/30/1987,5000000,125400,-4874600,1086.6551126516465
Six-String Samurai,9/18/1998,2000000,124494,-1875506,759.109756097561
The Romantics,9/10/2010,4500000,123820,-4376180,566.8401704823773
There Goes My Baby,9/2/1994,10500000,123509,-10376491,826.7001338688085
Afflicted,4/4/2014,318000,121179,-196821,511.14851184450293
It's All Gone Pete Tong,9/12/2004,2000000,120620,-1879380,635.1764086361243
Trust,9/10/2010,9500000,120000,-9380000,549.3524507986211
The Big Picture,9/15/1989,5000000,117463,-4882537,939.704
הסיפור של יוסי,5/16/2012,500000,116207,-383793,506.3971273934756
Camille Claudel 1915,3/13/2013,3512454,115860,-3396594,497.738139732701
Camille Claudel 1915,3/13/2013,3512454,115860,-3396594,497.738139732701
Winter Passing,2/7/2006,3500000,113783,-3386217,572.637141419225
Tetro,6/11/2009,15000000,113221,-14886779,524.9173593950661
Saint John of Las Vegas,6/10/2009,3800000,111731,-3688269,518.009392979837
Burn,11/1/2012,225000,111300,-113700,483.4485125162344
Bamako,6/21/2006,2000000,111000,-1889000,545.4545454545455
The Weight of Water,9/25/2000,16000000,109130,-15890870,627.183908045977
辛亥革命,7/3/2011,30000000,108348,-29891652,479.5814484645143
Sleep Dealer,12/10/2008,2500000,107559,-2392441,511.63023003596095
Not of This Earth,5/20/1988,210000,107352,-102648,909.7627118644068
Aferim!,1/22/2015,1379375,105097,-1274278,447.75095645060964
Freakonomics,10/1/2010,3000000,103735,-2896265,474.3017040752408
Córki dancingu,12/25/2015,1300000,101657,-1198343,429.08457005858617
Bellflower,4/16/2011,17000,101236,84236,448.0182683967358
Wuthering Heights,9/5/2011,8000000,100915,-7899085,444.77696142166434
Precious Cargo,7/15/2016,10500000,100659,-10399341,418.3179014910983
Une Femme est une femme,9/6/1961,160000,100655,-59345,3355.1666666666665
Roadgames,6/26/1981,1750000,100000,-1650000,1091.703056768559
Rubber,7/9/2010,500000,98017,-401983,449.5965799890831
羅生門,12/26/1950,250000,96568,-153432,3801.8897637795276
Twelve and Holding,9/11/2005,400000,95687,-304313,481.3229376257545
Stitches,5/19/2012,100000,95000,-5000,413.9830397685181
The Night Flier,4/30/1997,1000000,91549,-908451,571.8238600874454
Byzantium,9/9/2012,10000000,89237,-9910763,385.62791963942317
Life After Beth,8/15/2014,2400000,88273,-2311727,371.12574205808653
Sunshine Superman,5/22/2015,400000,88097,-311903,369.16584952941275
Mozart and the Whale,9/10/2005,12000000,84967,-11915033,427.3993963782696
Peeping Tom,4/6/1960,150000,83957,-66043,2846.0
A Street Cat Named Bob,11/4/2016,8000000,82703,-7917297,342.66406466876316
The Treatment,4/8/2006,900000,82701,-817299,410.4267990074442
The Innkeepers,12/1/2011,750000,78396,-671604,347.3891311283633
Silent Trigger,6/26/1996,15000000,76382,-14923618,486.50955414012736
Better Living Through Chemistry,3/14/2014,5000000,75143,-4924857,318.00772769400703
No One Lives,3/9/2013,2900000,74918,-2825082,321.85004274550744
Foodfight!,6/15/2012,65000000,73706,-64926294,321.18983083345677
Eye of the Dolphin,8/24/2007,2500000,71904,-2428096,344.8798503525349
A Troll in Central Park,10/7/1994,23000000,71368,-22928632,477.3779264214047
Assassination of a High School President,1/17/2008,11500000,69564,-11430436,328.6079369653224
Deadfall,11/8/2012,12000000,66351,-11933649,288.2056806286134
All About Eve,11/9/1950,1400000,63463,-1336537,2569.3522267206476
The Mudge Boy,1/17/2003,800000,62852,-737148,343.2659748771163
Hallam Foe,2/16/2007,8000000,60641,-7939359,295.30269975456775
Camp X-Ray,10/17/2014,1000000,59744,-940256,252.99067122307335
Walk of Shame,5/2/2014,15000000,59209,-14940791,248.88188314417823
Aftershock,9/12/2012,2000000,58510,-1941490,252.84455526410176
Dom durakov,12/6/2002,2500000,57862,-2442138,319.8562741846324
The Canyons,7/29/2013,250000,56825,-193175,242.96959512906355
Beautiful,4/27/2009,1500000,56000,-1444000,261.85844680532693
Dirty Girl,9/12/2010,4000000,55125,-3944875,252.35878208561658
Inhale,8/27/2010,10000000,55089,-9944911,252.193976350377
La terza madre,9/6/2007,3500000,54947,-3445053,263.54741234591586
Return of the Living Dead 3,10/1/1993,2000000,54207,-1945793,372.04529855868225
Aloft,2/12/2014,8000000,53086,-7946914,226.10858629957278
Hatchet II,8/26/2010,2500000,52604,-2447396,240.81780268175555
Curdled,9/6/1996,2300000,49620,-2250380,314.4486692015209
Following,9/12/1998,6000,48482,42482,296.3447432762836
Decoding Annie Parker,5/2/2014,2000000,48390,-1951610,203.4047919293821
Viva la libertà,2/13/2013,5000000,48125,-4951875,207.28702738557757
Mal de pierres,10/19/2016,10300000,47748,-10252252,197.83470684018843
Margaret,9/30/2011,14000000,46495,-13953505,205.3475605177965
Ca$h,1/1/2010,7000000,46488,-6953512,214.53986625870493
December Boys,9/20/2007,4000000,46474,-3953526,222.43174943523374
Lost River,4/8/2015,2000000,45431,-1954569,192.01687242972287
Opposite Sex,11/8/2014,3300000,45000,-3255000,190.55604253210868
La mariée était en noir,3/22/1968,747000,44566,-702434,1295.5232558139535
Defendor,9/12/2009,3500000,44462,-3455538,205.87213905699429
Jackpot,7/26/2001,400000,43719,-356281,246.30422535211267
Zaytoun,10/14/2012,8000000,42330,-7957670,182.99562937440828
CBGB,10/11/2013,5000000,40400,-4959600,172.98519349507163
Der rote Baron,3/29/2008,18000000,40239,-17959761,187.312345512352
Mr. Right,2/29/2016,8000000,34694,-7965306,145.69230510809132
Bwakaw,9/5/2012,11178,34659,23481,149.7750716270467
Cowboys & Angels,5/14/2003,2000000,33700,-1966300,183.65122615803816
Stake Land,9/30/2010,650000,33245,-616755,152.00424304218808
Local Color,9/19/2006,3250000,32788,-3217212,162.4777006937562
Song One,1/20/2014,6000000,32251,-5967749,137.36631158398677
Pontypool,3/6/2009,1500000,32000,-1468000,150.4402728610449
Meet Monica Velour,6/4/2010,5000000,31649,-4968351,145.20221136420986
The Tracey Fragments,2/8/2007,700000,31576,-668424,155.16538164806707
Maniac,12/26/2012,6000000,31081,-5968919,134.97047073128365
L!fe Happens,6/18/2011,930000,30905,-899095,136.79500004426308
Valhalla Rising,9/4/2009,5641880,30638,-5611242,141.86295255337572
The Boondock Saints,1/22/1999,6000000,30471,-5969529,185.2340425531915
Jimmy P.,9/11/2013,10000000,30283,-9969717,129.33217737423607
Road to Nowhere,4/13/2011,5000000,27046,-4972954,120.25468417916818
La Tête haute,5/13/2015,5000000,26144,-4973856,109.9388154159921
Highway to Hell,11/21/1991,9000000,26055,-8973945,188.94126178390138
Hood of Horror,6/27/2006,5000000,25900,-4974100,127.27272727272727
Lost in the Sun,11/5/2015,25000,25000,0,105.33589510230222
Captive,9/5/2012,11180,24591,13411,106.26731257049268
Vivre sa vie: film en douze tableaux,9/20/1962,64000,24517,-39483,806.4802631578948
Paradies: Liebe,4/27/2012,3600000,24267,-3575733,105.59362965863848
Behind the Burly Q,4/23/2010,250000,23859,-226141,109.35566372411517
All The Queen's Men,10/14/2001,15000000,23000,-14977000,129.43162633652224
The Divide,3/13/2011,3000000,22000,-2978000,98.44854050038708
Term Life,4/29/2016,16500000,21256,-16478744,88.48223986279757
The Good Night,1/25/2007,15000000,20380,-14979620,100.1479122747532
City Lights,1/30/1931,1500000,19181,-1480819,1221.71974522293
Itty Bitty Titty Committee,2/9/2007,1000000,18479,-981521,90.80634302871267
Venuto al mondo,9/13/2012,13000000,18295,-12981705,79.05983829356934
Women in Trouble,11/13/2009,3000000,18097,-2981903,83.65460176582073
5 Days of War,4/14/2011,20000000,17479,-19982521,77.71691284358799
Strangerland,7/1/2015,10000000,17472,-9982528,73.21058938882231
Cruel World,9/1/2005,2000000,16344,-1983656,82.2132796780684
Quiet City,3/12/2007,2500,15425,12925,75.1149246172426
Barefoot,2/2/2014,6000000,15071,-5984929,64.19173612856235
Vulgar,9/13/2000,120000,14904,-105096,85.80310880829016
Major Dundee,4/7/1965,3800000,14873,-3785127,473.66242038216564
Cherry 2000,11/12/1987,10000000,14000,-9986000,121.31715771230502
13 Sins,4/18/2014,5000000,13809,-4986191,58.04539722572509
Naqoyqatsi,9/2/2002,3000000,13308,-2986692,73.52486187845304
Standing Still,1/2/2005,1700000,12762,-1687238,66.92186680650236
Laurence Anyways,5/18/2012,9500000,12250,-9487750,53.382023549098385
Waltzing Anna,8/11/2006,1000000,11455,-988545,56.17949975478175
Peter and Vandy,1/1/2009,500000,11276,-488724,53.40456467891429
Forces spéciales,11/2/2011,10000000,10759,-9989241,47.55779516421342
Naturally Native,10/8/1999,700000,10508,-689492,62.47324613555292
Logan,9/10/2010,135000,10474,-124526,47.949313080539646
Squeeze,6/6/1997,500000,10300,-489700,64.25452276980661
Chaos,1/17/2005,20000000,10289,-19989711,53.644421272158496
Alone With Her,4/28/2006,1000000,10018,-989982,49.471604938271604
Down Terrace,9/1/2009,31192,10000,-21192,46.302941625881495
Welcome to the Punch,3/15/2013,8500000,9747,-8490253,41.8734131535874
Honeymoon,9/12/2014,1000000,9318,-990682,39.14616163440896
The Sacrament,9/2/2013,4000000,9221,-3990779,39.38090702928477
Fishtales,8/24/2007,14000000,9216,-13990784,44.203558923689386
Janky Promoters,10/16/2009,10000000,9069,-9990931,41.92206351407572
Stolen Lives,10/10/2009,2000000,7306,-1992694,33.79637981838956
Idioterne,4/28/1998,2500000,7235,-2492765,44.44103194103194
Special,1/30/2006,1000000,7202,-992798,36.245596376446905
The Adventurer: The Curse of the Midas Box,12/5/2013,25000000,6399,-24993601,27.45774493775987
Sweetwater,1/24/2013,7000000,6147,-6993853,26.476745087566655
Nasty Old People,10/10/2009,15000,5300,-9700,24.51694676121882
Xue di zi,12/20/2012,15000000,5290,-14994710,22.972034045509815
The Amazing Truth About Queen Raquela,3/7/2008,400000,5255,-394745,24.610355550560115
The Good Doctor,1/1/2011,6000000,5206,-5994794,23.63967433011084
The Duel,6/24/2016,10000000,4500,-9995500,18.70106554515684
Aftermath,4/6/2017,10500000,3451,-10496549,14.113134089087369
Nuit Blanche,11/14/2011,2500000,3358,-2496642,14.84330106528754
Eegah,6/8/1962,15000,3274,-11726,108.41059602649007
ATM,2/17/2012,3000000,3010,-2996990,13.121643300551023
About Cherry,2/14/2012,2500000,3003,-2496997,13.190549188932764
Philadelphia Experiment II,11/12/1993,5000000,2970,-4997030,20.37037037037037
The Samaritan,3/2/2012,12000000,2521,-11997479,10.989921182953198
Best Man Down,10/20/2012,1500000,1938,-1498062,8.417998358099391
The House of Usher,9/11/2007,130000,1677,-128323,8.043551249460405
Running Time,12/18/1997,130000,1596,-128404,9.876237623762377
Poor White Trash,6/16/2000,1200000,1404,-1198596,8.125
Star of Midnight,4/19/1935,280,831,551,60.21739130434782
The Mysterious Lady,8/4/1928,337,551,214,32.22222222222222
A Perfect Man,11/1/2013,5000000,388,-4999612,1.6647430589224652
Sunday,8/27/1997,450,288,-162,1.7866004962779158
Falling From Grace,2/21/1992,3,232,229,1.6654702081837758
I Married a Strange Person!,8/28/1998,250,203,-47,1.2408312958435208
Šišanje,10/6/2010,500000,198,-499802,0.9053042599594898
The Cherry Orchard,1/1/1999,5,135,130,0.8216676810712111
वांटेड,9/18/2009,75,134,59,0.6198624275477965
Make Your Move,8/7/2013,15,122,107,0.5216417176550067
Rugrats in Paris: The Movie,9/14/2000,30,103,73,0.5929763960852044
Lost & Found,4/23/1999,1,100,99,0.601684717208183
Die Angst des Tormanns beim Elfmeter,2/19/1972,410000,100,-409900,2.4154589371980677
Every Which Way But Loose,12/19/1978,5,85,80,1.2445095168374818
The Immortals,10/5/1995,50,83,33,0.5400130123617437
The End of Poverty?,5/19/2008,1000000,57,-999943,0.26049402463268057
"\"검사외�?\"\"After a prosecution lawyer is framed and convicted for murder\"",2/3/2016,500,50,-450,0.21087170143941025
Death at a Funeral,2/9/2007,9000000,46,-8999954,0.22604533683212202
Boy,2/14/2010,3,43,40,0.19839347423883805
Assisted Living,2/2/2005,500,41,-459,0.21376433785192908
Zyzzyx Road,2/25/2006,2000000,30,-1999970,0.15015015015015015
Madonna: Truth or Dare,5/10/1991,4,29,25,0.21386430678466078
A Farewell to Arms,12/8/1932,4,25,21,1.9083969465648856
A Farewell to Arms,12/8/1932,4,25,21,1.9083969465648856
In the Cut,9/9/2003,12000000,23,-11999977,0.12419006479481642
Starter for 10,9/13/2006,8,21,13,0.10349926071956629
Deadfall,10/8/1993,10000000,18,-9999982,0.12354152367879205
The Prophecy,9/1/1995,8,16,8,0.10443864229765014
William & Kate,4/18/2011,20,15,-5,0.06638225558053495
The 51st State,12/7/2001,28,14,-14,0.07923033389926429
Angela's Ashes,12/25/1999,25,13,-12,0.07701421800947866
The Cookout,9/3/2004,16000000,12,-15999988,0.0631911532385466
Chasing Liberty,1/9/2004,23000000,12,-22999988,0.06479481641468683
Hross í oss,8/30/2013,10,11,1,0.04697863326343482
F.I.S.T.,4/26/1978,11,11,0,0.17054263565891473
Bodyguard,8/31/2011,130,8,-122,0.03525953219415661
Pollock,9/6/2000,6,8,2,0.04605641911341393
Dreaming of Joseph Lees,10/29/1999,2000000,7,-1999993,0.041592394533571005
Bran Nue Dae,8/9/2009,7,7,0,0.032432332255344386
Never Talk to Strangers,10/20/1995,6400000,6,-6399994,0.0390625
Ladrón que roba a ladrón,8/31/2007,4002313,6,-4002307,0.028778358674276944
Split Second,5/1/1992,7,5,-2,0.03579098067287044
East of Eden,3/9/1955,1,5,4,0.18726591760299627
Miami Rhapsody,1/27/1995,6,5,-1,0.03313452617627568
Raja Natwarlal,8/29/2014,5,4,-1,0.016804533863236302
예의없는 것들,8/24/2006,3,4,1,0.019714144898965006
American Adobo,9/29/2001,344,4,-340,0.022509848058525607
Man Trouble,7/17/1992,30,4,-26,0.028388928317955996
Desmundo,11/8/2002,3,3,0,0.01654715940430226
Duniyadari,7/19/2014,390000,3,-389997,0.012612885323646638
Saamy,5/5/2003,1,3,2,0.01634877384196185
Все и сразу,6/5/2014,750000,3,-749997,0.012586902069706264
Dr. Horrible's Sing-Along Blog,7/15/2008,200000,3,-199997,0.013638595406521067
Tere Naam,8/15/2003,1,2,1,0.010834236186348862
The Letters,12/4/2015,1,1,0,0.004227882887644012
The Wind in the Willows,10/16/1996,12,1,-11,0.006305170239596469
Mute Witness,9/28/1995,2,1,-1,0.0065061808718282375
The Merry Widow,8/26/1925,592,1,-591,0.05649717514124294
Avatar,12/10/2009,237000000,"","",""
