Less Than Zero,11/6/1987,1,12396383,12396382,1.2396383E7
Modern Times,2/5/1936,1,8500000,8499999,8500000.0
Aquí Entre Nos,3/30/2012,1,2755584,2755583,2755584.0
Nurse 3-D,9/28/2013,10,10000000,9999990,1000000.0
From Prada to Nada,1/28/2011,93,2500000,2499907,26881.720430107525
Paranormal Activity,9/14/2007,15000,193355800,193340800,12890.386666666667
Tarnation,10/19/2003,218,1162014,1161796,5330.339449541284
The Blair Witch Project,7/14/1999,60000,248000000,247940000,4133.333333333333
"\"대�?\"\"While the Kingdom of Korea is under occupation by the Japanese\"",12/16/2015,5000,11083449,11078449,2216.6898
Eraserhead,3/19/1977,10000,7000000,6990000,700.0
猛龍過江,6/1/1972,130000,85000000,84870000,653.8461538461538
Pink Flamingos,3/12/1972,12000,6000000,5988000,500.0
Super Size Me,1/17/2004,65000,28575078,28510078,439.6165846153846
The Gallows,7/10/2015,100000,42664410,42564410,426.6441
Open Water,8/6/2004,130000,54667954,54537954,420.52272307692306
The Texas Chain Saw Massacre,10/1/1974,85000,30859000,30774000,363.0470588235294
Bambi,8/14/1942,858000,267447150,266589150,311.709965034965
Night of the Living Dead,10/1/1968,114000,30000000,29886000,263.1578947368421
Mad Max,4/12/1979,400000,100000000,99600000,250.0
Halloween,10/25/1978,300000,70000000,69700000,233.33333333333334
The Legend of Boggy Creek,8/1/1972,100000,22000000,21900000,220.0
Alice in Wonderland,7/3/1951,3000000,572000000,569000000,190.66666666666666
Joe,7/15/1970,106000,19319254,19213254,182.25711320754718
American Graffiti,8/1/1973,777000,140000000,139223000,180.18018018018017
Let's Do It Again,10/11/1975,70000,11800000,11730000,168.57142857142858
Blood Feast,6/6/1963,24500,4000000,3975500,163.26530612244898
A Ghost Story,7/7/2017,100000,15584255,15484255,155.84255
Once,3/23/2007,160000,20710513,20550513,129.44070625
Snow White and the Seven Dwarfs,12/20/1937,1488423,184925486,183437063,124.24256142239135
Rocky,11/21/1976,1000000,117235147,116235147,117.235147
Clerks,9/13/1994,27000,3151130,3124130,116.70851851851852
Napoleon Dynamite,6/11/2004,400000,46118097,45718097,115.2952425
The Birth of a Nation,2/8/1915,100000,11000000,10900000,110.0
Keeping Mum,12/2/2005,169000,18564702,18395702,109.8503076923077
The Hills Have Eyes,7/22/1977,230000,25000000,24770000,108.69565217391305
Friday the 13th,5/9/1980,550000,59754601,59204601,108.6447290909091
Enter the Dragon,8/17/1973,850000,90000000,89150000,105.88235294117646
Facing the Giants,9/29/2006,100000,10178331,10078331,101.78331
The Devil Inside,1/6/2012,1000000,101758490,100758490,101.75849
Catfish,9/17/2010,30000,3045943,3015943,101.53143333333334
Sweet Sweetback's Baadasssss Song,4/23/1971,150000,15200000,15050000,101.33333333333333
Gone with the Wind,12/15/1939,4000000,400176459,396176459,100.04411475
Lost & Found,4/23/1999,1,100,99,100.0
The Born Losers,8/18/1967,360000,36000000,35640000,100.0
人再囧途之泰囧,12/12/2012,2200000,208000000,205800000,94.54545454545455
The Rocky Horror Picture Show,8/14/1975,1200000,112892319,111692319,94.0769325
Cinderella,3/4/1950,2900000,263591415,260691415,90.89359137931035
The Big Parade,11/5/1925,245000,22000000,21755000,89.79591836734694
The Quiet Ones,4/1/2014,200000,17834867,17634867,89.174335
Saw,10/1/2004,1200000,103911669,102711669,86.5930575
Dawn of the Dead,9/2/1978,650000,55000000,54350000,84.61538461538461
The Evil Dead,10/15/1981,350000,29400000,29050000,84.0
Vixen!,10/15/1968,76000,6000000,5924000,78.94736842105263
Falling From Grace,2/21/1992,3,232,229,77.33333333333333
E.T. the Extra-Terrestrial,4/3/1982,10500000,792965326,782465326,75.52050723809523
My Big Fat Greek Wedding,2/22/2002,5000000,368744044,363744044,73.7488088
The Full Monty,8/13/1997,3500000,257850122,254350122,73.67146342857143
Per un pugno di dollari,9/12/1964,200000,14500000,14300000,72.5
Star Wars,5/25/1977,11000000,775398007,764398007,70.49072790909091
Saturday Night Fever,12/16/1977,3500000,237113184,233613184,67.746624
Jaws,6/18/1975,7000000,470654000,463654000,67.23628571428571
Fireproof,9/26/2008,500000,33456317,32956317,66.912634
Crocodile Dundee,9/26/1986,5000000,328203506,323203506,65.6407012
Insidious,9/13/2010,1500000,97009150,95509150,64.67276666666666
Unfriended,4/17/2015,1000000,62882090,61882090,62.88209
Dr. No,10/4/1962,950000,59600000,58650000,62.73684210526316
Robot Monster,6/25/1953,16000,1000000,984000,62.5
Love Story,12/16/1970,2200000,136400000,134200000,62.0
Primer,10/8/2004,7000,424760,417760,60.68
Weekend,9/22/2011,8000,484592,476592,60.574
The Rescuers,6/22/1977,1200000,71215869,70015869,59.3465575
Paranormal Activity 2,10/20/2010,3000000,177512032,174512032,59.17067733333333
Woodstock,3/26/1970,600000,34505110,33905110,57.508516666666665
Vanishing Point,1/15/1971,1300000,72266306,70966306,55.58946615384615
Macabre,10/1/1958,90000,5000000,4910000,55.55555555555556
The Exorcist,12/26/1973,8000000,441306145,433306145,55.163268125
One Hundred and One Dalmatians,1/25/1961,4000000,215880014,211880014,53.9700035
Pi,7/10/1998,60000,3221152,3161152,53.68586666666667
Ποτέ την Κυριακή,5/24/1960,151000,8000000,7849000,52.980132450331126
Animal House,7/27/1978,2700000,141000000,138300000,52.22222222222222
The Breakfast Club,2/15/1985,1000000,51525171,50525171,51.525171
The Jungle Book,10/17/1967,4000000,205843612,201843612,51.460903
Get Out,2/24/2017,5000000,252434250,247434250,50.48685
Goldfinger,9/17/1964,2500000,124881062,122381062,49.9524248
Valley Girl,4/8/1983,350000,17343596,16993596,49.553131428571426
Chasing Amy,4/4/1997,250000,12021272,11771272,48.085088
An Inconvenient Truth,1/24/2006,1000000,46243000,45243000,46.243
Blazing Saddles,2/7/1974,2600000,119500000,116900000,45.96153846153846
Four Weddings and a Funeral,3/9/1994,6000000,254700832,248700832,42.45013866666667
Roger & Me,9/1/1989,160000,6706368,6546368,41.9148
Frankenstein,11/21/1931,291000,12000000,11709000,41.23711340206186
Paranormal Activity 3,10/19/2011,5000000,205703818,200703818,41.1407636
The Godfather,3/14/1972,6000000,245066411,239066411,40.844401833333336
Phantasm,3/28/1979,300000,11988469,11688469,39.96156333333333
Psycho,6/16/1960,806948,32000000,31193052,39.655591190510414
Look Who's Talking,10/12/1989,7500000,296000000,288500000,39.46666666666667
From Russia with Love,10/11/1963,2000000,78898765,76898765,39.4493825
Annabelle,10/2/2014,6500000,255273813,248773813,39.272894307692304
ഗോഡ്ഫാദർ,3/3/1991,18000,700000,682000,38.888888888888886
Soodhu Kavvum,5/1/2013,310000,12000000,11690000,38.70967741935484
Saw II,10/28/2005,4000000,152925093,148925093,38.23127325
The Last Exorcism,8/27/2010,1800000,67738090,65938090,37.63227222222222
Tom Jones,10/6/1963,1000000,37600000,36600000,37.6
Rear Window,8/1/1954,1000000,36764313,35764313,36.764313
Fantasia,11/13/1940,2280000,83320000,81040000,36.54385964912281
One Flew Over the Cuckoo's Nest,11/18/1975,3000000,108981275,105981275,36.32709166666667
House of Wax,4/10/1953,658000,23800000,23142000,36.170212765957444
The Kid Stays in the Picture,1/18/2002,40000,1434436,1394436,35.8609
Dirty Dancing,8/21/1987,6000000,213954274,207954274,35.659045666666664
피에타,9/5/2012,103000,3623330,3520330,35.17796116504854
Ghoulies,11/8/1984,1000000,35000000,34000000,35.0
Das Leben der Anderen,3/15/2006,2000000,70000000,68000000,35.0
The Graduate,12/21/1967,3000000,104945305,101945305,34.981768333333335
The Sound of Music,3/2/1965,8200000,286214286,278014286,34.904181219512196
Courageous,9/30/2011,1000000,34522221,33522221,34.522221
Kingdom of the Spiders,8/24/1977,500000,17000000,16500000,34.0
The Collector,7/9/2009,3400000,114000000,110600000,33.529411764705884
Pretty Woman,3/23/1990,14000000,463000000,449000000,33.07142857142857
Intouchables,11/2/2011,13000000,426480871,413480871,32.80622084615385
Police Academy,3/22/1984,4500000,146198896,141698896,32.488643555555555
Pinocchio,2/23/1940,2600000,84300000,81700000,32.42307692307692
Zombadings 1: Patayin sa Shokot si Remington,8/31/2011,22361,721651,699290,32.27275166584678
Mickey,8/1/1918,250000,8000000,7750000,32.0
Porky's,11/13/1981,4000000,125728258,121728258,31.4320645
Juno,12/5/2007,7500000,231411584,223911584,30.854877866666666
Young Frankenstein,12/15/1974,2800000,86273333,83473333,30.811904642857144
Split,11/15/2016,9000000,276921998,267921998,30.76911088888889
Lights Out,7/21/2016,4900000,148868835,143968835,30.381394897959183
Grease,7/7/1978,6000000,181813770,175813770,30.302295
Parts Per Billion,3/25/2014,500000,15000000,14500000,30.0
Lost in Translation,8/31/2003,4000000,119723856,115723856,29.930964
The Empire Strikes Back,5/17/1980,18000000,538400000,520400000,29.91111111111111
Cat People,12/5/1942,134000,4000000,3866000,29.850746268656717
दंगल,12/23/2016,10400000,310000000,299600000,29.807692307692307
The Purge,5/31/2013,3000000,89328627,86328627,29.776209
The Sting,12/25/1973,5500000,159616327,154116327,29.021150363636362
Ultimo tango a Parigi,10/14/1972,1250000,36144000,34894000,28.9152
Rocky II,6/15/1979,7000000,200182160,193182160,28.59745142857143
Paranormal Activity 4,10/17/2012,5000000,142817992,137817992,28.5635984
Wolf Creek,1/1/2005,1000000,27762648,26762648,27.762648
Citizen Kane,4/30/1941,839727,23217674,22377947,27.649074044302495
The King's Speech,9/6/2010,15000000,414211549,399211549,27.614103266666667
"#Pellichoopulu",7/29/2016,200000,5500000,5300000,27.5
The Cherry Orchard,1/1/1999,5,135,130,27.0
A Star Is Born,12/16/1976,6000000,161000000,155000000,26.833333333333332
Pulp Fiction,9/10/1994,8000000,213928762,205928762,26.74109525
Death Race 2000,4/27/1975,300000,8000000,7700000,26.666666666666668
The Woman in Black 2: Angel of Death,12/30/2014,1000000,26501323,25501323,26.501323
Home Alone,11/9/1990,18000000,476684675,458684675,26.482481944444444
Tupac: Resurrection,1/23/2003,300000,7808524,7508524,26.028413333333333
Dog Day Afternoon,8/11/1975,1800000,46665856,44865856,25.925475555555554
Sinister,3/29/2012,3000000,77712439,74712439,25.904146333333333
Dope,6/19/2015,700000,17986781,17286781,25.69540142857143
Thunderball,12/16/1965,5500000,141195658,135695658,25.671937818181817
Your Sister's Sister,9/11/2011,125000,3200000,3075000,25.6
The Fault in Our Stars,5/16/2014,12000000,307166834,295166834,25.597236166666665
Black Swan,12/2/2010,13000000,327803731,314803731,25.215671615384615
Slumdog Millionaire,5/12/2008,15000000,377910544,362910544,25.194036266666668
The Lords of Flatbush,5/1/1974,160000,4000000,3840000,25.0
Per qualche dollaro in più,12/18/1965,600000,15000000,14400000,25.0
The House on Sorority Row,1/21/1983,425000,10604986,10179986,24.952908235294117
The Conjuring,7/18/2013,13000000,318000141,305000141,24.46154930769231
Sling Blade,8/30/1996,1000000,24444121,23444121,24.444121
I Was a Teenage Werewolf,6/19/1957,82000,2000000,1918000,24.390243902439025
A Haunted House,1/11/2013,2500000,60141683,57641683,24.0566732
Magic Mike,6/28/2012,7000000,167221571,160221571,23.888795857142856
Airplane!,7/2/1980,3500000,83453539,79953539,23.843868285714287
Top Gun,5/16/1986,15000000,356830601,341830601,23.788706733333335
American Beauty,9/15/1999,15000000,356296601,341296601,23.753106733333333
M*A*S*H,1/24/1970,3500000,81600000,78100000,23.314285714285713
Flashdance,4/14/1983,4000000,92921203,88921203,23.23030075
Live and Let Die,7/5/1973,7000000,161777836,154777836,23.111119428571428
Platoon,12/18/1986,6000000,138530565,132530565,23.0884275
Deliverance,7/30/1972,2000000,46122355,44122355,23.0611775
Ghost,7/12/1990,22000000,505000000,483000000,22.954545454545453
Fatal Attraction,9/11/1987,14000000,320145693,306145693,22.8675495
The French Connection,10/9/1971,1800000,41158757,39358757,22.86597611111111
My Left Foot: The Story of Christy Brown,7/21/1989,645180,14743391,14098211,22.85159335379274
War Room,8/28/2015,3000000,67790117,64790117,22.596705666666665
Good Will Hunting,12/5/1997,10000000,225933435,215933435,22.5933435
Swingers,10/18/1996,200000,4505922,4305922,22.52961
Death Wish 2,2/20/1982,2000000,45000000,43000000,22.5
The Last Picture Show,10/3/1971,1300000,29133000,27833000,22.41
Billy Elliot,5/18/2000,5000000,110000000,105000000,22.0
A Hard Day's Night,7/6/1964,560000,12299668,11739668,21.963692857142856
Bend It Like Beckham,4/11/2002,3500159,76578641,73078482,21.878617799934233
Peter Pan,2/5/1953,4000000,87404651,83404651,21.85116275
The Omen,6/6/1976,2800000,60922980,58122980,21.75820714285714
Taxi Driver,2/7/1976,1300000,28262574,26962574,21.74044153846154
Raiders of the Lost Ark,6/12/1981,18000000,389925971,371925971,21.662553944444443
American Pie,7/9/1999,11000000,235483004,224483004,21.40754581818182
The Fog,2/8/1980,1000000,21378361,20378361,21.378361
Beverly Hills Cop,11/29/1984,15000000,316360478,301360478,21.090698533333335
Ouija,10/24/2014,5000000,103590271,98590271,20.7180542
Howl,8/26/2010,30000,617000,587000,20.566666666666666
The Passion of the Christ,2/25/2004,30000000,611899420,581899420,20.396647333333334
Cabin Fever,8/15/2003,1500000,30553394,29053394,20.368929333333334
Cyborg,4/7/1989,500000,10166459,9666459,20.332918
[REC],4/10/2007,1500000,30448000,28948000,20.298666666666666
Bonnie and Clyde,7/18/1967,2500000,50700000,48200000,20.28
Back to the Future,7/3/1985,19000000,381109762,362109762,20.05840852631579
Home Alone 2: Lost in New York,11/19/1992,18000000,358991681,340991681,19.943982277777778
Fahrenheit 9/11,6/25/2004,6000000,119114517,113114517,19.8524195
Fat Pizza,4/10/2003,400000,7888102,7488102,19.720255
The Visit,9/10/2015,5000000,98450062,93450062,19.6900124
Pelle Svanslös,12/25/1981,48740,955401,906661,19.601990151826016
Driving Miss Daisy,12/13/1989,7500000,145793296,138293296,19.439106133333333
The Lazarus Effect,1/29/2015,3300000,64110728,60810728,19.427493333333334
Dances with Wolves,11/9/1990,22000000,424208848,402208848,19.282220363636362
Tadpole,11/1/2002,150000,2891288,2741288,19.275253333333332
Beyond the Valley of the Dolls,7/17/1970,2090000,40000000,37910000,19.138755980861244
Адмиралъ,6/6/2008,2000000,38135878,36135878,19.067939
Carrie,11/3/1976,1800000,33800000,32000000,18.77777777777778
大鱼·海棠,7/8/2016,4531653,84552250,80020597,18.65814747951796
From Here to Eternity,8/28/1953,1650000,30500000,28850000,18.484848484848484
The Grudge,10/22/2004,10000000,183474602,173474602,18.3474602
千と千尋の神隠し,7/20/2001,15000000,274925095,259925095,18.32833966666667
Good Guys Wear Black,6/1/1978,1000000,18300000,17300000,18.3
No se Aceptan Devoluciones,7/20/2013,5500000,99067206,93567206,18.012219272727272
Aladdin,11/25/1992,28000000,504050219,476050219,18.001793535714285
The Howling,4/3/1981,1000000,17985893,16985893,17.985893
Another Earth,7/22/2011,100000,1776935,1676935,17.76935
Return of the Jedi,5/23/1983,32350000,572700000,540350000,17.7032457496136
Mrs. Doubtfire,11/24/1993,25000000,441286195,416286195,17.6514478
Can't Buy Me Love,8/14/1987,1800000,31623833,29823833,17.568796111111112
The Getaway,12/13/1972,3352254,58831997,55479743,17.549981892780202
The Lion King,6/23/1994,45000000,788241776,743241776,17.516483911111113
Children of the Corn,3/9/1984,800000,14000000,13200000,17.5
ना तु�?जानो ना हम,5/9/2002,350000,6100000,5750000,17.428571428571427
Le fabuleux destin d'Amélie Poulain,4/25/2001,10000000,173921954,163921954,17.3921954
Friday the 13th Part 2,5/1/1981,1250000,21722776,20472776,17.3782208
The Station Agent,1/26/2003,500000,8679814,8179814,17.359628
Paranormal Activity: The Marked Ones,1/1/2014,5000000,86362372,81362372,17.2724744
Butch Cassidy and the Sundance Kid,9/23/1969,6000000,102308889,96308889,17.0514815
Mary Poppins,8/27/1964,6000000,102272727,96272727,17.0454545
Every Which Way But Loose,12/19/1978,5,85,80,17.0
El secreto de sus ojos,8/13/2009,2000000,33965843,31965843,16.9829215
The Poseidon Adventure,12/1/1972,5000000,84563118,79563118,16.9126236
The Crying Game,9/2/1992,3705538,62548947,58843409,16.879855772630048
The Sixth Sense,8/6/1999,40000000,672806292,632806292,16.8201573
Wind River,8/3/2017,11000000,184770205,173770205,16.797291363636365
Hostel,1/6/2005,4800000,80578934,75778934,16.787277916666667
Lovely & Amazing,8/31/2001,250000,4186931,3936931,16.747724
The Imitation Game,11/14/2014,14000000,233555708,219555708,16.68255057142857
The Piano,5/19/1993,7000000,116700000,109700000,16.67142857142857
Bei Jing yu shang Xi Ya Tu,3/20/2013,4881000,81350000,76469000,16.666666666666668
28 Days Later,10/31/2002,5000000,82719885,77719885,16.543977
Rain Man,12/11/1988,25000000,412800000,387800000,16.512
The Bodyguard,11/25/1992,25000000,411006740,386006740,16.4402696
Benvenuti al sud,10/1/2010,4000000,65584679,61584679,16.39616975
Saw III,10/27/2006,10000000,163876815,153876815,16.3876815
Moonlight,10/21/2016,4000000,65046687,61046687,16.26167175
Diamonds Are Forever,12/13/1971,7200000,116019547,108819547,16.113825972222223
There's Something About Mary,7/15/1998,23000000,369884651,346884651,16.08194134782609
Breakout,5/21/1975,1000000,16000000,15000000,16.0
Lights of New York,7/18/1928,75000,1200000,1125000,16.0
ദൃശ്യം,12/19/2013,750000,12000000,11250000,16.0
La Marche de l'empereur,1/26/2005,8000000,127392239,119392239,15.924029875
Rocky III,5/28/1982,17000000,270000000,253000000,15.882352941176471
Don't Breathe,8/25/2016,9900000,157100845,147200845,15.868772222222223
Airport 1975,10/18/1974,3000000,47000000,44000000,15.666666666666666
Minions,6/17/2015,74000000,1156730962,1082730962,15.631499486486486
Dumb and Dumber,12/16/1994,16000000,247275374,231275374,15.454710875
The Mask,7/29/1994,23000000,351583407,328583407,15.286235086956522
Midnight Express,9/12/1978,2300000,35000000,32700000,15.217391304347826
Missing in Action,11/16/1984,1500000,22812411,21312411,15.208274
Close Encounters of the Third Kind,11/16/1977,20000000,303788635,283788635,15.18943175
Crash,1/13/2004,6500000,98410061,91910061,15.140009384615384
Beauty and the Beast,11/13/1991,25000000,377350553,352350553,15.09402212
Bob & Carol & Ted & Alice,9/17/1969,2000000,30000000,28000000,15.0
Rane,5/27/1998,10000,150000,140000,15.0
西游记之大圣归来,7/10/2015,10000000,150000000,140000000,15.0
Beverly Hills Cop II,5/18/1987,20000000,299965036,279965036,14.9982518
Teenage Mutant Ninja Turtles,3/30/1990,13500000,202000000,188500000,14.962962962962964
Neighbors,5/8/2014,18000000,268157400,250157400,14.897633333333333
King Kong,4/7/1933,672000,10000000,9328000,14.880952380952381
La La Land,11/29/2016,30000000,445435700,415435700,14.847856666666667
The Longest Yard,8/21/1974,2900000,43008075,40108075,14.830370689655172
The Prince,8/22/2014,18000000,266586800,248586800,14.810377777777777
Prom Night,7/18/1980,1000000,14796236,13796236,14.796236
Scary Movie,7/7/2000,19000000,278019771,259019771,14.63261952631579
Play Misty for Me,11/3/1971,725000,10600000,9875000,14.620689655172415
Schindler's List,11/29/1993,22000000,321365567,299365567,14.607525772727273
Jurassic Park,6/11/1993,63000000,920100000,857100000,14.604761904761904
Hellraiser,9/11/1987,1000000,14564027,13564027,14.564027
Borat: Cultural Learnings of America for Make Benefit Glorious Nation of Kazakhstan,11/1/2006,18000000,261572744,243572744,14.531819111111112
Twins,12/9/1988,15000000,216614388,201614388,14.4409592
Dead Poets Society,6/2/1989,16400000,235860116,219460116,14.381714390243902
The Silence of the Lambs,2/1/1991,19000000,272742922,253742922,14.354890631578947
Boy,2/14/2010,3,43,40,14.333333333333334
"\"도가�?\"\"Based on actual events that took place at Gwangju Inhwa School for the hearing-impaired\"",9/22/2011,2200000,31500000,29300000,14.318181818181818
Fifty Shades of Grey,2/11/2015,40000000,571006128,531006128,14.2751532
Overboard,12/16/1987,1880006,26713187,24833181,14.209096673095724
The Twilight Saga: New Moon,3/15/2009,50000000,709827462,659827462,14.19654924
Like Crazy,10/28/2011,250000,3542353,3292353,14.169412
A Nightmare on Elm Street,11/14/1984,1800000,25504513,23704513,14.169173888888889
Guess Who's Coming to Dinner,12/11/1967,4000000,56666667,52666667,14.16666675
The Black Stallion,10/17/1979,2700000,37799643,35099643,13.999867777777778
Bean,7/3/1997,18000000,251212670,233212670,13.956259444444445
The Man with the Golden Gun,12/1/1974,7000000,97572000,90572000,13.938857142857144
Saw IV,10/25/2007,10000000,139352633,129352633,13.9352633
The Aristocats,12/23/1970,4000000,55675257,51675257,13.91881425
Gremlins,6/7/1984,11000000,153083102,142083102,13.916645636363636
It Happened One Night,2/22/1934,325000,4500000,4175000,13.846153846153847
Leaving Las Vegas,10/27/1995,3600000,49800000,46200000,13.833333333333334
In the Heat of the Night,8/2/1967,2000000,27379978,25379978,13.689989
The Best Exotic Marigold Hotel,11/28/2011,10000000,136836156,126836156,13.6836156
Arthur,7/17/1981,7000000,95461682,88461682,13.637383142857143
써니,5/4/2011,3550000,48000000,44450000,13.52112676056338
Deadpool,2/9/2016,58000000,783112979,725112979,13.501947913793103
Kindergarten Cop,12/21/1990,15000000,201957688,186957688,13.463845866666666
2016: Obama's America,7/13/2012,2500000,33400000,30900000,13.36
Transamerica,12/23/2005,1000000,13350369,12350369,13.350369
Kahaani,3/9/2012,1200000,16000000,14800000,13.333333333333334
Kramer vs. Kramer,12/18/1979,8000000,106260000,98260000,13.2825
The Spy Who Loved Me,7/7/1977,14000000,185438673,171438673,13.2456195
Joysticks,3/4/1983,300000,3952448,3652448,13.174826666666666
The Hangover,6/5/2009,35000000,459270619,424270619,13.122017685714285
The Boy Next Door,1/23/2015,4000000,52425855,48425855,13.10646375
The Blue Lagoon,7/5/1980,4500000,58853106,54353106,13.078468
Paws,9/25/1997,137731,1778391,1640660,12.912060465690367
Jackass: The Movie,10/21/2002,5000000,64282312,59282312,12.8564624
Baahubali 2: The Conclusion,4/27/2017,18000000,230000000,212000000,12.777777777777779
Despicable Me 2,6/25/2013,76000000,970761885,894761885,12.773182697368421
Despicable Me 3,6/15/2017,80000000,1020063384,940063384,12.7507923
Brokeback Mountain,9/2/2005,14000000,178043761,164043761,12.7174115
Friday the 13th: The Final Chapter,4/13/1984,2600000,32980880,30380880,12.684953846153846
I'm No Angel,10/6/1933,225000,2850000,2625000,12.666666666666666
On Her Majesty's Secret Service,12/12/1969,6500000,81974493,75474493,12.611460461538462
Populärmusik från Vittula,9/24/2004,2224000,28000000,25776000,12.589928057553957
Monty Python and the Holy Grail,3/13/1975,400000,5028948,4628948,12.57237
Little Miss Sunshine,7/26/2006,8000000,100523181,92523181,12.565397625
卧虎藏龙,10/1/2000,17000000,213525736,196525736,12.560337411764706
Toy Story,10/30/1995,30000000,373554033,343554033,12.4518011
Midnight Cowboy,5/25/1969,3600000,44785053,41185053,12.4402925
Scream,12/20/1996,14000000,173046663,159046663,12.360475928571429
Forrest Gump,7/6/1994,55000000,677945399,622945399,12.326279981818182
Aashiqui 2,4/25/2013,1300000,16000000,14700000,12.307692307692308
Mad Max 2,12/24/1981,2000000,24600832,22600832,12.300416
The Terminator,10/26/1984,6400000,78371200,71971200,12.2455
Notorious,8/15/1946,2000000,24464742,22464742,12.232371
Reservoir Dogs,9/2/1992,1200000,14661007,13461007,12.217505833333334
The Wizard of Oz,8/15/1939,2777000,33754967,30977967,12.15519157364062
The Purge: Anarchy,7/17/2014,9000000,108782847,99782847,12.086983
A Clockwork Orange,12/18/1971,2200000,26589000,24389000,12.085909090909091
The Gods Must Be Crazy,9/10/1980,5000000,60000000,55000000,12.0
The Buddy Holly Story,5/18/1978,1200000,14363400,13163400,11.9695
Casablanca,11/26/1942,878000,10462500,9584500,11.916287015945331
The Lord of the Rings: The Return of the King,12/1/2003,94000000,1118888979,1024888979,11.903074244680852
Indiana Jones and the Temple of Doom,5/23/1984,28000000,333000000,305000000,11.892857142857142
The Purge: Election Year,6/29/2016,10000000,118587880,108587880,11.858788
Grandma,6/4/2015,600000,7087452,6487452,11.81242
명량,7/30/2014,9500000,112156811,102656811,11.805980105263158
The Gift,7/30/2015,5000000,58978653,53978653,11.7957306
Batman,6/23/1989,35000000,411348924,376348924,11.7528264
You Only Live Twice,6/12/1967,9500000,111584787,102084787,11.74576705263158
Mamma Mia!,7/3/2008,52000000,609841637,557841637,11.727723788461539
Beasts of the Southern Wild,6/29/2012,1800000,21107746,19307746,11.726525555555556
The Lord of the Rings: The Two Towers,12/18/2002,79000000,926287400,847287400,11.725156962025316
Lion,11/24/2016,12000000,140302754,128302754,11.691896166666666
Ferris Bueller's Day Off,6/11/1986,6000000,70136369,64136369,11.689394833333333
Sergeant York,7/2/1941,1400000,16361885,14961885,11.687060714285714
Speed,6/9/1994,30000000,350448145,320448145,11.681604833333333
The Secret Life of Pets,6/18/2016,75000000,875457937,800457937,11.672772493333333
Pizza,10/19/2012,240000,2800000,2560000,11.666666666666666
Shakespeare in Love,12/11/1998,25000000,289317794,264317794,11.57271176
The Witch,2/19/2016,3500000,40423945,36923945,11.549698571428571
Love's Deadly Triangle: The Texas Cadet Murder,2/20/1997,14000000,161001698,147001698,11.500121285714286
Born on the Fourth of July,12/20/1989,14000000,161001698,147001698,11.500121285714286
The Broadway Melody,2/8/1929,379000,4358000,3979000,11.49868073878628
La vita è bella,12/20/1997,20000000,229400000,209400000,11.47
Poltergeist,6/4/1982,10700000,122200000,111500000,11.42056074766355
Earthquake,11/15/1974,7000000,79666653,72666653,11.38095042857143
Unforgiven,8/7/1992,14000000,159157447,145157447,11.368389071428572
The Karate Kid,6/22/1984,8000000,90815558,82815558,11.35194475
Strictly Ballroom,8/20/1992,3000000,33946224,30946224,11.315408
Vertigo,5/9/1958,2479000,28000000,25521000,11.294876966518757
Bridget Jones's Diary,4/13/2001,25000000,281929795,256929795,11.2771918
The Texas Chainsaw Massacre,10/17/2003,9500000,107071655,97571655,11.270700526315789
The Best Years of Our Lives,12/25/1946,2100000,23650000,21550000,11.261904761904763
Monster's Ball,11/11/2001,4000000,44909486,40909486,11.2273715
Hoop Dreams,9/12/1994,700000,7830611,7130611,11.186587142857142
Ирония судьбы. Продолжение,12/21/2007,5000000,55635037,50635037,11.1270074
The Bellboy,7/20/1960,900000,10000000,9100000,11.11111111111111
Waitress,5/25/2007,2000000,22179430,20179430,11.089715
Boyhood,6/5/2014,4000000,44349000,40349000,11.08725
Cool Runnings,9/30/1993,14000000,154864401,140864401,11.061742928571428
Dallas Buyers Club,9/7/2013,5000000,55198285,50198285,11.039657
She Done Him Wrong,2/9/1933,200000,2200000,2000000,11.0
Ted,6/29/2012,50000000,549368315,499368315,10.9873663
High Noon,3/27/1952,730000,8000000,7270000,10.95890410958904
Taare Zameen Par,12/21/2007,2600000,28430000,25830000,10.934615384615384
Independence Day,6/25/1996,75000000,816969268,741969268,10.892923573333332
No Escape,8/26/2015,5000000,54418872,49418872,10.8837744
Tosun Paşa,1/1/1976,64200,698200,634000,10.87538940809969
The Caine Mutiny,6/24/1954,2000000,21750000,19750000,10.875
Luftslottet som sprängdes,11/27/2009,4000000,43498108,39498108,10.874527
Fried Green Tomatoes,12/27/1991,11000000,119418501,108418501,10.856227363636364
Sleepless in Seattle,6/24/1993,21000000,227799884,206799884,10.847613523809525
Como agua para chocolate,4/16/1992,2000000,21665468,19665468,10.832734
Bad Teacher,5/16/2011,20000000,216197492,196197492,10.8098746
Harry Potter and the Deathly Hallows: Part 2,7/7/2011,125000000,1342000000,1217000000,10.736
Chariots of Fire,5/15/1981,5500000,58972904,53472904,10.722346181818182
Garden State,7/28/2004,2500000,26781723,24281723,10.7126892
While You Were Sleeping,4/21/1995,17000000,182057016,165057016,10.709236235294117
The Blind Side,11/20/2009,29000000,309208309,280208309,10.66235548275862
Recep İvedik,2/22/2008,500000,5330000,4830000,10.66
Twilight,11/20/2008,37000000,392616625,355616625,10.611260135135135
House Party,3/9/1990,2500000,26386000,23886000,10.5544
On the Waterfront,6/22/1954,910000,9600000,8690000,10.54945054945055
Saw V,10/23/2008,10800000,113857533,103057533,10.542364166666667
American Ninja,8/30/1985,1000000,10499694,9499694,10.499694
Amores perros,6/16/2000,2000000,20908467,18908467,10.4542335
Rosemary's Baby,6/12/1968,3200000,33395426,30195426,10.436070625
Insidious: Chapter 3,6/4/2015,10000000,104303851,94303851,10.4303851
Me Before You,6/2/2016,20000000,207945075,187945075,10.39725375
A Nightmare on Elm Street 4: The Dream Master,8/19/1988,7000000,72500000,65500000,10.357142857142858
Des hommes et des dieux,5/18/2010,4000000,41424067,37424067,10.35601675
She's All That,1/29/1999,10000000,103166989,93166989,10.3166989
The Twilight Saga: Eclipse,6/23/2010,68000000,698491347,630491347,10.271931573529411
Mujeres al borde de un ataque de nervios,3/14/1988,700000,7179298,6479298,10.25614
Risky Business,8/5/1983,6200000,63541777,57341777,10.24867370967742
The Maze Runner,9/10/2014,34000000,348319861,314319861,10.244701794117647
Halloween II,10/30/1981,2500000,25533818,23033818,10.2135272
Doctor Zhivago,12/22/1965,11000000,111858363,100858363,10.168942090909091
Romeo + Juliet,10/31/1996,14500000,147298761,132798761,10.15853524137931
Jackass Presents: Bad Grandpa,10/22/2013,15000000,151831537,136831537,10.122102466666666
Jurassic World,6/9/2015,150000000,1513528810,1363528810,10.090192066666667
Presumed Innocent,7/26/1990,22000000,221303188,199303188,10.059235818181818
Airport,3/5/1970,10000000,100489151,90489151,10.0489151
Cry_Wolf,9/16/2005,1000000,10047674,9047674,10.047674
Mrs. Miniver,6/4/1942,1344000,13500000,12156000,10.044642857142858
Born into Brothels,12/8/2004,350000,3515061,3165061,10.043031428571428
Gojira ni-sen mireniamu,12/11/1999,1000000,10037390,9037390,10.03739
Kissing Jessica Stein,4/21/2001,1000000,10013424,9013424,10.013424
Kuch Kuch Hota Hai,10/16/1998,1530000,15306000,13776000,10.003921568627451
Finding Nemo,5/30/2003,94000000,940335536,846335536,10.003569531914893
Valley of the Dolls,12/27/1967,5000000,50000000,45000000,10.0
The Pit and the Pendulum,8/12/1961,200000,2000000,1800000,10.0
The Kid,1/21/1921,250000,2500000,2250000,10.0
Halo Legends,2/16/2010,100000,1000000,900000,10.0
A Nightmare on Elm Street Part 2: Freddy's Revenge,10/31/1985,3000000,29999213,26999213,9.999737666666666
Friday the 13th: A New Beginning,3/22/1985,2200000,21930418,19730418,9.968371818181819
Snow Flower and the Secret Fan,7/15/2011,134005,1332231,1198226,9.941651430916757
Serpico,12/5/1973,3000000,29800000,26800000,9.933333333333334
Se7en,9/22/1995,33000000,327311859,294311859,9.918541181818181
The Kids Are All Right,7/9/2010,3500000,34705850,31205850,9.915957142857144
Pitch Perfect 2,5/7/2015,29000000,287506194,258506194,9.914006689655173
Aliens,7/18/1986,18500000,183316455,164816455,9.908997567567567
Indiana Jones and the Last Crusade,5/24/1989,48000000,474171806,426171806,9.878579291666666
Ice Age: Dawn of the Dinosaurs,6/29/2009,90000000,886686817,796686817,9.852075744444445
Ghostbusters,6/7/1984,30000000,295212467,265212467,9.840415566666668
Bronson,10/9/2008,230000,2260712,2030712,9.829182608695652
Sultan,7/6/2016,10400000,102000000,91600000,9.807692307692308
Kickboxer,4/20/1989,1500000,14697005,13197005,9.798003333333334
Silver Linings Playbook,9/8/2012,21000000,205738714,184738714,9.797081619047619
Ben-Hur,12/26/1959,15000000,146900000,131900000,9.793333333333333
The Sword and the Sorcerer,4/1/1982,4000000,39103425,35103425,9.77585625
Mama,1/17/2013,15000000,146497771,131497771,9.766518066666666
Footloose,2/17/1984,8200000,80035402,71835402,9.760414878048781
The Color Purple,12/18/1985,15000000,146292009,131292009,9.7528006
Day of the Dead,7/19/1985,3500000,34000000,30500000,9.714285714285714
Rocky IV,11/21/1985,31000000,300473716,269473716,9.692700516129031
Chronicle,2/1/2012,15000000,145000000,130000000,9.666666666666666
Sliding Doors,4/23/1998,6000000,58000000,52000000,9.666666666666666
Calendar Girls,9/2/2003,10000000,96542059,86542059,9.6542059
Buried,9/24/2010,1987650,19152480,17164830,9.635740698815184
American Pie 2,8/10/2001,30000000,287553595,257553595,9.585119833333334
Annie Hall,4/19/1977,4000000,38251425,34251425,9.56285625
An Unmarried Woman,5/26/1978,2515000,24000000,21485000,9.542743538767395
Alien,5/25/1979,11000000,104931801,93931801,9.539254636363637
Madea's Family Reunion,2/24/2006,6000000,57231524,51231524,9.538587333333334
Step Up,8/11/2006,12000000,114194847,102194847,9.51623725
Leprechaun,1/8/1993,900000,8556940,7656940,9.507711111111112
Purple Rain,7/27/1984,7200000,68392977,61192977,9.499024583333334
The Ten Commandments,10/5/1956,13000000,122700000,109700000,9.438461538461539
Austin Powers: The Spy Who Shagged Me,6/8/1999,33000000,310940086,277940086,9.422426848484848
Jaws 2,6/16/1978,20000000,187884007,167884007,9.39420035
An American Tail,11/21/1986,9000000,84542002,75542002,9.393555777777777
Private Lessons,8/21/1981,2800000,26279000,23479000,9.385357142857142
The Lord of the Rings: The Fellowship of the Ring,12/18/2001,93000000,871368364,778368364,9.369552301075268
Easy A,9/10/2010,8000000,74952305,66952305,9.369038125
12 Years a Slave,10/18/2013,20000000,187000000,167000000,9.35
The Devil Wears Prada,6/30/2006,35000000,326551094,291551094,9.330031257142856
Cidade de Deus,2/5/2002,3300000,30641770,27341770,9.28538484848485
El Mariachi,9/4/1992,220000,2040920,1820920,9.276909090909092
Fiddler on the Roof,11/3/1971,9000000,83304330,74304330,9.256036666666667
Дневной дозор,1/1/2006,4200000,38862717,34662717,9.253027857142857
The Secret of My Success,4/10/1987,12000000,110996879,98996879,9.249739916666666
Ice Age: Continental Drift,6/26/2012,95000000,877244782,782244782,9.2341556
PK,12/18/2014,13000000,120000000,107000000,9.23076923076923
Hidden Figures,12/10/2016,25000000,230698791,205698791,9.22795164
Titanic,11/18/1997,200000000,1845034188,1645034188,9.22517094
American Sniper,12/11/2014,58800000,542307423,483507423,9.222915357142858
The Hunger Games,3/12/2012,75000000,691210692,616210692,9.21614256
Sleeping with the Enemy,2/8/1991,19000000,174999005,155999005,9.21047394736842
Bad Moms,7/28/2016,20000000,183936074,163936074,9.1968037
Lethal Weapon 3,5/15/1992,35000000,321731527,286731527,9.192329342857143
Mr. Bean's Holiday,3/22/2007,25000000,229736344,204736344,9.18945376
Friday the 13th Part III,8/13/1982,4000000,36690067,32690067,9.17251675
Sleeper,12/17/1973,2000000,18344729,16344729,9.1723645
Oh Boy,7/3/2012,300000,2750275,2450275,9.167583333333333
The Strangers,5/29/2008,9000000,82391145,73391145,9.154571666666667
The Sessions,5/2/2012,1000000,9138338,8138338,9.138338
Red Dawn,8/10/1984,4200000,38376497,34176497,9.13726119047619
High Anxiety,12/25/1977,3400000,31063038,27663038,9.136187647058824
White Noise,1/7/2005,10000000,91196419,81196419,9.1196419
Lethal Weapon 2,7/7/1989,25000000,227853986,202853986,9.11415944
Ouija: Origin of Evil,10/20/2016,9000000,81705746,72705746,9.078416222222222
Taken,2/18/2008,25000000,226830568,201830568,9.07322272
The Bridge on the River Kwai,10/2/1957,3000000,27200000,24200000,9.066666666666666
Blair Witch,9/15/2016,5000000,45172994,40172994,9.0345988
Everything You Always Wanted to Know About Sex *But Were Afraid to Ask,8/6/1972,2000000,18016290,16016290,9.008145
Love Me Tender,11/15/1956,1000000,9000000,8000000,9.0
The Greatest Show on Earth,1/10/1952,4000000,36000000,32000000,9.0
Dirty Harry,12/21/1971,4000000,35976000,31976000,8.994
A Nightmare on Elm Street 3: Dream Warriors,2/27/1987,5000000,44793222,39793222,8.9586444
The Karate Kid,6/10/2010,40000000,357852395,317852395,8.946309875
The Artist,5/15/2011,15000000,133432856,118432856,8.895523733333333
Bowling for Columbine,10/9/2002,4000000,35564473,31564473,8.89111825
Bridesmaids,4/28/2011,32500000,288383523,255883523,8.87333916923077
The Descendants,9/9/2011,20000000,177243185,157243185,8.86215925
A Dog's Purpose,1/19/2017,22000000,194647323,172647323,8.84760559090909
Boyz n the Hood,7/12/1991,6500000,57504069,51004069,8.846779846153845
The Iron Lady,12/30/2011,13000000,114956699,101956699,8.842823
Oculus,9/8/2013,5000000,44030246,39030246,8.8060492
The Lost Weekend,11/25/1945,1250000,11000000,9750000,8.8
The Robe,9/16/1953,4100000,36000000,31900000,8.78048780487805
Still Alice,12/5/2014,5000000,43884652,38884652,8.7769304
Harry Potter and the Chamber of Secrets,11/13/2002,100000000,876688482,776688482,8.76688482
The China Syndrome,3/16/1979,5900000,51718367,45818367,8.765824915254237
Parasite,3/12/1982,800000,7000000,6200000,8.75
Marty,4/11/1955,343000,3000000,2657000,8.746355685131196
Splash,3/9/1984,8000000,69821334,61821334,8.72766675
Breaking Away,5/24/1979,2300000,20000000,17700000,8.695652173913043
Some Like It Hot,3/18/1959,2883848,25000000,22116152,8.668972844615944
Notting Hill,5/13/1999,42000000,363889678,321889678,8.664039952380952
Fargo,4/5/1996,7000000,60611975,53611975,8.65885357142857
Romancing the Stone,3/30/1984,10000000,86572238,76572238,8.6572238
The Santa Clause,11/10/1994,22000000,189833357,167833357,8.628788954545454
The Second Best Exotic Marigold Hotel,2/26/2015,10000000,85978266,75978266,8.5978266
The Outlaw Josey Wales,6/30/1976,3700000,31800000,28100000,8.594594594594595
The English Patient,11/14/1996,27000000,231976425,204976425,8.591719444444445
Cocktail,7/29/1988,20000000,171504781,151504781,8.57523905
Grand Masti,9/13/2013,5500000,47000000,41500000,8.545454545454545
Stripes,6/25/1981,10000000,85300000,75300000,8.53
Sleeping Beauty,1/28/1959,6000000,51000000,45000000,8.5
Frozen,11/27/2013,150000000,1274219009,1124219009,8.494793393333333
A Patch of Blue,12/10/1965,800000,6792000,5992000,8.49
Monsters,6/18/2010,500000,4242978,3742978,8.485956
Time Bandits,7/13/1981,5000000,42365581,37365581,8.4731162
Babe,7/18/1995,30000000,254134910,224134910,8.471163666666667
Dil To Pagal Hai,10/30/1997,1300000,11000000,9700000,8.461538461538462
Garv: Pride and Honour,7/9/2004,1300000,11000000,9700000,8.461538461538462
Heaven is for Real,4/16/2014,12000000,101332962,89332962,8.4444135
Star Wars: The Force Awakens,12/15/2015,245000000,2068223624,1823223624,8.44172907755102
Tootsie,12/16/1982,21000000,177200000,156200000,8.438095238095238
Sing,11/23/2016,75000000,632443719,557443719,8.43258292
Big,6/3/1988,18000000,151668774,133668774,8.426043
Doctor Who,3/31/1996,5000000,42000000,37000000,8.4
The Dirty Dozen,6/15/1967,5400000,45300000,39900000,8.38888888888889
DodgeBall: A True Underdog Story,6/18/2004,20000000,167722310,147722310,8.3861155
The Fugitive,8/6/1993,44000000,368875760,324875760,8.38354
Escape from New York,5/22/1981,6000000,50244700,44244700,8.374116666666668
The Return of the Pink Panther,5/21/1975,5000000,41833347,36833347,8.3666694
Taken 2,9/27/2012,45000000,376141306,331141306,8.358695688888888
Snatch,9/1/2000,10000000,83557872,73557872,8.3557872
Ghajini,12/25/2008,9100000,76000000,66900000,8.351648351648352
First Blood,10/22/1982,15000000,125212904,110212904,8.347526933333333
Philomena,11/1/2013,12000000,100129872,88129872,8.344156
La Bamba,7/24/1987,6500000,54215416,47715416,8.340833230769231
Manchester by the Sea,11/18/2016,9000000,75026965,66026965,8.336329444444445
The Apartment,6/15/1960,3000000,25000000,22000000,8.333333333333334
Project X,3/1/2012,12000000,100000000,88000000,8.333333333333334
ആക്ഷ�?ഹീറോ ബിജു,2/4/2016,300000,2500000,2200000,8.333333333333334
A Fish Called Wanda,7/15/1988,7500000,62493712,54993712,8.332494933333333
All the President's Men,4/4/1976,8500000,70600000,62100000,8.305882352941177
Back to the Future Part II,11/20/1989,40000000,332000000,292000000,8.3
The Towering Inferno,12/14/1974,14000000,116000000,102000000,8.285714285714286
Magic Mike XXL,7/1/2015,14800000,122513057,107713057,8.277909256756757
The African Queen,12/3/1951,1300000,10750000,9450000,8.26923076923077
Ice Age: The Meltdown,3/23/2006,80000000,660940780,580940780,8.26175975
Brick,1/30/2005,475000,3919254,3444254,8.251061052631579
The Theory of Everything,11/26/2014,15000000,123726688,108726688,8.248445866666666
The Queen,9/15/2006,15000000,123384128,108384128,8.225608533333334
Todo sobre mi madre,4/19/1999,8272296,67872296,59600000,8.204771202577858
Sense and Sensibility,12/13/1995,16500000,135000000,118500000,8.181818181818182
Gran Torino,12/9/2008,33000000,269958228,236958228,8.180552363636364
Dirty Grandpa,1/21/2016,11500000,94073028,82573028,8.180263304347825
Singham,7/22/2011,3062000,25034000,21972000,8.175702155453951
Robin Hood: Prince of Thieves,6/14/1991,48000000,390493908,342493908,8.13528975
Make Your Move,8/7/2013,15,122,107,8.133333333333333
(500) Days of Summer,7/17/2009,7500000,60722734,53222734,8.096364533333333
The Waterboy,11/6/1998,23000000,185991646,162991646,8.086593304347826
Following,9/12/1998,6000,48482,42482,8.080333333333334
Shrek,5/16/2001,60000000,484409218,424409218,8.073486966666668
Star Trek II: The Wrath of Khan,6/3/1982,12000000,96800000,84800000,8.066666666666666
Friday,4/26/1995,3500000,28215918,24715918,8.061690857142857
La mala educación,3/19/2004,5000000,40266982,35266982,8.0533964
괴물,7/27/2006,11000000,88489643,77489643,8.044513
47 Meters Down,6/15/2017,5500000,44235023,38735023,8.042731454545455
Star Wars: Episode I - The Phantom Menace,5/19/1999,115000000,924317558,809317558,8.037543982608696
Let's Be Cops,8/13/2014,17000000,136621271,119621271,8.036545352941177
Star Wars: The Clone Wars,8/5/2008,8500000,68282844,59782844,8.033275764705882
Män som hatar kvinnor,2/27/2009,13000000,104345682,91345682,8.026590923076924
Lethal Weapon,3/6/1987,15000000,120207127,105207127,8.013808466666667
Think Like a Man,4/16/2012,12000000,96070507,84070507,8.005875583333333
The Last King of Scotland,9/1/2006,6000000,48027970,42027970,8.004661666666667
The Conjuring 2,5/13/2016,40000000,320170008,280170008,8.0042502
Roman Holiday,9/2/1953,1500000,12000000,10500000,8.0
Dhoom,8/27/2004,1500000,12000000,10500000,8.0
Er ist wieder da,10/8/2015,3196621,25513752,22317131,7.981475439221603
Menace II Society,5/26/1993,3500000,27900000,24400000,7.9714285714285715
Philadelphia,12/22/1993,26000000,206678440,180678440,7.949170769230769
The Cheat,12/13/1915,17311,137365,120054,7.935127953324476
The Proposal,6/1/2009,40000000,317375031,277375031,7.934375775
Begin Again,9/7/2013,8000000,63464861,55464861,7.933107625
Furious 7,4/1/2015,190000000,1506249360,1316249360,7.927628210526316
Scoop,7/27/2006,4000000,31584901,27584901,7.89622525
Beauty and the Beast,3/16/2017,160000000,1262886337,1102886337,7.89303960625
Beethoven's 2nd,12/14/1993,15000000,118243066,103243066,7.882871066666667
Despicable Me,7/8/2010,69000000,543513985,474513985,7.877014275362319
Legally Blonde,7/13/2001,18000000,141774679,123774679,7.8763710555555555
My Best Friend's Wedding,6/19/1997,38000000,299288605,261288605,7.876015921052631
Bloodsport,2/26/1988,1500000,11806119,10306119,7.870746
Silver Streak,12/3/1976,6500000,51079064,44579064,7.858317538461538
Ernest Goes to Camp,5/22/1987,3000000,23509382,20509382,7.8364606666666665
The Lego Movie,2/6/2014,60000000,469160692,409160692,7.8193448666666665
Harry Potter and the Philosopher's Stone,11/16/2001,125000000,976475550,851475550,7.8118044
Paranormal Activity: The Ghost Dimension,10/21/2015,10000000,78096553,68096553,7.8096553
Resident Evil: The Final Chapter,12/23/2016,40000000,312242626,272242626,7.80606565
Sands of Iwo Jima,12/14/1949,1000000,7800000,6800000,7.8
3 Idiots,12/23/2009,9000000,70000000,61000000,7.777777777777778
Colors,4/15/1988,6000000,46616067,40616067,7.7693445
Children of the Corn II: The Final Sacrifice,1/29/1993,900000,6980986,6080986,7.756651111111111
The Grudge 3,5/12/2009,5000000,38610009,33610009,7.7220018
Air Bud,8/1/1997,3000000,23144499,20144499,7.714833
Bullitt,10/17/1968,5500000,42300873,36800873,7.691067818181819
Free Willy,7/16/1993,20000000,153698625,133698625,7.68493125
National Lampoon’s Van Wilder,3/29/2002,5000000,38275483,33275483,7.6550966
Ночной дозор,6/27/2004,4200000,32000000,27800000,7.619047619047619
The Lord of the Rings,11/15/1978,4000000,30471420,26471420,7.617855
Kokowääh,2/2/2011,5650000,43000000,37350000,7.610619469026549
Mean Girls,4/30/2004,17000000,129042871,112042871,7.590757117647059
The Exorcism of Emily Rose,9/9/2005,19000000,144216468,125216468,7.590340421052631
The Bridges of Madison County,5/28/1995,24000000,182016617,158016617,7.584025708333333
Dilwale Dulhania Le Jayenge,10/20/1995,13200000,100000000,86800000,7.575757575757576
Justin Bieber: Never Say Never,2/11/2011,13000000,98441954,85441954,7.572458
Paris is Burning,3/13/1990,500000,3779620,3279620,7.55924
Monster,11/16/2003,8000000,60378584,52378584,7.547323
Phone Booth,9/9/2002,13000000,97837138,84837138,7.525933692307692
The Hand that Rocks the Cradle,1/10/1992,11700000,88036683,76336683,7.52450282051282
Star Wars: Episode III - Revenge of the Sith,5/17/2005,113000000,850000000,737000000,7.522123893805309
寻龙诀,12/18/2015,37000000,278300000,241300000,7.521621621621621
The Woman in Black,2/1/2012,17000000,127730736,110730736,7.513572705882353
Shaun of the Dead,4/9/2004,4000000,30039392,26039392,7.509848
Wizards,2/9/1977,1200000,9000000,7800000,7.5
Road Trip,5/19/2000,16000000,119754278,103754278,7.484642375
Patton,1/25/1970,12000000,89800000,77800000,7.483333333333333
Sister Act,5/28/1992,31000000,231605150,200605150,7.4711338709677415
Beverly Hills Chihuahua,10/3/2008,20000000,149281606,129281606,7.4640803
Fletch,5/31/1985,8000000,59612888,51612888,7.451611
The Wrestler,9/7/2008,6000000,44703995,38703995,7.450665833333334
Bad Boys,4/7/1995,19000000,141407024,122407024,7.442474947368421
The Flintstones,5/26/1994,46000000,341631208,295631208,7.426765391304348
East Is East,5/14/1999,3800000,28200000,24400000,7.421052631578948
Rush Hour,9/18/1998,33000000,244386864,211386864,7.405662545454545
Sausage Party,7/11/2016,19000000,140705322,121705322,7.405543263157894
Coming to America,6/28/1988,39000000,288752301,249752301,7.4039051538461536
The Squid and the Whale,10/5/2005,1500000,11098131,9598131,7.398754
The Sword in the Stone,12/25/1963,3000000,22182353,19182353,7.394117666666666
Hard Candy,1/14/2005,950000,7022209,6072209,7.391798947368421
The Butterfly Effect,1/22/2004,13000000,96060858,83060858,7.38929676923077
I Know What You Did Last Summer,10/17/1997,17000000,125586134,108586134,7.387419647058824
La vérité si je mens !,4/1/1997,4000000,29456000,25456000,7.364
The Matrix,3/30/1999,63000000,463517383,400517383,7.357418777777778
It Follows,2/4/2015,2000000,14674076,12674076,7.337038
Death Wish,7/24/1974,3000000,22000000,19000000,7.333333333333333
Knocked Up,6/1/2007,30000000,219076518,189076518,7.3025506
We're the Millers,8/7/2013,37000000,269994119,232994119,7.297138351351351
West Side Story,10/18/1961,6000000,43656822,37656822,7.276137
Bull Durham,6/15/1988,7000000,50888000,43888000,7.269714285714286
A Man for All Seasons,12/12/1966,3900000,28350000,24450000,7.269230769230769
Earth,4/22/2007,15000000,109000000,94000000,7.266666666666667
About Time,8/16/2013,12000000,87100449,75100449,7.25837075
Madonna: Truth or Dare,5/10/1991,4,29,25,7.25
Les Misérables,12/18/2012,61000000,441809770,380809770,7.242783114754098
Cruel Intentions,3/5/1999,10500000,75902208,65402208,7.228781714285715
Million Dollar Baby,12/15/2004,30000000,216763646,186763646,7.2254548666666665
10 Cloverfield Lane,3/10/2016,15000000,108286421,93286421,7.219094733333334
Basic Instinct,3/20/1992,49000000,352927224,303927224,7.202596408163266
Straight Outta Compton,8/13/2015,28000000,201634991,173634991,7.201249678571428
Hit & Run,8/22/2012,2000000,14400000,12400000,7.2
Dark Skies,2/21/2013,3500000,25174316,21674316,7.192661714285714
Scream 2,12/9/1997,24000000,172363301,148363301,7.181804208333333
If I Stay,8/21/2014,11000000,78874843,67874843,7.170440272727273
Ace Ventura: Pet Detective,2/4/1994,15000000,107217396,92217396,7.1478264
Wedding Crashers,7/14/2005,40000000,285176741,245176741,7.129418525
Paper Towns,6/18/2015,12000000,85512300,73512300,7.126025
Mannequin,2/13/1987,6000000,42721196,36721196,7.120199333333334
Airlift,1/22/2016,4500000,32000000,27500000,7.111111111111111
Madagascar,5/25/2005,75000000,532680671,457680671,7.1024089466666664
Ida,10/25/2013,2159280,15298355,13139075,7.0849334037271685
Ace Ventura: When Nature Calls,11/10/1995,30000000,212385533,182385533,7.079517766666667
Paul Blart: Mall Cop,1/15/2009,26000000,183293131,157293131,7.049735807692308
The Santa Clause 3: The Escape Clause,11/1/2006,12000000,84500122,72500122,7.041676833333334
The Simpsons Movie,7/25/2007,75000000,527068851,452068851,7.02758468
District 9,8/5/2009,30000000,210819611,180819611,7.027320366666666
Tangerine,7/10/2015,100000,702354,602354,7.02354
Half Nelson,8/11/2006,700000,4911725,4211725,7.01675
Indecent Proposal,4/7/1993,38000000,266614059,228614059,7.0161594473684215
Capote,9/30/2005,7000000,49084830,42084830,7.012118571428571
The Shallows,6/24/2016,17000000,119100758,102100758,7.005926941176471
Save the Last Dance,1/12/2001,13000000,91038276,78038276,7.0029443076923075
Around the World in Eighty Days,10/17/1956,6000000,42000000,36000000,7.0
"\"இறுதிச்சுற்ற�?\"\"A grumpy boxing coach takes on a young\"",1/28/2016,300000,2100000,1800000,7.0
Bajrangi Bhaijaan,7/17/2015,14000000,98000000,84000000,7.0
Mickey's Christmas Carol,10/19/1983,3000000,21000000,18000000,7.0
A Room with a View,12/13/1985,3000000,20966644,17966644,6.9888813333333335
For Your Eyes Only,6/23/1981,28000000,195312802,167312802,6.975457214285714
Hot Shots!,7/31/1991,26000000,181096164,155096164,6.965237076923077
Psycho II,6/3/1983,5000000,34725000,29725000,6.945
喜宴,8/4/1993,1000000,6933459,5933459,6.933459
Winter's Bone,6/11/2010,2000000,13831503,11831503,6.9157515
Ayurveda: Art of Being,9/20/2001,300000,2074000,1774000,6.913333333333333
Salmon Fishing in the Yemen,9/10/2011,5000000,34564651,29564651,6.9129302
The Twilight Saga: Breaking Dawn - Part 2,11/13/2012,120000000,829000000,709000000,6.908333333333333
The Avengers,4/25/2012,220000000,1519557910,1299557910,6.907081409090909
The Lady in the Van,11/13/2015,6000000,41387687,35387687,6.897947833333333
Fifty Shades Darker,2/8/2017,55000000,378827494,323827494,6.887772618181818
Saving Private Ryan,7/24/1998,70000000,481840909,411840909,6.8834415571428575
End of Watch,9/20/2012,7000000,48126384,41126384,6.875197714285714
Invasion of the Body Snatchers,12/19/1978,3500000,24046533,20546533,6.870438
The Land Before Time,11/18/1988,12300000,84460846,72160846,6.866735447154472
Big Daddy,6/25/1999,34200000,234801895,200601895,6.865552485380117
No Country for Old Men,11/8/2007,25000000,171600000,146600000,6.864
The Incredibles,11/5/2004,92000000,631442092,539442092,6.863501
Desert Hearts,10/1/1985,350000,2400000,2050000,6.857142857142857
The Wedding Singer,2/13/1998,18000000,123306987,105306987,6.850388166666667
Tommy,3/19/1975,5000000,34251525,29251525,6.850305
Friday the 13th Part VII: The New Blood,5/13/1988,2800000,19170001,16370001,6.846428928571428
Sideways,10/22/2004,16000000,109502303,93502303,6.8438939375
The Unholy Three,9/16/1925,103000,704000,601000,6.834951456310679
Apollo 13,6/30/1995,52000000,355237933,303237933,6.831498711538462
Cloverfield,1/15/2008,25000000,170764026,145764026,6.83056104
Rambo: First Blood Part II,5/21/1985,44000000,300400432,256400432,6.827282545454546
Zootopia,2/11/2016,150000000,1023784195,873784195,6.825227966666667
Pee-wee's Big Adventure,7/26/1985,6000000,40940662,34940662,6.823443666666667
Gravity,9/27/2013,105000000,716392705,611392705,6.822787666666667
Octopussy,6/5/1983,27500000,187500000,160000000,6.818181818181818
ഓം ശാന്തി ഓശാന,2/7/2014,220000,1500000,1280000,6.818181818181818
Chicago,12/26/2002,45000000,306776732,261776732,6.817260711111111
17 Again,3/11/2009,20000000,136267476,116267476,6.8133738
Saw 3D,10/21/2010,20000000,136150434,116150434,6.8075217
Niagara,1/26/1953,1250000,8500000,7250000,6.8
Mortal Kombat,8/18/1995,18000000,122195920,104195920,6.788662222222222
Taken 3,12/16/2014,48000000,325771424,277771424,6.786904666666667
Pitch Perfect,9/28/2012,17000000,115350426,98350426,6.785319176470588
The Jungle Book 2,2/7/2003,20000000,135680000,115680000,6.784
Act of Valor,2/24/2012,12000000,81272766,69272766,6.7727305
Catch Me If You Can,12/25/2002,52000000,352114312,300114312,6.771429076923077
Nefes: Vatan Sağolsun,10/15/2009,2000000,13500000,11500000,6.75
Liar Liar,3/21/1997,45000000,302710615,257710615,6.726902555555555
Love and Death,6/10/1975,3000000,20173742,17173742,6.724580666666666
Y tu mamá también,6/8/2001,5000000,33616692,28616692,6.7233384
The Game Plan,9/28/2007,22000000,147880543,125880543,6.721842863636364
My Bloody Valentine,1/16/2009,15000000,100734718,85734718,6.715647866666667
Hot Fuzz,2/14/2007,12000000,80573774,68573774,6.714481166666666
Skyline,11/11/2010,10000000,66821036,56821036,6.6821036
Human Traffic,6/4/1999,600000,4000000,3400000,6.666666666666667
Lobo Guerreiro,4/2/2015,12000000,80000000,68000000,6.666666666666667
Walk the Line,9/13/2005,28000000,186438883,158438883,6.658531535714285
Caddyshack,7/25/1980,6000000,39846344,33846344,6.641057333333333
The Hunt for Red October,3/2/1990,30000000,199200000,169200000,6.64
True Grit,12/22/2010,38000000,252276927,214276927,6.6388665
Volver,3/16/2006,12899867,85582407,72682540,6.634363517081223
Bringing Down the House,3/7/2003,20000000,132675402,112675402,6.6337701
City Slickers,6/7/1991,27000000,179033791,152033791,6.630881148148148
WarGames,6/3/1983,12000000,79567667,67567667,6.630638916666666
Jackass Number Two,9/22/2006,11000000,72778712,61778712,6.616246545454546
Metropolis,5/26/2001,14500000,95789342,81289342,6.60616151724138
Baby Driver,6/28/2017,34000000,224511319,190511319,6.6032740882352945
गुरु,1/12/2007,4700000,31000000,26300000,6.595744680851064
공조,1/18/2017,8520000,56100000,47580000,6.584507042253521
Critters,4/11/1986,2000000,13167232,11167232,6.583616
48 Hrs.,12/7/1982,12000000,78868508,66868508,6.572375666666667
To Kill a Mockingbird,12/25/1962,2000000,13129846,11129846,6.564923
The Naked Gun: From the Files of Police Squad!,12/2/1988,12000000,78756177,66756177,6.56301475
Step Up 2: The Streets,2/14/2008,23000000,150816700,127816700,6.557247826086956
Silent House,1/21/2011,2000000,13101672,11101672,6.550836
Men in Black,7/2/1997,90000000,589390539,499390539,6.548783766666666
Up in the Air,9/5/2009,25000000,163670000,138670000,6.5468
2001: A Space Odyssey,4/10/1968,10500000,68700000,58200000,6.542857142857143
The Vow,2/5/2012,30000000,196114570,166114570,6.537152333333333
Stand by Me,8/22/1986,8000000,52287414,44287414,6.53592675
The Hunger Games: Catching Fire,11/15/2013,130000000,847423452,717423452,6.518641938461538
300,12/9/2006,65000000,422610419,357610419,6.501698753846154
Ice Age,3/10/2002,59000000,383257136,324257136,6.495883661016949
Friday the 13th Part VI: Jason Lives,8/1/1986,3000000,19472057,16472057,6.490685666666667
Rocky Balboa,12/20/2006,24000000,155721132,131721132,6.4883805
Giant,10/10/1956,5400000,35000000,29600000,6.481481481481482
The Twilight Saga: Breaking Dawn - Part 1,3/15/2011,110000000,712171856,602171856,6.4742896
Cavalcade,2/8/1933,1180280,7630000,6449720,6.46456772969126
Meet the Fockers,12/22/2004,80000000,516642939,436642939,6.4580367375
Shane,4/23/1953,3100000,20000000,16900000,6.451612903225806
The Firm,6/30/1993,42000000,270248367,228248367,6.434484928571429
Vicky Cristina Barcelona,8/15/2008,15000000,96408652,81408652,6.427243466666667
The Boy,1/22/2016,10000000,64188367,54188367,6.4188367
House at the End of the Street,9/21/2012,6900000,44287131,37387131,6.418424782608696
The Curse of the Were-Rabbit,9/4/2005,30000000,192452832,162452832,6.4150944
Tiny Furniture,11/12/2010,65000,416498,351498,6.4076615384615385
Bachelor Party,6/29/1984,6000000,38435947,32435947,6.4059911666666665
Mr. Smith Goes to Washington,10/19/1939,1500000,9600000,8100000,6.4
Martin Lawrence Live: Runteldat,8/1/2002,3000000,19184015,16184015,6.3946716666666665
Sex and the City,5/12/2008,65000000,415252786,350252786,6.3885044
The Addams Family,11/22/1991,30000000,191502426,161502426,6.3834142
Logan,2/28/2017,97000000,616801808,519801808,6.358781525773196
Spring Breakers,1/24/2013,5000000,31724284,26724284,6.3448568
Три богатыря и Шамаханская царица,12/29/2010,3000000,19010585,16010585,6.336861666666667
A Lonely Place to Die,4/9/2011,4000000,25345000,21345000,6.33625
Beneath the Planet of the Apes,5/1/1970,3000000,18999718,15999718,6.333239333333333
The Bourne Ultimatum,8/3/2007,70000000,442824138,372824138,6.326059114285714
Barbershop,4/1/2002,12000000,75781642,63781642,6.315136833333334
Pocahontas,6/14/1995,55000000,346079773,291079773,6.292359509090909
Le Dîner de cons,4/15/1998,12500000,78599508,66099508,6.28796064
The Thin Man,5/25/1934,226408,1423000,1196592,6.285113600226141
As Good as It Gets,12/19/1997,50000000,314178011,264178011,6.28356022
American Hustle,12/12/2013,40000000,251171807,211171807,6.279295175
Mystic River,10/7/2003,25000000,156822020,131822020,6.2728808
The Crow,5/11/1994,15000000,94000000,79000000,6.266666666666667
Hannah and Her Sisters,2/7/1986,6400000,40084041,33684041,6.26313140625
Harry Potter and the Order of the Phoenix,6/28/2007,150000000,938212738,788212738,6.254751586666667
A Farewell to Arms,12/8/1932,4,25,21,6.25
A Farewell to Arms,12/8/1932,4,25,21,6.25
Network,11/1/1976,3800000,23689877,19889877,6.234178157894737
Waiting...,10/7/2005,3000000,18637690,15637690,6.212563333333334
Saw VI,10/22/2009,11000000,68233629,57233629,6.203057181818182
Moonraker,6/26/1979,34000000,210308099,176308099,6.1855323235294115
7Aum Arivu,10/26/2011,16000000,98900000,82900000,6.18125
Quiet City,3/12/2007,2500,15425,12925,6.17
Super Troopers,1/18/2001,3000000,18492362,15492362,6.164120666666666
Ride Along,1/7/2014,25000000,153997819,128997819,6.15991276
О чём говорят мужчины,3/4/2010,1950000,12005838,10055838,6.15684
Claire of the Moon,9/18/1992,130000,799674,669674,6.151338461538462
The Da Vinci Code,5/17/2006,125000000,767820459,642820459,6.142563672
South Pacific,3/18/1958,6000000,36800000,30800000,6.133333333333334
Shrek 2,5/19/2004,150000000,919838758,769838758,6.132258386666667
Love Actually,9/7/2003,40000000,244931766,204931766,6.12329415
Back to the Future Part III,5/25/1990,40000000,244527583,204527583,6.113189575
The Possession,8/30/2012,14000000,85446075,71446075,6.103291071428571
Chocolat,12/14/2000,25000000,152500343,127500343,6.10001372
Wayne's World,2/14/1992,20000000,121697323,101697323,6.08486615
A Few Good Men,12/11/1992,40000000,243240178,203240178,6.08100445
The Ides of March,9/24/2011,12500000,75993061,63493061,6.07944488
Iron Man 3,4/18/2013,200000000,1215439994,1015439994,6.07719997
Harry Potter and the Prisoner of Azkaban,5/31/2004,130000000,789804554,659804554,6.075419646153846
Superbad,8/17/2007,20000000,121463226,101463226,6.0731613
GoldenEye,11/16/1995,58000000,352194034,294194034,6.072310931034483
Das Boot,9/16/1981,14000000,85000000,71000000,6.071428571428571
Bruce Almighty,5/23/2003,80000000,484572835,404572835,6.0571604375
Bridget Jones's Baby,9/14/2016,35000000,211952420,176952420,6.055783428571429
Gone Girl,10/1/2014,61000000,369330363,308330363,6.054596114754099
Kill Bill: Vol. 1,10/10/2003,30000000,180949000,150949000,6.031633333333334
Alvin and the Chipmunks,12/13/2007,60000000,361366633,301366633,6.022777216666666
Sweet Home Alabama,9/26/2002,30000000,180622424,150622424,6.020747466666666
Fast Times at Ridgemont High,8/13/1982,4500000,27092880,22592880,6.02064
The Hunger Games: Mockingjay - Part 1,11/18/2014,125000000,752100229,627100229,6.016801832
Meet the Parents,10/6/2000,55000000,330444045,275444045,6.008073545454545
More American Graffiti,8/3/1979,2500000,15014674,12514674,6.0058696
హ్యాపీ డేస్,9/28/2007,440141,2640850,2200709,6.000009087996801
Mean Streets,10/2/1973,500000,3000000,2500000,6.0
The Angrez,6/2/2006,50000,300000,250000,6.0
Limitless,3/8/2011,27000000,161849455,134849455,5.994424259259259
The Birdcage,3/8/1996,31000000,185260553,154260553,5.976146870967742
Yeh Jawaani Hai Deewani,5/31/2013,7700000,46000000,38300000,5.974025974025974
Harry Potter and the Goblet of Fire,11/5/2005,150000000,895921036,745921036,5.9728069066666665
Bellflower,4/16/2011,17000,101236,84236,5.955058823529412
Любовь-морковь 2,12/23/2008,3000000,17850711,14850711,5.950237
101 Dalmatians,11/17/1996,54000000,320689294,266689294,5.93869062962963
Romanzo criminale,9/30/2005,818418,4851244,4032826,5.927587125405355
Before Sunset,2/10/2004,2700000,15992615,13292615,5.923190740740741
Jeepers Creepers,7/1/2001,10000000,59217789,49217789,5.9217789
Bananas,4/28/1971,2000000,11833696,9833696,5.916848
Hotel Transylvania 2,9/21/2015,80000000,473226958,393226958,5.915336975
Spider-Man,5/1/2002,139000000,821708551,682708551,5.911572309352518
No Strings Attached,1/21/2011,25000000,147780440,122780440,5.9112176
Alvin and the Chipmunks: The Squeakquel,12/21/2009,75000000,443140005,368140005,5.9085334
The Man from Snowy River,3/2/1982,3500000,20659423,17159423,5.902692285714286
Room,10/16/2015,6000000,35401758,29401758,5.900293
Disturbia,4/12/2007,20000000,117760134,97760134,5.8880067
Jackass 3D,10/15/2010,20000000,117224271,97224271,5.86121355
New Kids Turbo,12/9/2010,1500000,8786756,7286756,5.857837333333333
Cat on a Hot Tin Roof,2/17/1958,3000000,17570324,14570324,5.8567746666666665
Sea of Love,9/15/1989,19000000,110879513,91879513,5.835763842105263
The Martian,9/30/2015,108000000,630161890,522161890,5.834832314814815
Murderball,7/22/2005,300000,1750211,1450211,5.834036666666667
Strangers on a Train,6/18/1951,1200000,7000000,5800000,5.833333333333333
The Trouble with Harry,10/3/1955,1200000,7000000,5800000,5.833333333333333
Benvenuti al nord,1/18/2012,6000000,35000000,29000000,5.833333333333333
My Cousin Vinny,3/13/1992,11000000,64088552,53088552,5.826232
Sherlock Holmes,12/23/2009,90000000,524028679,434028679,5.822540877777778
Ghostbusters II,6/15/1989,37000000,215394738,178394738,5.821479405405405
The Grand Budapest Hotel,2/26/2014,30000000,174600318,144600318,5.8200106
Stomp the Yard,5/16/2007,13000000,75511123,62511123,5.808547923076923
When Harry Met Sally...,7/21/1989,16000000,92823546,76823546,5.801471625
Trois,2/11/2000,200000,1160268,960268,5.80134
Big Momma's House,5/31/2000,30000000,173959438,143959438,5.798647933333333
Boys Don't Cry,9/2/1999,2000000,11540607,9540607,5.7703035
Transformers: Dark of the Moon,6/28/2011,195000000,1123746996,928746996,5.762805107692308
Halloween III: Season of the Witch,10/22/1982,2500000,14400000,11900000,5.76
Casper,5/26/1995,50000000,287928194,237928194,5.75856388
Planet of the Apes,2/7/1968,5800000,33395426,27595426,5.757832068965517
Commando,10/3/1985,10000000,57500000,47500000,5.75
Evil Dead,4/5/2013,17000000,97542952,80542952,5.737820705882353
Do the Right Thing,6/30/1989,6500000,37295445,30795445,5.7377607692307695
Birdman,8/27/2014,18000000,103215094,85215094,5.734171888888889
Witness,2/8/1985,12000000,68706993,56706993,5.72558275
Twelve Monkeys,12/29/1995,29500000,168840000,139340000,5.7233898305084745
英雄,12/19/2002,31000000,177394432,146394432,5.722401032258064
Mission: Impossible,5/22/1996,80000000,457696359,377696359,5.7212044875
Cinderella,3/12/2015,95000000,543514353,448514353,5.721203715789474
Jumping the Broom,5/6/2011,6600000,37710610,31110610,5.713728787878788
Conquest of the Planet of the Apes,6/29/1972,1700000,9700000,8000000,5.705882352941177
Theeviravaathi: The Terrorist,9/12/1998,24554,140021,115467,5.702573918709782
Match Point,10/26/2005,15000000,85306374,70306374,5.6870916
The Amityville Horror,4/15/2005,19000000,108047131,89047131,5.686691105263158
Signs,8/2/2002,72000000,408247917,336247917,5.670109958333334
Brooklyn,10/20/2015,11000000,62076141,51076141,5.643285545454545
Just Married,1/9/2003,18000000,101564935,83564935,5.642496388888889
The Pink Panther Strikes Again,12/15/1976,6000000,33833201,27833201,5.638866833333333
Crazy Heart,12/16/2009,7000000,39462438,32462438,5.637491142857143
The Social Network,9/30/2010,40000000,224920315,184920315,5.623007875
The Warriors,2/8/1979,4000000,22490039,18490039,5.62250975
New Jack City,3/8/1991,8500000,47624253,39124253,5.602853294117647
Woman in Gold,4/10/2015,11000000,61619773,50619773,5.601797545454546
The Pursuit of Happyness,12/14/2006,55000000,307077295,252077295,5.583223545454546
Transformers: Revenge of the Fallen,6/19/2009,150000000,836297228,686297228,5.575314853333333
Margin Call,9/28/2011,3500000,19504039,16004039,5.572582571428572
Ayan,4/3/2009,3230939,18000000,14769061,5.57113582150576
Vals Im Bashir,6/25/2008,2000000,11125849,9125849,5.5629245
The Intern,9/24/2015,35000000,194564672,159564672,5.558990628571428
The Little Mermaid,11/17/1989,40000000,222300000,182300000,5.5575
"\"バトル・ロワイア�?\"\"In the future\"",12/16/2000,4500000,25000000,20500000,5.555555555555555
Conan the Destroyer,6/29/1984,18000000,100000000,82000000,5.555555555555555
Skyfall,10/25/2012,200000000,1108561013,908561013,5.542805065
Star Trek IV: The Voyage Home,11/25/1986,24000000,133000000,109000000,5.541666666666667
Toy Story 2,10/30/1999,90000000,497366869,407366869,5.526298544444445
The Jungle Book,4/7/2016,175000000,966550600,791550600,5.523146285714286
Blue Jasmine,7/25/2013,18000000,99206215,81206215,5.511456388888889
Wonder Woman,5/30/2017,149000000,820580447,671580447,5.507251322147651
The Great Dictator,10/15/1940,2000000,11000000,9000000,5.5
Battle Beyond the Stars,9/8/1980,2000000,11000000,9000000,5.5
The Money Pit,3/15/1986,10000000,54999651,44999651,5.4999651
Return to Never Land,2/14/2002,20000000,109862682,89862682,5.4931341
Hable con ella,3/14/2002,9285469,51001550,41716081,5.49261970504667
Desperately Seeking Susan,3/29/1985,5000000,27400000,22400000,5.48
My Week with Marilyn,10/17/2011,6400000,35057696,28657696,5.477765
Jerry Maguire,12/6/1996,50000000,273552592,223552592,5.47105184
Superman,12/13/1978,55000000,300218018,245218018,5.458509418181818
Predator,6/11/1987,18000000,98235548,80235548,5.457530444444444
The Fast and the Furious,6/22/2001,38000000,207283925,169283925,5.454840131578948
劇場版ポケットモンスター ミュウツーの逆襲,7/18/1998,30000000,163644662,133644662,5.454822066666667
Attack of the 50 Foot Woman,5/19/1958,88000,480000,392000,5.454545454545454
For Me and My Gal,10/21/1942,802000,4371000,3569000,5.450124688279302
L'arnacoeur,3/17/2010,8700000,47355187,38655187,5.443124942528736
Next Friday,1/12/2000,11000000,59827328,48827328,5.438848
Exodus,3/27/1960,4000000,21750000,17750000,5.4375
Bhaag Milkha Bhaag,7/12/2013,4600000,25000000,20400000,5.434782608695652
The Dark Knight,7/16/2008,185000000,1004558444,819558444,5.430045643243243
�?காதல�?கண்மணி,4/17/2015,940000,5100000,4160000,5.425531914893617
Elf,10/9/2003,32000000,173398518,141398518,5.4187036875
Babel,9/8/2006,25000000,135330182,110330182,5.41320728
Star Wars: Episode II - Attack of the Clones,5/15/2002,120000000,649398328,529398328,5.411652733333334
Quartet,9/8/2012,11000000,59520298,48520298,5.410936181818182
Movie 43,1/1/2013,6000000,32438988,26438988,5.406498
Cool Hand Luke,6/22/1967,3000000,16217773,13217773,5.405924333333333
The Ugly Truth,7/24/2009,38000000,205298907,167298907,5.402602815789474
Dracula,11/13/1992,40000000,215862692,175862692,5.3965673
Rio,4/3/2011,90000000,484635760,394635760,5.384841777777778
Clerks II,5/25/2006,5000000,26888376,21888376,5.3776752
Escape from Alcatraz,6/22/1979,8000000,43000000,35000000,5.375
Twister,5/10/1996,92000000,494471524,402471524,5.374690478260869
House of Usher,6/21/1960,270000,1450000,1180000,5.37037037037037
Legends of the Fall,12/16/1994,30000000,160638883,130638883,5.354629433333334
Gifted,4/12/2017,7000000,37461045,30461045,5.351577857142857
Halloween,8/31/2007,15000000,80253908,65253908,5.3502605333333335
Hot Shots! Part Deux,5/21/1993,25000000,133752825,108752825,5.350113
Those Magnificent Men in Their Flying Machines or How I Flew from London to Paris in 25 hours 11 minutes,6/3/1965,5600000,29950000,24350000,5.348214285714286
What Women Want,12/15/2000,70000000,374111707,304111707,5.344452957142857
Safety Not Guaranteed,6/8/2012,750000,4007792,3257792,5.343722666666666
27 Dresses,1/10/2008,30000000,160259319,130259319,5.3419773
Toy Story 3,6/16/2010,200000000,1066969703,866969703,5.334848515
The Derby Stallion,7/4/2005,750000,4000000,3250000,5.333333333333333
Pirates of the Caribbean: Dead Man's Chest,6/20/2006,200000000,1065659812,865659812,5.32829906
Jason Goes to Hell: The Final Friday,8/13/1993,3000000,15938065,12938065,5.312688333333333
Step Up 3D,8/4/2010,30000000,159291809,129291809,5.309726966666667
Ocean's Eleven,12/7/2001,85000000,450717150,365717150,5.302554705882353
Sinister 2,8/19/2015,10000000,52882018,42882018,5.2882018
Uncle Buck,8/16/1989,15000000,79258538,64258538,5.283902533333333
Rogue One: A Star Wars Story,12/14/2016,200000000,1056057273,856057273,5.280286365
The Call,3/14/2013,13000000,68572378,55572378,5.274798307692308
Gnomeo & Juliet,1/13/2011,36000000,189712432,153712432,5.269789777777778
�?깡패 같은 애인,5/20/2010,800000,4214668,3414668,5.268335
Hitch,2/10/2005,70000000,368100420,298100420,5.258577428571429
Top Hat,9/6/1935,609000,3202000,2593000,5.257799671592775
Dr. Strangelove or: How I Learned to Stop Worrying and Love the Bomb,1/29/1964,1800000,9440272,7640272,5.244595555555556
8 Mile,11/8/2002,41000000,215000000,174000000,5.2439024390243905
Rang De Basanti,1/26/2006,2200000,11502151,9302151,5.228250454545455
P.S. I Love You,11/15/2007,30000000,156835339,126835339,5.2278446333333335
A Beautiful Mind,12/11/2001,60000000,313542341,253542341,5.2257056833333335
Night at the Museum,10/20/2006,110000000,574480841,464480841,5.2225531
Argo,10/11/2012,44500000,232324128,187824128,5.220766921348314
Flight,11/2/2012,31000000,161772375,130772375,5.21846370967742
Cape Fear,11/15/1991,35000000,182300000,147300000,5.208571428571428
Devil's Due,1/8/2014,7000000,36433975,29433975,5.204853571428571
Drive,8/6/2011,15000000,78054825,63054825,5.203655
Battle for the Planet of the Apes,6/15/1973,1700000,8844595,7144595,5.2027029411764705
The Elephant Man,10/2/1980,5000000,26010864,21010864,5.2021728
Super 8,6/8/2011,50000000,260095987,210095987,5.20191974
Terminator 2: Judgment Day,7/1/1991,100000000,520000000,420000000,5.2
Dunkirk,7/19/2017,100000000,519876949,419876949,5.19876949
The Mummy,4/16/1999,80000000,415885488,335885488,5.1985686
Transformers: Age of Extinction,6/25/2014,210000000,1091405097,881405097,5.1971671285714285
42nd Street,2/2/1933,439000,2281000,1842000,5.195899772209567
The Ring,10/18/2002,48000000,249348933,201348933,5.1947694375
Porky's II: The Next Day,6/24/1983,6500000,33759266,27259266,5.193733230769231
Rise of the Planet of the Apes,8/3/2011,93000000,482860185,389860185,5.192045
Spy Kids 3-D: Game Over,7/25/2003,38000000,197011982,159011982,5.184525842105264
Urban Legend,9/25/1998,14000000,72527595,58527595,5.1805425
Whale Rider,1/30/2003,8000000,41400000,33400000,5.175
Jackson County Jail,3/31/1976,445000,2300000,1855000,5.168539325842697
Inception,7/14/2010,160000000,825532764,665532764,5.159579775
Madagascar 3: Europe's Most Wanted,6/6/2012,145000000,746921274,601921274,5.1511812
Finding Dory,6/16/2016,200000000,1028570889,828570889,5.142854445
The Enforcer,12/20/1976,9000000,46236000,37236000,5.137333333333333
JFK,12/20/1991,40000000,205405498,165405498,5.13513745
シン・ゴジラ,7/29/2016,15000000,77000000,62000000,5.133333333333334
Alice in Wonderland,3/3/2010,200000000,1025491110,825491110,5.12745555
The Smurfs,7/29/2011,110000000,563749323,453749323,5.124993845454545
Spaced Invaders,4/27/1990,3000000,15369573,12369573,5.123191
The DUFF,2/20/2015,8500000,43528634,35028634,5.1210157647058825
Kingsman: The Secret Service,1/29/2015,81000000,414351546,333351546,5.115451185185186
Apollo 18,7/20/2011,5000000,25562924,20562924,5.1125848
ആനന്ദം,10/21/2016,450000,2300000,1850000,5.111111111111111
Maze Runner: The Scorch Trials,9/9/2015,61000000,311256926,250256926,5.102572557377049
Crossroads,2/15/2002,12000000,61141030,49141030,5.095085833333333
Waiting to Exhale,12/22/1995,16000000,81452156,65452156,5.09075975
United 93,4/28/2006,15000000,76286096,61286096,5.085739733333333
A View to a Kill,5/24/1985,30000000,152427960,122427960,5.080932
The Mighty Ducks,10/1/1992,10000000,50752337,40752337,5.0752337
Life of Pi,11/20/2012,120000000,609016565,489016565,5.0751380416666665
Kill Bill: Vol. 2,4/16/2004,30000000,152159461,122159461,5.071982033333334
In the Name of the Father,12/12/1993,13000000,65796862,52796862,5.0612970769230765
Shaft's Big Score!,6/8/1972,1978000,10000000,8022000,5.055611729019211
Diary of a Wimpy Kid,3/19/2010,15000000,75700498,60700498,5.046699866666667
功夫,2/10/2004,20000000,100914445,80914445,5.04572225
The Way Way Back,6/6/2013,4600000,23198652,18598652,5.043185217391304
Muriel's Wedding,9/29/1994,3000000,15119639,12119639,5.039879666666667
Midnight in Paris,5/11/2011,30000000,151119219,121119219,5.0373073
The Net,7/28/1995,22000000,110627965,88627965,5.028543863636363
Die Hard,7/15/1988,28000000,140767956,112767956,5.027427
Der Untergang,9/8/2004,18339750,92180910,73841160,5.026290434711488
Tammy,7/2/2014,20000000,100525432,80525432,5.0262716
The Perfect Guy,9/11/2015,12000000,60273173,48273173,5.022764416666667
Avengers: Age of Ultron,4/22/2015,280000000,1405403694,1125403694,5.019298907142857
Life of Brian,8/17/1979,4000000,20045115,16045115,5.01127875
The Longest Day,9/25/1962,10000000,50100000,40100000,5.01
Fast Five,4/20/2011,125000000,626137675,501137675,5.0091014
Resident Evil: Afterlife,9/9/2010,60000000,300228084,240228084,5.0038014
Chinatown,6/20/1974,6000000,30000000,24000000,5.0
The Miracle Worker,5/22/1962,500000,2500000,2000000,5.0
Spartacus,10/6/1960,12000000,60000000,48000000,5.0
بچه‌ها�?آسمان,8/1/1997,180000,900000,720000,5.0
Airport '77,3/11/1977,6000000,30000000,24000000,5.0
East of Eden,3/9/1955,1,5,4,5.0
Rangeela,1/1/1995,2800000,14000000,11200000,5.0
The Signal,2/22/2007,50000,249905,199905,4.9981
Pet Sematary,4/21/1989,11500000,57469467,45969467,4.997344956521739
Life in a Day,1/27/2011,45202,225861,180659,4.996703685677625
Chicken Run,6/21/2000,45000000,224834564,179834564,4.996323644444445
Shrek the Third,5/17/2007,160000000,798958165,638958165,4.99348853125
올드보이,1/1/2003,3000000,14980005,11980005,4.993335
The Lorax,3/1/2012,70000000,348840316,278840316,4.983433085714286
Stay Hungry,4/23/1976,5000000,24854765,19854765,4.970953
The Help,8/9/2011,25000000,124272124,99272124,4.97088496
Identity Thief,2/7/2013,35000000,173965010,138965010,4.970428857142857
Race,2/19/2016,5000000,24804129,19804129,4.9608258
Troll,1/17/1986,1100000,5450815,4350815,4.955286363636364
The Fate of the Furious,4/12/2017,250000000,1238764765,988764765,4.95505906
Kids,7/28/1995,1500000,7412216,5912216,4.941477333333333
My Big Fat Greek Wedding 2,3/23/2016,18000000,88923251,70923251,4.940180611111111
Escape from the Planet of the Apes,5/20/1971,2500000,12348905,9848905,4.939562
Fast & Furious 6,5/6/2013,160000000,788679850,628679850,4.9292490625
Erin Brockovich,3/17/2000,52000000,256271286,204271286,4.928293961538461
The Matrix Reloaded,5/15/2003,150000000,738599701,588599701,4.923998006666666
The Other Woman,4/16/2014,40000000,196781193,156781193,4.919529825
Child's Play,11/8/1988,9000000,44196684,35196684,4.910742666666667
Dressed to Kill,6/25/1980,6500000,31899000,25399000,4.907538461538461
Hide and Seek,1/27/2005,25000000,122644820,97644820,4.9057928
Tape,1/26/2001,100000,490475,390475,4.90475
Inside Out,6/9/2015,175000000,857611174,682611174,4.90063528
Nanny McPhee,10/21/2005,25000000,122489822,97489822,4.89959288
50/50,9/30/2011,8000000,39187783,31187783,4.898472875
Shark Tale,9/20/2004,75000000,367275019,292275019,4.897000253333333
American Psycho,4/13/2000,7000000,34266564,27266564,4.895223428571429
Beetlejuice,2/29/1988,15000000,73326666,58326666,4.8884444
Licence to Kill,7/7/1989,32000000,156167015,124167015,4.88021921875
Raising Arizona,3/1/1987,6000000,29180280,23180280,4.86338
Kung Fu Panda,6/4/2008,130000000,631744560,501744560,4.859573538461539
What Happens in Vegas,5/7/2008,35000000,170000000,135000000,4.857142857142857
Groundhog Day,2/11/1993,14600000,70906973,56306973,4.85664198630137
Rio 2,3/19/2014,103000000,500188435,397188435,4.856198398058252
Daddy's Home,12/25/2015,50000000,242786137,192786137,4.85572274
Bienvenue chez les ch'tis,1/9/2008,11000000,53191886,42191886,4.835626
Star Trek III: The Search for Spock,5/31/1984,18000000,87000000,69000000,4.833333333333333
Jaane Tu... Ya Jaane Na,7/4/2008,2300000,11100000,8800000,4.826086956521739
The Guns of Navarone,4/27/1961,6000000,28900000,22900000,4.816666666666666
Friday the 13th,2/11/2009,19000000,91379051,72379051,4.809423736842105
Night of the Comet,11/16/1984,3000000,14418922,11418922,4.806307333333334
The Gauntlet,12/21/1977,5500000,26414658,20914658,4.802665090909091
Arundhati,1/16/2009,2915739,14000000,11084261,4.801527160009864
Last Vegas,10/31/2013,28000000,134402450,106402450,4.8000875
How Green Was My Valley,10/28/1941,1250000,6000000,4750000,4.8
21 Jump Street,3/12/2012,42000000,201585328,159585328,4.7996506666666665
The Angry Birds Movie,5/11/2016,73000000,349779543,276779543,4.791500589041096
Mission: Impossible - Ghost Protocol,12/7/2011,145000000,694713380,549713380,4.79112675862069
Parental Guidance,12/25/2012,25000000,119772232,94772232,4.79088928
Show Boat,7/13/1951,2300000,11000000,8700000,4.782608695652174
The Unborn,1/9/2009,16000000,76514050,60514050,4.782128125
The Living Daylights,6/29/1987,40000000,191185897,151185897,4.779647425
About a Boy,4/26/2002,27000000,129000000,102000000,4.777777777777778
Cast Away,12/22/2000,90000000,429632142,339632142,4.773690466666666
The Omen,6/6/2006,25000000,119188334,94188334,4.76753336
The Big Short,12/11/2015,28000000,133346506,105346506,4.762375214285714
Cheaper by the Dozen,12/24/2003,40000000,190212113,150212113,4.755302825
Precious,11/6/2009,10000000,47536959,37536959,4.7536959
Phenomenon,7/5/1996,32000000,152036382,120036382,4.7511369375
Lola rennt,8/20/1998,1530000,7267585,5737585,4.750055555555556
The Green Mile,12/10/1999,60000000,284600000,224600000,4.743333333333333
Hard to Kill,2/9/1990,10000000,47410000,37410000,4.741
American Gigolo,2/8/1980,4800000,22743674,17943674,4.738265416666667
Blue Valentine,12/27/2010,3500000,16566240,13066240,4.733211428571429
Transformers,6/27/2007,150000000,709709780,559709780,4.7313985333333335
Prince of Darkness,10/23/1987,3000000,14182492,11182492,4.727497333333333
ДухLess,10/4/2012,2800000,13218980,10418980,4.721064285714286
Paddington,11/27/2014,55000000,259207227,204207227,4.712858672727273
Who Framed Roger Rabbit,6/21/1988,70000000,329803958,259803958,4.711485114285714
Miss Congeniality,12/14/2000,45000000,212000000,167000000,4.711111111111111
Austin Powers in Goldmember,7/26/2002,63000000,296655431,233655431,4.7088163650793655
Final Destination 3,2/10/2006,25000000,117719158,92719158,4.70876632
God's Not Dead 2,4/1/2016,5000000,23507567,18507567,4.7015134
Ernest Saves Christmas,11/11/1988,6000000,28202109,22202109,4.7003515
American Reunion,4/4/2012,50000000,234989584,184989584,4.69979168
The Eye,2/1/2008,12000000,56309766,44309766,4.6924805
Frida,8/29/2002,12000000,56298474,44298474,4.6915395
Creed,11/25/2015,37000000,173567581,136567581,4.691015702702702
Auf der anderen Seite,9/27/2007,3800000,17804565,14004565,4.685411842105263
The King and I,6/29/1956,4550000,21300000,16750000,4.681318681318682
Pirates of the Caribbean: The Curse of the Black Pearl,7/9/2003,140000000,655011224,515011224,4.6786516
Love & Friendship,5/27/2016,3000000,14016568,11016568,4.672189333333334
The SpongeBob SquarePants Movie,11/14/2004,30000000,140161792,110161792,4.672059733333334
Spellbound,12/28/1945,1500000,7000000,5500000,4.666666666666667
Goodbye Pork Pie,2/5/1981,300000,1400000,1100000,4.666666666666667
"\"धू�?�?\"\"To avenge his father's death\"",12/18/2013,19500000,91000000,71500000,4.666666666666667
Vaaranam Aayiram,11/14/2008,3000000,14000000,11000000,4.666666666666667
Lawrence of Arabia,12/10/1962,15000000,69995385,54995385,4.666359
Tales from the Darkside: The Movie,5/3/1990,3500000,16324573,12824573,4.664163714285714
Rebecca,4/12/1940,1288000,6000000,4712000,4.658385093167702
The Final Destination,8/26/2009,40000000,186167139,146167139,4.654178475
Vizontele Tuuba,1/21/2004,3000000,13954476,10954476,4.651492
Weekend at Bernie's,7/5/1989,6500000,30218387,23718387,4.648982615384615
Empire,12/6/2002,4000000,18591272,14591272,4.647818
The Hills Have Eyes,3/10/2006,15000000,69623713,54623713,4.641580866666667
The Butler,8/16/2013,25000000,115922175,90922175,4.636887
Lolita,6/13/1962,2000000,9250000,7250000,4.625
Set It Off,11/6/1996,9000000,41590886,32590886,4.621209555555556
Miracles from Heaven,3/17/2016,16000000,73883359,57883359,4.6177099375
Captain America: Civil War,4/27/2016,250000000,1153304495,903304495,4.61321798
La Guerre du feu,12/15/1981,12000000,55260558,43260558,4.6050465
Source Code,3/30/2011,32000000,147332697,115332697,4.60414678125
K-9,4/28/1989,17000000,78247647,61247647,4.602802764705882
Dear John,2/4/2010,25000000,114977104,89977104,4.59908416
Scary Movie 3,10/24/2003,48000000,220673217,172673217,4.5973586875
Boom Town,8/30/1940,2000000,9172000,7172000,4.586
Tau man ji D,5/12/2005,1549000,7096000,5547000,4.581020012911556
Broken Flowers,5/17/2005,10000000,45742101,35742101,4.5742101
Sinbad and the Eye of the Tiger,7/15/1977,3500000,16000000,12500000,4.571428571428571
Alvin and the Chipmunks: Chipwrecked,12/14/2011,75000000,342695435,267695435,4.569272466666667
The Birds,3/28/1963,2500000,11403529,8903529,4.5614116
Shrek Forever After,5/16/2010,165000000,752600867,587600867,4.561217375757575
Inglourious Basterds,8/18/2009,70000000,319131050,249131050,4.559015
Remember the Titans,9/29/2000,30000000,136706683,106706683,4.556889433333334
Trick,7/23/1999,450000,2049595,1599595,4.554655555555556
Ёлки,12/12/2010,5000000,22772019,17772019,4.5544038
Nightcrawler,10/23/2014,8500000,38697217,30197217,4.552613764705883
Guardians of the Galaxy,7/30/2014,170000000,773328629,603328629,4.548991935294118
Mission: Impossible - Rogue Nation,7/23/2015,150000000,682330139,532330139,4.548867593333333
Dragon: The Bruce Lee Story,5/7/1993,14000000,63513743,49513743,4.536695928571429
Major League,2/16/1989,11000000,49797148,38797148,4.527013454545455
You Can't Take It With You,8/23/1938,1644736,7433101,5788365,4.5193277218957935
Taxi 3,1/29/2003,14500000,65497208,50997208,4.517048827586207
تین بہادر,5/21/2015,143149,645135,501986,4.506737734807787
A Perfect World,11/24/1993,30000000,135130999,105130999,4.504366633333333
Journey 2: The Mysterious Island,1/19/2012,79000000,355692760,276692760,4.50244
Prophecy,1/1/1979,12000000,54000000,42000000,4.5
A Walk in the Woods,9/2/2015,8000000,35991087,27991087,4.498885875
Who's Afraid of Virginia Woolf?,6/21/1966,7500000,33736689,26236689,4.4982252
Fantastic Beasts and Where to Find Them,11/16/2016,180000000,809342332,629342332,4.496346288888889
Hansel & Gretel: Witch Hunters,1/17/2013,50000000,224803475,174803475,4.4960695
A Serious Man,10/2/2009,7000000,31430334,24430334,4.490047714285715
Nerve,7/27/2016,19000000,85241496,66241496,4.48639452631579
War of the Worlds,6/28/2005,132000000,591739379,459739379,4.482874083333333
Coal Miner's Daughter,3/7/1980,15000000,67182787,52182787,4.478852466666667
The First Wives Club,9/20/1996,26000000,116400000,90400000,4.476923076923077
Under Siege,10/8/1992,35000000,156563139,121563139,4.473232542857143
The Princess Diaries,8/3/2001,37000000,165335153,128335153,4.468517648648649
The Rock,6/6/1996,75000000,335062621,260062621,4.467501613333333
Sabrina,9/28/1954,2238813,10000000,7761187,4.466652641377372
"\"劇場版ポケットモンスター 幻のポケモン ルギア爆�?\"\"Ash Ketchum must put his skill to the test when he attempts to save the world from destruction. The Greedy Pokemon collector Lawrence III throws the universe into chaos after disrupting the balance of nature by capturing one of the Pokemon birds that rule the elements of fire\"",7/17/1999,30000000,133949270,103949270,4.464975666666667
When a Stranger Calls,2/3/2006,15000000,66966987,51966987,4.4644658
Missing in Action 2: The Beginning,3/1/1985,2410000,10755447,8345447,4.462841078838174
Non-Stop,1/26/2014,50000000,222809600,172809600,4.456192
Recess: School's Out,1/27/2001,10000000,44460850,34460850,4.446085
Never Say Never Again,10/7/1983,36000000,160000000,124000000,4.444444444444445
A Streetcar Named Desire,9/18/1951,1800000,8000000,6200000,4.444444444444445
Hannah Montana: The Movie,4/10/2009,35000000,155545279,120545279,4.444150828571429
Gladiator,5/1/2000,103000000,457640427,354640427,4.443110941747573
Upstream Color,4/5/2013,100000,444098,344098,4.44098
Papillon,12/13/1973,12000000,53267000,41267000,4.438916666666667
Down and Out in Beverly Hills,1/31/1986,14000000,62134225,48134225,4.438158928571428
John Wick,10/22/2014,20000000,88761661,68761661,4.43808305
Kung Fu Panda 2,5/25/2011,150000000,665692281,515692281,4.43794854
Gosford Park,11/7/2001,19800000,87754044,67954044,4.432022424242424
He's Just Not That Into You,2/6/2009,40000000,177259441,137259441,4.431486025
Voyage to the Bottom of the Sea,7/12/1961,1580000,7000000,5420000,4.430379746835443
In the Line of Fire,7/8/1993,40000000,176997168,136997168,4.4249292
Burn After Reading,9/5/2008,37000000,163720069,126720069,4.42486672972973
Jagten,8/28/2012,3800000,16800000,13000000,4.421052631578948
Runaway Bride,7/30/1999,70000000,309457509,239457509,4.420821557142857
The Mummy Returns,4/28/2001,98000000,433013274,335013274,4.418502795918367
Agneepath,1/25/2012,11097000,49028000,37931000,4.4181310264035325
Spotlight,11/6/2015,20000000,88346473,68346473,4.41732365
Tremors,1/19/1990,11000000,48572000,37572000,4.415636363636364
Memento,10/11/2000,9000000,39723096,30723096,4.413677333333333
Four Lions,5/7/2010,967686,4270000,3302314,4.412588380941751
Delhi Belly,7/1/2011,4090000,18035000,13945000,4.409535452322738
Singam,5/28/2010,2200000,9700000,7500000,4.409090909090909
The Truman Show,6/4/1998,60000000,264118201,204118201,4.401970016666667
Mighty Morphin Power Rangers: The Movie,6/30/1995,15000000,66000000,51000000,4.4
Planes,8/9/2013,50000000,219788712,169788712,4.39577424
Hacksaw Ridge,10/7/2016,40000000,175302354,135302354,4.38255885
El laberinto del fauno,5/27/2006,19000000,83258226,64258226,4.382011894736842
Go,4/9/1999,6500000,28451622,21951622,4.377172615384615
Mission: Impossible II,5/24/2000,125000000,546388105,421388105,4.37110484
Fletch Lives,3/17/1989,8045760,35150960,27105200,4.3688800063636
The Fury,3/10/1978,5500000,24000000,18500000,4.363636363636363
Unknown,2/16/2011,30000000,130786397,100786397,4.359546566666666
葉問3,12/19/2015,36000000,156844753,120844753,4.356798694444445
The Day After Tomorrow,5/26/2004,125000000,544272402,419272402,4.354179216
One Hour Photo,8/21/2002,12000000,52223306,40223306,4.3519421666666664
Underworld,9/19/2003,22000000,95708457,73708457,4.350384409090909
In Time,10/27/2011,40000000,173930596,133930596,4.3482649
Mr. & Mrs. Smith,6/7/2005,110000000,478207520,368207520,4.347341090909091
Epic Movie,1/25/2007,20000000,86865564,66865564,4.3432782
The Dark Knight Rises,7/16/2012,250000000,1084939099,834939099,4.339756396
Central Intelligence,6/15/2016,50000000,216972543,166972543,4.33945086
The Pelican Brief,12/16/1993,45000000,195268056,150268056,4.339290133333333
Zombieland,10/7/2009,23600000,102391382,78791382,4.338617881355932
The Croods,3/20/2013,135000000,585178928,450178928,4.334658725925926
Torn Curtain,7/13/1966,3000000,13000000,10000000,4.333333333333333
Arrival,11/10/2016,47000000,203388186,156388186,4.327408212765958
Pride & Prejudice,9/16/2005,28000000,121147947,93147947,4.326712392857143
Scent of a Woman,12/23/1992,31000000,134095253,103095253,4.325653322580645
Traffic,12/27/2000,48000000,207515725,159515725,4.323244270833333
紅番區,1/30/1995,7500000,32392047,24892047,4.3189396
Guardians of the Galaxy Vol. 2,4/19/2017,200000000,863416141,663416141,4.317080705
Atonement,8/29/2007,30000000,129266061,99266061,4.3088687
To Rome with Love,4/20/2012,17000000,73244881,56244881,4.308522411764706
Friends with Benefits,7/21/2011,35000000,150483765,115483765,4.299536142857143
Candyman,10/16/1992,6000000,25792310,19792310,4.298718333333333
Hook,12/11/1991,70000000,300854823,230854823,4.297926042857143
Over the Hedge,4/22/2006,80000000,343397247,263397247,4.2924655875
Lo imposible,9/9/2012,42000000,180274123,138274123,4.292241023809524
Jaws 3-D,3/16/1983,20500000,87987055,67487055,4.2920514634146345
John Wick: Chapter 2,2/8/2017,40000000,171539887,131539887,4.288497175
Moana,11/23/2016,150000000,643034466,493034466,4.28689644
The Fly,7/16/1958,700000,3000000,2300000,4.285714285714286
Wag the Dog,12/25/1997,15000000,64256513,49256513,4.283767533333333
The Raven,1/25/1963,350000,1499275,1149275,4.2836428571428575
28 Weeks Later,4/26/2007,15000000,64238440,49238440,4.282562666666666
The Danish Girl,11/27/2015,15000000,64191523,49191523,4.279434866666667
The Village,7/30/2004,60000000,256697520,196697520,4.278292
Closer,12/1/2004,27000000,115505027,88505027,4.277963962962963
San Andreas,5/27/2015,110000000,470490832,360490832,4.277189381818181
Pokémon 3: The Movie,7/8/2000,16000000,68411275,52411275,4.2757046875
Pokémon 3: The Movie,7/8/2000,16000000,68411275,52411275,4.2757046875
Fast & Furious,4/2/2009,85000000,363164265,278164265,4.272520764705883
The Blues Brothers,6/17/1980,27000000,115229890,88229890,4.267773703703703
The Sugarland Express,4/5/1974,3000000,12800000,9800000,4.266666666666667
Moonrise Kingdom,5/16/2012,16000000,68263166,52263166,4.266447875
Suicide Squad,8/2/2016,175000000,745600054,570600054,4.2605717371428575
Into the Woods,12/25/2014,50000000,212902372,162902372,4.25804744
Step Up Revolution,7/26/2012,33000000,140470746,107470746,4.2566892727272725
Django Unchained,12/25/2012,100000000,425368238,325368238,4.25368238
Indiana Jones and the Kingdom of the Crystal Skull,5/21/2008,185000000,786636033,601636033,4.252086664864865
Dumb and Dumber To,11/12/2014,40000000,169837010,129837010,4.24592525
The In-Laws,6/15/1979,9000000,38200000,29200000,4.2444444444444445
Cujo,8/10/1983,5000000,21200000,16200000,4.24
Freaky Friday,8/3/2003,26000000,110230332,84230332,4.239628153846154
My Fair Lady,10/21/1964,17000000,72070731,55070731,4.239454764705882
Lincoln,11/9/2012,65000000,275293450,210293450,4.2352838461538465
Dabba,9/19/2013,1000000,4235151,3235151,4.235151
The Fourth Kind,11/6/2009,10000000,42333295,32333295,4.2333295
The Valley of Decision,6/1/1945,2160000,9132000,6972000,4.227777777777778
Spy Kids,3/18/2001,35000000,147934180,112934180,4.226690857142857
St. Vincent,10/9/2014,13000000,54837234,41837234,4.218248769230769
Dhoom 2,11/24/2006,11000000,46396427,35396427,4.217857
Hotel Transylvania,9/20/2012,85000000,358375603,273375603,4.216183564705882
Maleficent,5/28/2014,180000000,758539785,578539785,4.214109916666667
Death Warrant,9/14/1990,4000000,16853487,12853487,4.21337175
The Best Man Holiday,11/15/2013,17000000,71625195,54625195,4.213246764705882
The SpongeBob Movie: Sponge Out of Water,2/5/2015,74000000,311594032,237594032,4.210730162162162
The 40 Year Old Virgin,8/11/2005,26000000,109449237,83449237,4.209586038461539
American Wedding,8/1/2003,55000000,231449203,176449203,4.208167327272728
Premonition,2/8/2007,20000000,84146832,64146832,4.2073416
I Am Sam,12/28/2001,22000000,92542418,70542418,4.206473545454545
Captain America: The Winter Soldier,3/20/2014,170000000,714766572,544766572,4.204509247058824
The Nightmare Before Christmas,10/9/1993,18000000,75634409,57634409,4.201911611111111
How to Train Your Dragon 2,6/12/2014,145000000,609123048,464123048,4.200848606896551
Up,5/13/2009,175000000,735099082,560099082,4.200566182857143
Veer-Zaara,11/12/2004,7000000,29385320,22385320,4.197902857142857
Fanaa,5/26/2006,5300000,22175908,16875908,4.18413358490566
Dawn of the Planet of the Apes,6/26/2014,170000000,710644566,540644566,4.180262152941176
Iron Man,4/30/2008,140000000,585174222,445174222,4.179815871428572
Chef,5/8/2014,11000000,45967935,34967935,4.178903181818182
The Wood,7/16/1999,6000000,25059640,19059640,4.176606666666666
Hellraiser: Bloodline,3/8/1996,4000000,16675000,12675000,4.16875
Hitman,11/21/2007,24000000,99965753,75965753,4.165239708333333
Valentine's Day,2/10/2010,52000000,216485654,164485654,4.163185653846154
The Town,9/15/2010,37000000,154026136,117026136,4.162868540540541
Hancock,7/1/2008,150000000,624029371,474029371,4.160195806666667
Ratatouille,6/22/2007,150000000,623722818,473722818,4.15815212
Not Another Teen Movie,12/7/2001,16000000,66468332,50468332,4.15427075
Stop Making Sense,11/16/1984,1200000,4978922,3778922,4.149101666666667
Doctor Dolittle,6/22/1998,71000000,294456605,223456605,4.147276126760564
Out of Africa,12/20/1985,31000000,128499205,97499205,4.14513564516129
Om Shanti Om,11/7/2007,9100000,37707444,28607444,4.143675164835165
Bridge of Spies,10/15/2015,40000000,165478348,125478348,4.1369587
Throw Momma from the Train,12/11/1987,14000000,57915972,43915972,4.136855142857143
Trainspotting,2/23/1996,4000000,16491080,12491080,4.12277
Hard Target,8/20/1993,18000000,74189677,56189677,4.121648722222222
Doctor Strange,10/25/2016,165000000,677718395,512718395,4.107384212121212
Tumbleweeds,11/28/1999,312000,1281176,969176,4.106333333333334
Krampus,11/26/2015,15000000,61548707,46548707,4.103247133333333
Austin Powers: International Man of Mystery,5/2/1997,16500000,67683989,51183989,4.102059939393939
The Man Who Knew Too Much,6/1/1956,2500000,10250000,7750000,4.1
Inside Man,3/23/2006,45000000,184376254,139376254,4.097250088888889
Along Came Polly,1/16/2004,42000000,171963386,129963386,4.094366333333333
National Lampoon's Vacation,7/28/1983,15000000,61399552,46399552,4.093303466666667
Interstellar,11/5/2014,165000000,675120017,510120017,4.0916364666666665
Panic Room,3/29/2002,48000000,196397415,148397415,4.0916128125
English Vinglish,9/14/2012,2840000,11620000,8780000,4.091549295774648
The Hobbit: An Unexpected Journey,11/26/2012,250000000,1021103568,771103568,4.084414272
The Hunger Games: Mockingjay - Part 2,11/18/2015,160000000,653428261,493428261,4.08392663125
The Great Gatsby,3/27/1974,6500000,26533200,20033200,4.082030769230769
Suspicion,11/14/1941,1103000,4500000,3397000,4.0797824116047146
No Good Deed,9/10/2014,13200000,53830415,40630415,4.078061742424242
RoboCop,7/17/1987,13000000,53000000,40000000,4.076923076923077
xXx: Return of Xander Cage,1/13/2017,85000000,346147658,261147658,4.072325388235294
Marley & Me,12/25/2008,60000000,244082376,184082376,4.0680396
Die Hard: With a Vengeance,5/19/1995,90000000,366101666,276101666,4.067796288888889
Flightplan,9/22/2005,55000000,223387299,168387299,4.061587254545454
San Francisco,6/26/1936,1300000,5273000,3973000,4.056153846153846
Bill & Ted's Excellent Adventure,2/17/1989,10000000,40485039,30485039,4.0485039
Swimfan,9/6/2002,8500000,34411240,25911240,4.048381176470588
Patch Adams,12/25/1998,50000000,202292902,152292902,4.04585804
Scream 3,2/3/2000,40000000,161834276,121834276,4.0458569
Jumanji,12/15/1995,65000000,262797249,197797249,4.0430346
Hannibal,2/8/2001,87000000,351692268,264692268,4.042439862068965
The Fly,8/15/1986,15000000,60629159,45629159,4.041943933333333
The Hundred-Foot Journey,8/6/2014,22000000,88880821,66880821,4.0400373181818185
Another 48 Hrs.,6/8/1990,38000000,153518974,115518974,4.039973
Hellbound: Hellraiser II,12/23/1988,3000000,12090735,9090735,4.030245
Juice,1/17/1992,5000000,20146880,15146880,4.029376
Piku,5/8/2015,5500000,22159216,16659216,4.028948363636363
Vampires Suck,8/18/2010,20000000,80547866,60547866,4.0273933
Madagascar: Escape 2 Africa,10/30/2008,150000000,603900354,453900354,4.02600236
Trainwreck,7/17/2015,35000000,140795793,105795793,4.022736942857143
Total Recall,6/1/1990,65000000,261317921,196317921,4.020275707692308
Garfield,6/10/2004,50000000,200804534,150804534,4.01609068
Johnny English,4/6/2003,40000000,160583018,120583018,4.01457545
Lionheart,6/7/1990,6000000,24078196,18078196,4.013032666666667
The Cannonball Run,6/19/1981,18000000,72179579,54179579,4.009976611111111
The Salvation,5/22/2014,10500000,42070000,31570000,4.006666666666667
Enchanted,11/20/2007,85000000,340487652,255487652,4.005737082352941
The Forest,1/7/2016,10000000,40055439,30055439,4.0055439
Bommarillu,8/9/2006,1333333,5333333,4000000,4.000000750000187
Spice World,12/19/1997,25000000,100000000,75000000,4.0
Creepshow 2,5/1/1987,3500000,14000000,10500000,4.0
The Hollywood Knights,5/30/1980,2500000,10000000,7500000,4.0
Louis C.K.: Live at the Beacon Theater,12/10/2011,250000,1000000,750000,4.0
Hud,5/29/1963,2500000,10000000,7500000,4.0
The Night of the Iguana,8/6/1964,3000000,12000000,9000000,4.0
Bachna Ae Haseeno,8/14/2008,2400000,9600000,7200000,4.0
Beremennyy,7/21/2011,2000000,8000000,6000000,4.0
Tentacoli,2/25/1977,750000,3000000,2250000,4.0
Company,4/15/2002,1500000,6000000,4500000,4.0
Ant-Man,7/14/2015,130000000,519311965,389311965,3.9947074230769233
Casino Royale,11/14/2006,150000000,599045960,449045960,3.9936397333333336
Mata Hari,12/26/1931,558000,2227000,1669000,3.9910394265232974
The Boss Baby,3/23/2017,125000000,498814908,373814908,3.990519264
The Notebook,6/25/2004,29000000,115603229,86603229,3.98631824137931
Bachelorette,8/6/2012,3000000,11947954,8947954,3.9826513333333335
Nighthawks,3/17/1981,5000000,19905359,14905359,3.9810718
狄仁傑之通天帝國,9/18/2010,13000000,51723285,38723285,3.978714230769231
Sully,9/7/2016,60000000,238470033,178470033,3.97450055
The Lucky One,4/19/2012,25000000,99357138,74357138,3.97428552
Star Trek: The Motion Picture,12/6/1979,35000000,139000000,104000000,3.9714285714285715
Sin City,4/1/2005,40000000,158733820,118733820,3.9683455
Whiplash,10/10/2014,3300000,13092000,9792000,3.9672727272727273
Jurassic Park III,7/18/2001,93000000,368780809,275780809,3.9653850430107527
xXx,8/9/2002,70000000,277448382,207448382,3.963548314285714
Scary Movie 4,4/13/2006,45000000,178262620,133262620,3.9613915555555557
One Day,3/2/2011,15000000,59389433,44389433,3.9592955333333335
Patriot Games,6/4/1992,45000000,178051587,133051587,3.9567019333333335
Armageddon,7/1/1998,140000000,553799566,413799566,3.9557111857142857
Conan the Barbarian,4/2/1982,20000000,79114085,59114085,3.95570425
Big Hero 6,10/24/2014,165000000,652105443,487105443,3.9521542
X-Men,7/13/2000,75000000,296339527,221339527,3.9511936933333334
Family Plot,4/9/1976,2000000,7900000,5900000,3.95
The Revenant,12/25/2015,135000000,532950503,397950503,3.9477815037037036
The Break-Up,6/1/2006,52000000,204999686,152999686,3.9423016538461537
King Kong,9/8/1976,23000000,90614445,67614445,3.9397584782608694
This Is the End,6/12/2013,32000000,126041322,94041322,3.9387913125
Inside Job,10/8/2010,2000000,7871522,5871522,3.935761
借りぐらしのアリエッティ,7/16/2010,37000000,145570827,108570827,3.9343466756756755
風立ちぬ,7/20/2013,30000000,117932401,87932401,3.931080033333333
Firefox,6/13/1982,18000000,70687344,52687344,3.9270746666666665
About Last Night,2/14/2014,12500000,49002684,36502684,3.92021472
The Wolf of Wall Street,12/25/2013,100000000,392000694,292000694,3.92000694
Scary Movie 5,4/11/2013,20000000,78378744,58378744,3.9189372
Spider-Man 2,6/25/2004,200000000,783766341,583766341,3.918831705
The Lobster,10/8/2015,4000000,15656193,11656193,3.91404825
Gallipoli,8/13/1981,3000000,11740000,8740000,3.9133333333333336
Bluffmaster!,1/1/2005,1823152,7133082,5309930,3.9124998902998764
功夫瑜伽,1/27/2017,65000000,254212245,189212245,3.9109576153846155
The Informer,5/9/1935,243000,950000,707000,3.909465020576132
Dave Chappelle's Block Party,9/12/2005,3000000,11718595,8718595,3.906198333333333
I Am Legend,12/14/2007,150000000,585349010,435349010,3.902326733333333
Gentleman's Agreement,11/11/1947,2000000,7800000,5800000,3.9
Damien: Omen II,6/9/1978,6800000,26518355,19718355,3.899758088235294
The Lego Batman Movie,2/8/2017,80000000,311950384,231950384,3.8993798
Mrs. Brown's Boys D'Movie,6/27/2014,5900000,23000000,17100000,3.8983050847457625
The Bucket List,12/25/2007,45000000,175372502,130372502,3.8971667111111112
Ice Age: Collision Course,6/23/2016,105000000,408579038,303579038,3.891228933333333
Disclosure,12/9/1994,55000000,214015089,159015089,3.891183436363636
The Usual Suspects,7/19/1995,6000000,23341568,17341568,3.890261333333333
Mildred Pierce,9/24/1945,1453000,5638000,4185000,3.8802477632484513
The Jewel of the Nile,12/4/1985,25000000,96773200,71773200,3.870928
Ransom,11/8/1996,80000000,309492681,229492681,3.8686585125
The Name of the Rose,9/24/1986,20000000,77200000,57200000,3.86
Rush Hour 2,8/3/2001,90000000,347325802,257325802,3.8591755777777776
You've Got Mail,12/17/1998,65000000,250821495,185821495,3.8587922307692306
Deuce Bigalow: Male Gigolo,12/10/1999,17000000,65535067,48535067,3.8550039411764705
The Animal,6/1/2001,22000000,84772742,62772742,3.8533064545454545
Cars,6/8/2006,120000000,461983149,341983149,3.849859575
The Girl on the Train,10/5/2016,45000000,173185859,128185859,3.8485746444444446
2012,10/10/2009,200000000,769653595,569653595,3.848267975
The Bourne Supremacy,7/23/2004,75000000,288500217,213500217,3.84666956
Happy Feet,11/16/2006,100000000,384335608,284335608,3.84335608
The Best Man,10/22/1999,9000000,34573780,25573780,3.8415311111111112
Marked for Death,10/5/1990,12000000,46044400,34044400,3.8370333333333333
The Hobbit: The Desolation of Smaug,12/11/2013,250000000,958400000,708400000,3.8336
Samson and Delilah,12/21/1949,3000000,11500000,8500000,3.8333333333333335
Freddy vs. Jason,8/15/2003,30000000,114908830,84908830,3.8302943333333332
The Hobbit: The Battle of the Five Armies,12/10/2014,250000000,956019788,706019788,3.824079152
Bride Wars,1/9/2009,30000000,114663461,84663461,3.8221153666666665
Hardware,9/14/1990,1500000,5728953,4228953,3.819302
Teenage Mutant Ninja Turtles,8/7/2014,125000000,477200000,352200000,3.8176
Harry Potter and the Deathly Hallows: Part 1,10/17/2010,250000000,954305868,704305868,3.817223472
Thank You for Smoking,9/5/2005,6500000,24793509,18293509,3.814386
Hope Springs,8/7/2012,30000000,114281051,84281051,3.8093683666666665
A Time to Kill,7/24/1996,40000000,152266007,112266007,3.806650175
Get Shorty,10/20/1995,30250000,115101622,84851622,3.805012297520661
Breakfast at Tiffany's,10/5/1961,2500000,9500000,7000000,3.8
The Hustler,9/25/1961,2000000,7600000,5600000,3.8
Outbreak,3/10/1995,50000000,189859560,139859560,3.7971912
Thor: The Dark World,10/29/2013,170000000,644571402,474571402,3.7915964823529413
The Lost Boys,7/31/1987,8500000,32222567,23722567,3.7908902352941176
The Color of Money,10/7/1986,13800000,52293982,38493982,3.7894189855072464
The Fast and the Furious,2/15/1955,66000,250000,184000,3.787878787878788
1408,7/12/2007,25000000,94679598,69679598,3.78718392
The Specialist,10/7/1994,45000000,170362582,125362582,3.7858351555555556
The Rookie,3/25/2002,20000000,75597042,55597042,3.7798521
The Naked Gun 2½: The Smell of Fear,6/28/1991,23000000,86930411,63930411,3.7795830869565217
Vantage Point,2/1/2008,40000000,151161491,111161491,3.779037275
Hang 'em High,7/31/1968,1800000,6800000,5000000,3.7777777777777777
22 Jump Street,6/5/2014,50000000,188441614,138441614,3.76883228
Timecop,9/15/1994,27000000,101646581,74646581,3.764688185185185
Sleepers,10/18/1996,44000000,165615285,121615285,3.76398375
Pineapple Express,8/6/2008,27000000,101624843,74624843,3.763883074074074
School of Rock,10/3/2003,35000000,131282949,96282949,3.7509414
Into the Wild,9/11/2007,15000000,56255142,41255142,3.7503428
A Walk to Remember,1/25/2002,11000000,41227069,30227069,3.7479153636363636
The Fighter,12/17/2010,25000000,93617009,68617009,3.74468036
Oliver!,9/26/1968,10000000,37402877,27402877,3.7402877
Harry Potter and the Half-Blood Prince,7/7/2009,250000000,933959197,683959197,3.735836788
Lone Survivor,12/24/2013,40000000,149295601,109295601,3.732390025
Serbuan maut,9/8/2011,1100000,4105187,3005187,3.7319881818181817
Funny Girl,9/19/1968,14000000,52223306,38223306,3.7302361428571427
Interview with the Vampire,11/11/1994,60000000,223664608,163664608,3.7277434666666664
Gabbar Is Back,5/1/2015,11000000,41000000,30000000,3.727272727272727
Before Midnight,4/5/2013,3000000,11176469,8176469,3.725489666666667
Loose Cannons,2/9/1990,1500000,5585154,4085154,3.723436
Now You See Me 2,6/2/2016,90000000,334901337,244901337,3.7211259666666665
Michael Clayton,9/28/2007,25000000,92991835,67991835,3.7196734
Monsters University,6/20/2013,200000000,743559607,543559607,3.717798035
In Cold Blood,12/14/1967,3500000,13007551,9507551,3.716443142857143
Watership Down,10/14/1978,1000000,3713768,2713768,3.713768
Jeepers Creepers 2,8/8/2003,17000000,63102666,46102666,3.711921529411765
Air Force One,7/25/1997,85000000,315156409,230156409,3.7077224588235294
X2,4/24/2003,110000000,407711549,297711549,3.706468627272727
Grand Hotel,5/25/1932,700000,2594000,1894000,3.7057142857142855
Emma,8/2/1996,6000000,22231658,16231658,3.7052763333333334
Everest,9/10/2015,55000000,203427584,148427584,3.6986833454545454
21 & Over,3/1/2013,13000000,48065672,35065672,3.6973593846153845
Resident Evil: Retribution,9/12/2012,65000000,240159255,175159255,3.6947577692307694
Obsessed,4/24/2009,20000000,73830340,53830340,3.691517
The Heat,6/27/2013,43000000,158674180,115674180,3.6900972093023254
The Cider House Rules,12/17/1999,24000000,88545092,64545092,3.6893788333333335
A Cinderella Story,7/10/2004,19000000,70067909,51067909,3.687784684210526
Shutter Island,2/18/2010,80000000,294804195,214804195,3.6850524375
Working Girl,12/20/1988,28000000,103173635,75173635,3.6847726785714285
Phoonk,8/22/2008,750000,2760000,2010000,3.68
Why Did I Get Married?,10/12/2007,15000000,55184721,40184721,3.6789814
The Muppets,11/22/2011,45000000,165184237,120184237,3.6707608222222223
Wake Up Sid,10/2/2009,3000000,11000000,8000000,3.6666666666666665
Without a Paddle,8/20/2004,19000000,69631118,50631118,3.6647956842105263
The Kite Runner,10/14/2007,20000000,73276047,53276047,3.66380235
Nick and Norah's Infinite Playlist,10/3/2008,9000000,32973937,23973937,3.6637707777777777
Ocean's Thirteen,6/7/2007,85000000,311312624,226312624,3.6625014588235296
The Nun's Story,6/18/1959,3500000,12800000,9300000,3.657142857142857
The Godfather: Part II,12/20/1974,13000000,47542841,34542841,3.6571416153846155
The Terminal,6/17/2004,60000000,219417255,159417255,3.65695425
Dawn of the Dead,3/19/2004,28000000,102356381,74356381,3.6555850357142856
Music and Lyrics,2/9/2007,40000000,145896422,105896422,3.64741055
Sixteen Candles,5/4/1984,6500000,23686027,17186027,3.644004153846154
Cliffhanger,5/28/1993,70000000,255000211,185000211,3.642860157142857
Romeo Must Die,3/20/2000,25000000,91036760,66036760,3.6414704
Jack Reacher,12/20/2012,60000000,218340595,158340595,3.6390099166666667
A Soldier's Story,9/14/1984,6000000,21821347,15821347,3.6368911666666666
Quo Vadis,11/8/1951,8250000,30000000,21750000,3.6363636363636362
Transporter 3,11/26/2008,30000000,108979549,78979549,3.6326516333333334
Desperado,8/25/1995,7000000,25405445,18405445,3.6293492857142855
Old School,2/21/2003,24000000,87055349,63055349,3.627306208333333
New in Town,1/30/2009,8000000,29010817,21010817,3.626352125
Spy,5/6/2015,65000000,235666219,170666219,3.6256341384615385
Harold & Kumar Escape from Guantanamo Bay,4/25/2008,12000000,43493123,31493123,3.6244269166666667
Killer of Sheep,11/14/1978,100000,362222,262222,3.62222
Planet of the Apes,7/25/2001,100000000,362211740,262211740,3.6221174
Sanctum,2/3/2011,30000000,108609310,78609310,3.6203103333333333
Barbershop 2:  Back in Business,1/20/2004,18000000,65070412,47070412,3.615022888888889
Letters from Iwo Jima,12/19/2006,19000000,68673228,49673228,3.6143804210526316
Eternal Sunshine of the Spotless Mind,3/19/2004,20000000,72258126,52258126,3.6129063
City of Angels,4/10/1998,55000000,198685114,143685114,3.612456618181818
L.A. Confidential,9/19/1997,35000000,126216940,91216940,3.6061982857142856
The Bye Bye Man,1/12/2017,7400000,26667197,19267197,3.60367527027027
The Beach,2/11/2000,40000000,144056873,104056873,3.601421825
Trapeze,5/30/1956,4000000,14400000,10400000,3.6
Frenzy,5/25/1972,3500000,12600000,9100000,3.6
Monster-in-Law,5/13/2005,43000000,154749918,111749918,3.5988353023255812
Spectre,10/26/2015,245000000,880674609,635674609,3.5945902408163266
Kung Fu Panda 3,1/23/2016,145000000,521170825,376170825,3.594281551724138
Star Trek VI: The Undiscovered Country,12/5/1991,27000000,96900000,69900000,3.588888888888889
Dead Man Walking,12/29/1995,11000000,39363635,28363635,3.5785122727272727
Crank,8/31/2006,12000000,42931041,30931041,3.57758675
Soul Kitchen,9/9/2009,5000000,17872796,12872796,3.5745592
Stargate,10/27/1994,55000000,196567262,141567262,3.5739502181818184
The Bourne Identity,6/14/2002,60000000,214034224,154034224,3.567237066666667
The Return of the Living Dead,5/15/1985,4000000,14237000,10237000,3.55925
Johnny English Reborn,9/15/2011,45000000,160078586,115078586,3.5573019111111113
West of Zanzibar,11/24/1928,259000,921000,662000,3.555984555984556
Halloween 4: The Return of Michael Myers,10/21/1988,5000000,17768757,12768757,3.5537514
Anacondas: The Hunt for the Blood Orchid,8/26/2004,20000000,70992898,50992898,3.5496449
How to Lose a Guy in 10 Days,2/7/2003,50000000,177371441,127371441,3.54742882
The Hateful Eight,12/25/2015,44000000,155760117,111760117,3.5400026590909093
Gothika,11/21/2003,40000000,141591324,101591324,3.5397831
Gandhi,11/30/1982,22000000,77737889,55737889,3.533540409090909
The Reader,12/10/2008,32000000,113019290,81019290,3.5318528125
Big Fat Liar,2/8/2002,15000000,52970014,37970014,3.5313342666666667
My Name Is Khan,2/12/2010,12000000,42345360,30345360,3.52878
The Amazing Spider-Man 2,4/16/2014,200000000,705717432,505717432,3.52858716
About Schmidt,12/13/2002,30000000,105834556,75834556,3.5278185333333334
Superman II,12/4/1980,54000000,190458706,136458706,3.527013074074074
Shallow Hal,11/1/2001,40000000,141069860,101069860,3.5267465
The Accountant,10/14/2016,44000000,155160045,111160045,3.526364659090909
The Wind That Shakes the Barley,6/23/2006,6500000,22889018,16389018,3.5213873846153847
Raising Victor Vargas,5/16/2002,800000,2816116,2016116,3.520145
Neighbors,12/18/1981,8500000,29916207,21416207,3.5195537647058823
National Treasure: Book of Secrets,12/13/2007,130000000,457363168,327363168,3.5181782153846153
The Hangover Part III,5/23/2013,103000000,362000072,259000072,3.514563805825243
Minority Report,6/20/2002,102000000,358372926,256372926,3.5134600588235294
Каникулы строгого режима,8/25/2009,5000000,17566040,12566040,3.513208
Forgetting Sarah Marshall,4/17/2008,30000000,105173115,75173115,3.5057705
Diary of a Wimpy Kid: Dog Days,8/2/2012,22000000,77112176,55112176,3.505098909090909
Remember Me,3/12/2010,16000000,56032889,40032889,3.5020555625
Sisters,12/18/2015,30000000,105011053,75011053,3.500368433333333
Wild,12/5/2014,15000000,52501541,37501541,3.500102733333333
Batman Returns,6/19/1992,80000000,280000000,200000000,3.5
To Catch a Thief,8/3/1955,2500000,8750000,6250000,3.5
The Amazing Spider-Man,6/27/2012,215000000,752215857,537215857,3.4986784046511628
The Equalizer,9/24/2014,55000000,192330738,137330738,3.496922509090909
Horton Hears a Who!,3/3/2008,85000000,297138014,212138014,3.4957413411764704
Batman v Superman: Dawn of Justice,3/23/2016,250000000,873260194,623260194,3.493040776
Hostel: Part II,6/8/2007,10200000,35619521,25419521,3.4921099019607844
Live Free or Die Hard,6/20/2007,110000000,383531464,273531464,3.486649672727273
Safe Haven,2/7/2013,28000000,97594140,69594140,3.485505
Earth to Echo,6/14/2014,13000000,45300000,32300000,3.4846153846153847
Anchorman: The Legend of Ron Burgundy,7/9/2004,26000000,90574188,64574188,3.4836226153846153
Clear and Present Danger,8/3/1994,62000000,215887717,153887717,3.482059951612903
Point Break,7/12/1991,24000000,83531958,59531958,3.48049825
Honey,11/24/2003,18000000,62646763,44646763,3.480375722222222
An Education,10/29/2009,7500000,26096852,18596852,3.479580266666667
Casino Royale,4/13/1967,12000000,41744718,29744718,3.4787265
Final Destination 2,1/31/2003,26000000,90426405,64426405,3.4779386538461536
Robots,3/10/2005,75000000,260696994,185696994,3.47595992
National Treasure,11/19/2004,100000000,347451894,247451894,3.47451894
Anchorman 2: The Legend Continues,12/18/2013,50000000,173649015,123649015,3.4729803
Scanners,1/14/1981,4100000,14225876,10125876,3.4697258536585367
The Wedding Ringer,1/16/2015,23000000,79799880,56799880,3.46956
Elmer Gantry,6/19/1960,3000000,10400000,7400000,3.466666666666667
Piranha 3D,8/20/2010,24000000,83188165,59188165,3.4661735416666666
The Secret Life of Bees,9/17/2008,11000000,38105395,27105395,3.464126818181818
Jason Bourne,7/27/2016,120000000,415484914,295484914,3.4623742833333333
The Wolverine,7/23/2013,120000000,415440673,295440673,3.4620056083333335
Big Momma's House 2,1/26/2006,40000000,138259062,98259062,3.45647655
Money Monster,5/12/2016,27000000,93282604,66282604,3.4549112592592595
Pirates of the Caribbean: Dead Men Tell No Tales,5/23/2017,230000000,794191988,564191988,3.453008643478261
Spider-Man 3,5/1/2007,258000000,890871626,632871626,3.4529907984496124
Diary of a Wimpy Kid: Rodrick Rules,3/25/2011,21000000,72417394,51417394,3.448447333333333
Pain & Gain,4/18/2013,25000000,86175291,61175291,3.44701164
Chennai Express,8/9/2013,18000000,62000000,44000000,3.4444444444444446
Wanted,6/19/2008,75000000,258270008,183270008,3.4436001066666666
Nell,12/23/1994,31000000,106683817,75683817,3.4414134516129034
Young Guns,8/12/1988,13000000,44726644,31726644,3.440511076923077
This Is England,9/12/2006,2380000,8176544,5796544,3.43552268907563
Kick-Ass,3/22/2010,28000000,96188903,68188903,3.4353179642857143
Happy Gilmore,2/16/1996,12000000,41205099,29205099,3.43375825
Rugrats in Paris: The Movie,9/14/2000,30,103,73,3.433333333333333
The Expendables,8/3/2010,80000000,274470394,194470394,3.430879925
The Pianist,9/24/2002,35000000,120072577,85072577,3.4306450571428573
London Has Fallen,3/2/2016,60000000,205754447,145754447,3.4292407833333334
Die Hard 2,7/2/1990,70000000,240031094,170031094,3.4290156285714284
Harper,2/23/1966,3500000,12000000,8500000,3.4285714285714284
Love & Other Drugs,11/22/2010,30000000,102820008,72820008,3.4273336
Mr. Deeds,6/28/2002,50000000,171269535,121269535,3.4253907
마더,5/28/2009,5000000,17112713,12112713,3.4225426
Primal Fear,4/3/1996,30000000,102616183,72616183,3.4205394333333334
Brown Sugar,10/5/2002,8000000,27362712,19362712,3.420339
Moulin Rouge!,3/9/2001,52500000,179213434,126713434,3.413589219047619
Carol,11/20/2015,11800000,40272135,28472135,3.4128927966101696
Eat Pray Love,8/12/2010,60000000,204594016,144594016,3.4099002666666665
Mr. Popper's Penguins,6/17/2011,55000000,187361754,132361754,3.4065773454545454
Sing Street,3/11/2016,4000000,13624522,9624522,3.4061305
Quarantine,10/10/2008,12000000,40855419,28855419,3.40461825
Hoodwinked!,12/16/2005,15000000,51053787,36053787,3.4035858
Shall We Dance?,10/15/2004,50000000,170128460,120128460,3.4025692
The Royal Tenenbaums,10/5/2001,21000000,71441250,50441250,3.4019642857142856
Duel in the Sun,12/31/1946,6000000,20400000,14400000,3.4
The Other Woman,10/28/2010,30000000,102000000,72000000,3.4
The Bounty Hunter,3/16/2010,40000000,136000000,96000000,3.4
La Vérité si je Mens ! 2,2/7/2001,12560000,42700000,30140000,3.3996815286624202
A Passage to India,12/14/1984,8000000,27187653,19187653,3.398456625
Divergent,3/14/2014,85000000,288747895,203747895,3.3970340588235293
Absence of Malice,12/18/1981,12000000,40716963,28716963,3.39308025
Grown Ups,6/24/2010,80000000,271430189,191430189,3.3928773625
Pina,2/24/2011,4317946,14624826,10306880,3.386986775656759
Celda 211,11/6/2009,5700000,19300483,13600483,3.386049649122807
Once Upon a Time in Mexico,9/11/2003,29000000,98185582,69185582,3.3857097241379313
Going in Style,4/6/2017,25000000,84618541,59618541,3.38474164
Never Been Kissed,4/9/1999,25000000,84565230,59565230,3.3826092
Mulan,6/18/1998,90000000,304320254,214320254,3.3813361555555557
She Wore a Yellow Ribbon,10/22/1949,1600000,5400000,3800000,3.375
The Verdict,12/8/1982,16000000,53977250,37977250,3.373578125
The Outsiders,3/25/1983,10000000,33697647,23697647,3.3697647
Charade,12/5/1963,4000000,13474588,9474588,3.368647
Vacation,7/28/2015,31000000,104384188,73384188,3.367231870967742
Batman Forever,6/16/1995,100000000,336529144,236529144,3.36529144
Wild Things,3/20/1998,20000000,67200000,47200000,3.36
Boogeyman,2/4/2005,20000000,67192859,47192859,3.35964295
Final Destination 5,8/12/2011,47000000,157887643,110887643,3.3593115531914894
Smokin' Aces,12/9/2006,17000000,57103895,40103895,3.3590526470588236
Devil,1/13/2010,10000000,33583175,23583175,3.3583175
Amour,7/1/2012,8900000,29844753,20944753,3.353343033707865
Dennis the Menace,6/23/1993,35000000,117270765,82270765,3.3505932857142855
The History Boys,10/2/2006,4000000,13401952,9401952,3.350488
Collateral,8/4/2004,65000000,217764291,152764291,3.3502198615384615
The Rugrats Movie,11/20/1998,30000000,100491683,70491683,3.3497227666666665
The Great Gatsby,5/10/2013,105000000,351040419,246040419,3.3432420857142855
Horrible Bosses,7/8/2011,35000000,117000000,82000000,3.342857142857143
10 Things I Hate About You,3/30/1999,16000000,53478166,37478166,3.342385375
Warm Bodies,1/31/2013,35000000,116980662,81980662,3.3423046285714286
Marathon Man,10/5/1976,6500000,21709020,15209020,3.339849230769231
Selma,12/25/2014,20000000,66787908,46787908,3.3393954
The Babadook,5/22/2014,2000000,6676471,4676471,3.3382355
Elephant,5/18/2003,3000000,10012022,7012022,3.3373406666666665
Something's Gotta Give,12/12/2003,80000000,266728738,186728738,3.334109225
Dragnet,6/25/1987,20000000,66673516,46673516,3.3336758
How the West Was Won,11/1/1962,15000000,50000000,35000000,3.3333333333333335
The Deer Hunter,12/8/1978,15000000,50000000,35000000,3.3333333333333335
Judgment at Nuremberg,12/1/1961,3000000,10000000,7000000,3.3333333333333335
Bad Santa,11/26/2003,23000000,76488889,53488889,3.3256038695652173
Rings,2/1/2017,25000000,83080890,58080890,3.3232356
Zero Dark Thirty,12/19/2012,40000000,132820716,92820716,3.3205179
North by Northwest,7/7/1959,4000000,13275000,9275000,3.31875
A Good Day to Die Hard,2/6/2013,92000000,304654182,212654182,3.3114585
Shocker,10/27/1989,5000000,16554699,11554699,3.3109398
The Smurfs 2,7/30/2013,105000000,347434178,242434178,3.308896933333333
Unbreakable,11/13/2000,75000000,248118121,173118121,3.308241613333333
No Reservations,7/25/2007,28000000,92601050,64601050,3.3071803571428573
Godzilla,5/14/2014,160000000,529076069,369076069,3.30672543125
Jackie Brown,12/24/1997,12000000,39673162,27673162,3.306096833333333
Fantastic Four,6/29/2005,100000000,330579719,230579719,3.30579719
A Nightmare on Elm Street,4/30/2010,35000000,115664037,80664037,3.3046867714285715
風の谷のナウシカ,3/11/1984,1000000,3301446,2301446,3.301446
Run Fatboy Run,9/6/2007,10000000,33000000,23000000,3.3
Role Models,2/3/2008,28000000,92380927,64380927,3.2993188214285714
The Constant Gardener,8/31/2005,25000000,82466670,57466670,3.2986668
[REC]²,9/15/2009,5600000,18469680,12869680,3.298157142857143
Resident Evil: Extinction,9/20/2007,45000000,148412065,103412065,3.298045888888889
Notes on a Scandal,12/25/2006,15000000,49469904,34469904,3.2979936
Ocean's Twelve,12/9/2004,110000000,362744280,252744280,3.2976752727272727
True Lies,7/14/1994,115000000,378882411,263882411,3.2946296608695653
Tsotsi,8/18/2005,3000000,9879971,6879971,3.2933236666666668
Smurfs: The Lost Village,3/23/2017,60000000,197183546,137183546,3.2863924333333334
Scooby-Doo,6/14/2002,84000000,275650703,191650703,3.281555988095238
Street Kings,4/10/2008,20000000,65569869,45569869,3.27849345
Marnie,7/9/1964,2135161,7000000,4864839,3.278441297869341
Mere Brother Ki Dulhan,9/9/2011,5510000,18050000,12540000,3.2758620689655173
The American,8/31/2010,20000000,65464324,45464324,3.2732162
Under the Tuscan Sun,4/30/2003,18000000,58878723,40878723,3.271040166666667
La Pianiste,5/14/2001,3000000,9801375,6801375,3.267125
The Lizzie McGuire Movie,4/25/2003,17000000,55534455,38534455,3.2667326470588236
Bizim Aile,9/7/1975,65700,214600,148900,3.2663622526636225
The Last Samurai,12/5/2003,140000000,456758981,316758981,3.26256415
The Mummy,6/6/2017,125000000,407778013,282778013,3.262224104
Star Trek: First Contact,11/21/1996,46000000,150000000,104000000,3.260869565217391
The Guard,7/7/2011,6000000,19560274,13560274,3.2600456666666666
Due Date,11/4/2010,65000000,211780824,146780824,3.2581665230769232
That Awkward Moment,1/29/2014,8000000,26049082,18049082,3.25613525
They Live,11/23/1988,4000000,13008928,9008928,3.252232
Eega,6/6/2012,5990000,19450000,13460000,3.2470784641068446
The Bank Job,2/28/2008,20000000,64822796,44822796,3.2411398
Species,7/7/1995,35000000,113374103,78374103,3.2392600857142857
Julie & Julia,8/6/2009,40000000,129540499,89540499,3.238512475
Gitler kaput!,9/18/2008,3000000,9713500,6713500,3.237833333333333
Halloween: H20,8/5/1998,17000000,55041738,38041738,3.237749294117647
Jimmy Neutron: Boy Genius,12/21/2001,25000000,80936232,55936232,3.23744928
The Goonies,6/6/1985,19000000,61503218,42503218,3.2370114736842104
Sunshine Cleaning,1/18/2008,5000000,16174377,11174377,3.2348754
Bring It On,8/25/2000,28000000,90449929,62449929,3.230354607142857
Invisible Agent,7/31/1942,322000,1040000,718000,3.229813664596273
The Ring Two,3/17/2005,50000000,161451538,111451538,3.22903076
Yes Man,12/9/2008,70000000,225990978,155990978,3.228442542857143
MouseHunt,12/19/1997,38000000,122417389,84417389,3.2215102368421054
The Departed,10/5/2006,90000000,289847354,199847354,3.2205261555555555
The Talented Mr. Ripley,12/25/1999,40000000,128798265,88798265,3.219956625
Entrapment,4/29/1999,66000000,212404396,146404396,3.2182484242424243
Saving Mr. Banks,11/16/2013,35000000,112544580,77544580,3.2155594285714284
Into the Storm,8/6/2014,50000000,160602194,110602194,3.21204388
The Lawnmower Man,3/5/1992,10000000,32101000,22101000,3.2101
Pearl Harbor,5/21/2001,140000000,449220945,309220945,3.208721035714286
Pirates of the Caribbean: At World's End,5/19/2007,300000000,961000000,661000000,3.203333333333333
Employee of the Month,10/6/2006,12000000,38368909,26368909,3.1974090833333335
An American Werewolf in London,8/21/1981,10000000,31973249,21973249,3.1973249
Alien³,5/22/1992,50000000,159773545,109773545,3.1954709
The Golden Child,12/12/1986,25000000,79817939,54817939,3.19271756
Ted 2,6/25/2015,68000000,217022588,149022588,3.1915086470588236
My Sister's Keeper,6/26/2009,30000000,95714875,65714875,3.1904958333333333
Scenes from a Mall,2/22/1991,3000000,9563393,6563393,3.1877976666666665
Cloudy with a Chance of Meatballs 2,9/26/2013,78000000,248384621,170384621,3.184418217948718
The Hangover Part II,5/25/2011,80000000,254455986,174455986,3.180699825
Excalibur,4/10/1981,11000000,34967437,23967437,3.178857909090909
Hoosiers,11/14/1986,9000000,28607524,19607524,3.1786137777777776
The Doctor,7/24/1991,12000000,38120905,26120905,3.1767420833333335
The Mist,11/21/2007,18000000,57096190,39096190,3.1720105555555556
Freddy's Dead: The Final Nightmare,9/5/1991,11000000,34872033,23872033,3.170184818181818
Spy Kids: All the Time in the World,8/18/2011,27000000,85564310,58564310,3.1690485185185184
Charlie and the Chocolate Factory,7/13/2005,150000000,474968763,324968763,3.16645842
Lucy,7/14/2014,40000000,126546825,86546825,3.163670625
Daddy's Little Girls,2/14/2007,10000000,31609243,21609243,3.1609243
Star Trek: Generations,11/17/1994,38000000,120000000,82000000,3.1578947368421053
The Cell,8/17/2000,33000000,104155843,71155843,3.1562376666666667
Predators,7/3/2010,40000000,126248813,86248813,3.156220325
Men in Black II,7/3/2002,140000000,441818803,301818803,3.1558485928571427
The Rose,11/7/1979,9250000,29174648,19924648,3.154016
Sex Tape,7/17/2014,40000000,126069509,86069509,3.151737725
Spy Kids 2: The Island of Lost Dreams,8/7/2002,38000000,119723358,81723358,3.1506146842105265
Party Girl,6/9/1995,150000,472370,322370,3.1491333333333333
The Wedding Date,2/4/2005,15000000,47175038,32175038,3.1450025333333333
Wishmaster,9/19/1997,5000000,15719109,10719109,3.1438218
Mechanic: Resurrection,8/25/2016,40000000,125729635,85729635,3.143240875
StreetDance 3D,5/19/2010,5773100,18144030,12370930,3.142857390310232
Scary Movie 2,7/4/2001,45000000,141220678,96220678,3.138237288888889
The Lost World: Jurassic Park,5/23/1997,73000000,229074524,156074524,3.1380071780821917
THX 1138,3/11/1971,777000,2437000,1660000,3.1364221364221363
Hell or High Water,8/12/2016,12000000,37589296,25589296,3.1324413333333334
Space Jam,11/15/1996,80000000,250200000,170200000,3.1275
Dancer in the Dark,5/17/2000,12800000,40031879,27231879,3.127490546875
The Object of My Affection,4/17/1998,15000000,46905889,31905889,3.1270592666666666
Racing Stripes,1/6/2005,30000000,93772522,63772522,3.125750733333333
The Expendables 2,8/8/2012,100000000,312573423,212573423,3.12573423
The Women,9/12/2008,16000000,50007546,34007546,3.125471625
A Mighty Wind,4/16/2003,6000000,18750246,12750246,3.125041
Once Bitten,11/15/1985,3200000,10000000,6800000,3.125
Heat,12/15/1995,60000000,187436818,127436818,3.123946966666667
The Prince of Egypt,12/15/1998,70000000,218613188,148613188,3.1230455428571426
Resident Evil,3/15/2002,33000000,102984862,69984862,3.120753393939394
Ride Along 2,1/14/2016,40000000,124827316,84827316,3.1206829
Teenage Mutant Ninja Turtles II: The Secret of the Ooze,3/22/1991,25000000,78000000,53000000,3.12
Iron Man 2,4/28/2010,200000000,623933331,423933331,3.119666655
Ray,10/29/2004,40000000,124731534,84731534,3.11828835
Land of the Dead,6/24/2005,15000000,46770602,31770602,3.1180401333333334
Fury,10/15/2014,68000000,211817906,143817906,3.114969205882353
The Horse Whisperer,5/14/1998,60000000,186883563,126883563,3.11472605
リン�?2,1/23/1999,6000000,18686644,12686644,3.114440666666667
2 Fast 2 Furious,6/5/2003,76000000,236350661,160350661,3.1098771184210525
Knowing,3/19/2009,50000000,155446362,105446362,3.10892724
Neighbors 2: Sorority Rising,5/4/2016,35000000,108758521,73758521,3.1073863142857143
Little Fockers,12/21/2010,100000000,310650585,210650585,3.10650585
Why Him?,12/22/2016,38000000,118034273,80034273,3.1061650789473685
Sarkar,7/1/2005,1900000,5900000,4000000,3.1052631578947367
Open Range,8/29/2003,22000000,68296293,46296293,3.1043769545454545
Prometheus,5/30/2012,130000000,403170142,273170142,3.1013087846153846
The Foot Fist Way,6/24/2006,79000,245000,166000,3.1012658227848102
Bwakaw,9/5/2012,11178,34659,23481,3.100644122383253
Raising Cain,8/7/1992,12000000,37170057,25170057,3.09750475
The Grey,1/26/2012,25000000,77278331,52278331,3.09113324
ゲド戦記,7/29/2006,22000000,68000000,46000000,3.090909090909091
There Will Be Blood,12/28/2007,25000000,77208711,52208711,3.08834844
Blended,5/21/2014,40000000,123494610,83494610,3.08736525
Grown Ups 2,7/11/2013,80000000,246984278,166984278,3.087303475
Die Another Day,11/17/2002,140000000,431971116,291971116,3.0855079714285716
Son of God,2/28/2014,22000000,67800064,45800064,3.081821090909091
Need for Speed,3/13/2014,66000000,203277636,137277636,3.0799641818181818
The Big Lebowski,3/6/1998,15000000,46189568,31189568,3.0793045333333335
Dracula Untold,10/1/2014,70000000,215529201,145529201,3.078988585714286
Sudden Impact,12/7/1983,22000000,67642693,45642693,3.0746678636363636
Focus,2/25/2015,50100000,153962963,103862963,3.0731130339321355
Face/Off,6/27/1997,80000000,245676146,165676146,3.070951825
300: Rise of an Empire,3/5/2014,110000000,337580051,227580051,3.0689095545454546
When the Bough Breaks,9/9/2016,10000000,30658387,20658387,3.0658387
Dogma,11/12/1999,10000000,30652890,20652890,3.065289
Misery,11/28/1990,20000000,61276872,41276872,3.0638436
Kong: Skull Island,3/8/2017,185000000,566652812,381652812,3.062988172972973
Are We There Yet?,1/20/2005,32000000,97918663,65918663,3.05995821875
Seven Pounds,12/18/2008,55000000,168167691,113167691,3.057594381818182
Southpaw,6/15/2015,30000000,91709827,61709827,3.0569942333333335
White Chicks,6/23/2004,37000000,113086475,76086475,3.056391216216216
X-Men: Apocalypse,5/18/2016,178000000,543934787,365934787,3.0558134101123597
Darkman,8/24/1990,16000000,48878502,32878502,3.054906375
The Untouchables,6/2/1987,25000000,76270454,51270454,3.05081816
Anaconda,4/11/1997,45000000,136885767,91885767,3.041905933333333
Congo,6/9/1995,50000000,152022101,102022101,3.04044202
Sweeney Todd: The Demon Barber of Fleet Street,12/20/2007,50000000,152000000,102000000,3.04
PEEPLI [Live],8/13/2010,2270000,6900000,4630000,3.039647577092511
Baby Geniuses,3/12/1999,12000000,36450736,24450736,3.037561333333333
Magic in the Moonlight,7/25/2014,16800000,51029361,34229361,3.0374619642857144
The Last Exorcism Part II,2/28/2013,5000000,15179302,10179302,3.0358604
Daddy Day Camp,8/8/2007,6000000,18197398,12197398,3.0328996666666668
It's a Wonderful Life,12/20/1946,3180000,9644124,6464124,3.032743396226415
Shaft,7/2/1971,4000000,12121618,8121618,3.0304045
Tomorrow Never Dies,12/11/1997,110000000,333011068,223011068,3.0273733454545453
A Bug's Life,11/25/1998,120000000,363258859,243258859,3.0271571583333334
Drag Me to Hell,3/15/2009,30000000,90810892,60810892,3.0270297333333334
Immortals,11/10/2011,75000000,226904017,151904017,3.025386893333333
Halloween: The Curse of Michael Myers,9/29/1995,5000000,15116634,10116634,3.0233268
Planes: Fire & Rescue,7/17/2014,50000000,151165787,101165787,3.02331574
21 Grams,9/6/2003,20000000,60427839,40427839,3.02139195
Stay Alive,3/24/2006,9000000,27105095,18105095,3.011677222222222
Eight Below,2/17/2006,40000000,120455994,80455994,3.01139985
Mar adentro,9/3/2004,12806000,38535221,25729221,3.0091535998750585
Identity,4/25/2003,30000000,90259536,60259536,3.0086512
Broken Arrow,2/9/1996,50000000,150270147,100270147,3.00540294
Apocalypto,12/7/2006,40000000,120175290,80175290,3.00438225
Water for Elephants,3/15/2011,38000000,114156230,76156230,3.0041113157894737
Red River,8/26/1948,3000000,9012000,6012000,3.004
Why Did I Get Married Too?,4/2/2010,20000000,60072596,40072596,3.0036298
Single White Female,8/14/1992,16000000,48017402,32017402,3.001087625
Atomic Blonde,7/26/2017,30000000,90007945,60007945,3.0002648333333335
Rambo III,5/24/1988,63000000,189015611,126015611,3.000247793650794
Witness for the Prosecution,12/17/1957,3000000,9000000,6000000,3.0
Selena,3/21/1997,20000000,60000000,40000000,3.0
The Egyptian,8/25/1954,5000000,15000000,10000000,3.0
"\"அலைபாயுத�?\"\"After a difficult romance in a class-divided society\"",4/14/2000,2000000,6000000,4000000,3.0
விஸ்வரூபம்,1/25/2013,17000000,51000000,34000000,3.0
Saamy,5/5/2003,1,3,2,3.0
Warlords of the 21st Century,1/1/1982,1000000,3000000,2000000,3.0
How to Train Your Dragon,3/5/2010,165000000,494878759,329878759,2.999265206060606
Thor,4/21/2011,150000000,449326618,299326618,2.995510786666667
Jobs,8/16/2013,12000000,35931410,23931410,2.9942841666666666
Inside Llewyn Davis,10/6/2013,11000000,32935319,21935319,2.994119909090909
X-Men: Days of Future Past,5/15/2014,250000000,747862775,497862775,2.9914511
Vanilla Sky,12/10/2001,68000000,203388341,135388341,2.991005014705882
Cop Land,8/15/1997,15000000,44862187,29862187,2.9908124666666667
Hachi: A Dog's Tale,6/13/2009,16000000,47801389,31801389,2.9875868125
The Joy Luck Club,9/8/1993,11000000,32861136,21861136,2.987376
Con Air,6/1/1997,75000000,224012234,149012234,2.9868297866666667
Tarzan,6/18/1999,150000000,448000000,298000000,2.986666666666667
Harsh Times,9/11/2005,2000000,5967038,3967038,2.983519
Secrets & Lies,5/24/1996,4500000,13417292,8917292,2.9816204444444443
Bad Day at Black Rock,1/7/1955,1271000,3788000,2517000,2.980330448465775
Jason's Lyric,9/28/1994,7000000,20851521,13851521,2.9787887142857143
Hercules,6/26/1997,85000000,252712101,167712101,2.9730835411764707
முதல்வன்,11/7/1999,7400000,22000000,14600000,2.972972972972973
Crimson Tide,5/12/1995,53000000,157387195,104387195,2.969569716981132
Star of Midnight,4/19/1935,280,831,551,2.967857142857143
August: Osage County,12/26/2013,25000000,74188937,49188937,2.96755748
In a World...,8/9/2013,1000000,2963902,1963902,2.963902
Arbitrage,9/14/2012,12000000,35485056,23485056,2.957088
How to Be Single,1/21/2016,38000000,112343513,74343513,2.956408236842105
Staying Alive,7/11/1983,22000000,64892670,42892670,2.949666818181818
Melancholia,5/26/2011,7400000,21817298,14417298,2.9482835135135135
Man of Steel,6/12/2013,225000000,662845518,437845518,2.94598008
Hustle & Flow,7/22/2005,8000000,23563727,15563727,2.945465875
Twilight Zone: The Movie,6/24/1983,10000000,29450919,19450919,2.9450919
Mad Max Beyond Thunderdome,6/29/1985,12305523,36230219,23924696,2.9442242316722336
A Low Down Dirty Shame,11/23/1994,10000000,29392418,19392418,2.9392418
Passenger 57,11/5/1992,15000000,44065653,29065653,2.9377102
Cocktail,7/13/2012,6400000,18800000,12400000,2.9375
The Great Escape,6/20/1963,4000000,11744471,7744471,2.93611775
Swing Time,8/27/1936,886000,2600000,1714000,2.9345372460496613
The Italian Job,5/30/2003,60000000,176070171,116070171,2.93450285
Inferno,10/13/2016,75000000,220021259,145021259,2.9336167866666667
कट्यार काळजात घुसली,11/12/2015,1500000,4400000,2900000,2.933333333333333
The Fifth Element,5/7/1997,90000000,263920180,173920180,2.9324464444444445
Quantum of Solace,10/30/2008,200000000,586090727,386090727,2.930453635
Corpse Bride,9/9/2005,40000000,117195061,77195061,2.929876525
十三人の刺客,9/9/2010,6000000,17555141,11555141,2.9258568333333335
Think Like a Man Too,6/20/2014,24000000,70181428,46181428,2.9242261666666667
Mary and Max,2/9/2009,590235,1725381,1135146,2.9232102467661187
Wall Street,12/10/1987,15000000,43848069,28848069,2.9232046
Hop,3/30/2011,63000000,183953723,120953723,2.919900365079365
Bathing Beauty,7/1/1944,2361000,6892000,4531000,2.919102075391783
Braveheart,5/24/1995,72000000,210000000,138000000,2.9166666666666665
Captain Underpants: The First Epic Movie,6/1/2017,38000000,110824373,72824373,2.9164308684210525
Godzilla,5/20/1998,130000000,379014294,249014294,2.9154945692307694
Blade,8/21/1998,45000000,131183530,86183530,2.9151895555555556
The Day the Earth Stood Still,12/10/2008,80000000,233093859,153093859,2.9136732375
Brave,6/21/2012,185000000,538983207,353983207,2.9134227405405406
Sliver,5/21/1993,40000000,116300000,76300000,2.9075
The Transporter Refueled,9/3/2015,25000000,72629670,47629670,2.9051868
Noah,3/20/2014,125000000,362637473,237637473,2.901099784
Halloween: Resurrection,7/1/2002,13000000,37664855,24664855,2.8972965384615383
WALL·E,6/22/2008,180000000,521311860,341311860,2.896177
Action Jackson,2/12/1988,7000000,20256975,13256975,2.8938535714285716
Battle: Los Angeles,3/8/2011,70000000,202466756,132466756,2.8923822285714285
The 5th Wave,1/14/2016,38000000,109906372,71906372,2.892272947368421
I Am Number Four,2/18/2011,50000000,144492830,94492830,2.8898566
Big Eyes,12/24/2014,10000000,28883511,18883511,2.8883511
Amadeus,10/26/1984,18000000,51973029,33973029,2.8873905
Get Smart,6/19/2008,80000000,230685453,150685453,2.8835681625
Sex and the City 2,5/26/2010,100000000,288347692,188347692,2.88347692
Click,6/22/2006,82500000,237681299,155181299,2.8809854424242425
Drumline,12/13/2002,20000000,57588485,37588485,2.87942425
History of the World: Part I,6/12/1981,11000000,31672907,20672907,2.8793551818181817
Swimming Pool,5/18/2003,7800000,22441323,14641323,2.8770926923076923
Vertical Limit,12/8/2000,75000000,215663859,140663859,2.87551812
Resident Evil: Apocalypse,9/10/2004,45000000,129394835,84394835,2.875440777777778
King of Kings,10/11/1961,5037000,14483352,9446352,2.875392495533055
Boogie Nights,9/11/1997,15000000,43101594,28101594,2.8734396
Bajirao Mastani,12/18/2015,19500000,56000000,36500000,2.871794871794872
The Lake House,6/16/2006,40000000,114830111,74830111,2.870752775
Charlie's Angels,11/2/2000,92000000,264105545,172105545,2.870712445652174
Blade II,3/22/2002,54000000,155010032,101010032,2.870556148148148
The X Files,6/19/1998,66000000,189198313,123198313,2.866641106060606
The Shack,3/3/2017,20000000,57330873,37330873,2.86654365
The Men Who Stare at Goats,10/17/2009,24000000,68729358,44729358,2.86372325
प्रे�?रत�?धन पायो,11/11/2015,23400000,67000000,43600000,2.8632478632478633
Antz,10/2/1998,60000000,171757863,111757863,2.86263105
The Adventures of Tintin,10/25/2011,130000000,371940071,241940071,2.861077469230769
G.I. Joe: Retaliation,3/26/2013,130000000,371876278,241876278,2.860586753846154
12 Angry Men,3/25/1957,350000,1000000,650000,2.857142857142857
Eyes of Laura Mars,8/2/1978,7000000,20000000,13000000,2.857142857142857
Wreck-It Ralph,11/1/2012,165000000,471222889,306222889,2.855896296969697
Rocky V,10/18/1990,42000000,119946358,77946358,2.855865666666667
High Plains Drifter,4/19/1973,5500000,15700000,10200000,2.8545454545454545
Sunset Boulevard,8/10/1950,1752000,5000000,3248000,2.853881278538813
Dracula,2/12/1931,355000,1012189,657189,2.8512366197183097
My Beautiful Laundrette,9/7/1985,860000,2451545,1591545,2.8506337209302326
Heartbreak Ridge,12/15/1986,15000000,42724017,27724017,2.8482678
Terminator Genisys,6/23/2015,155000000,440603537,285603537,2.842603464516129
Troy,5/13/2004,175000000,497409852,322409852,2.8423420114285713
Street Fighter,12/22/1994,35000000,99423521,64423521,2.8406720285714284
The Counselor,10/25/2013,25000000,71009334,46009334,2.84037336
John Q,2/15/2002,36000000,102244770,66244770,2.8401325
Apocalypse Now,8/15/1979,31500000,89460381,57960381,2.8400120952380954
The Sum of All Fears,5/31/2002,68000000,193000000,125000000,2.838235294117647
Starsky & Hutch,3/5/2004,60000000,170268750,110268750,2.8378125
Thelma & Louise,5/24/1991,16000000,45361000,29361000,2.8350625
Out for Justice,4/12/1991,14000000,39673161,25673161,2.833797214285714
Singin' in the Rain,4/10/1952,2540800,7200000,4659200,2.8337531486146097
The Matrix Revolutions,11/5/2003,150000000,424988211,274988211,2.83325474
Paul Blart: Mall Cop 2,4/16/2015,38000000,107597242,69597242,2.8315063684210524
Katyń,9/21/2007,5200000,14723313,9523313,2.8314063461538463
Léon,9/14/1994,16000000,45284974,29284974,2.830310875
Penguins of Madagascar,11/22/2014,132000000,373552094,241552094,2.829940106060606
Drive Me Crazy,10/1/1999,8000000,22593409,14593409,2.824176125
Meet the Spartans,1/24/2008,30000000,84646831,54646831,2.8215610333333334
The House Bunny,8/22/2008,25000000,70442940,45442940,2.8177176
Maid in Manhattan,12/13/2002,55000000,154906693,99906693,2.8164853272727273
The Newton Boys,3/26/1998,27000000,76000000,49000000,2.814814814814815
रान्झाना,6/21/2013,6400000,18000000,11600000,2.8125
TMNT,3/23/2007,34000000,95608995,61608995,2.8120292647058824
How the Grinch Stole Christmas,11/17/2000,123000000,345141403,222141403,2.8060276666666666
License to Drive,7/6/1988,8000000,22433275,14433275,2.804159375
Sicario,9/17/2015,30000000,84025816,54025816,2.800860533333333
The Hurt Locker,10/10/2008,15000000,42000000,27000000,2.8
Friday the 13th Part VIII: Jason Takes Manhattan,7/28/1989,5000000,14000000,9000000,2.8
Parrish,5/4/1961,1500000,4200000,2700000,2.8
The Forgotten,9/24/2004,42000000,117575636,75575636,2.799419904761905
The Serpent and the Rainbow,2/5/1988,7000000,19595031,12595031,2.799290142857143
Cars 2,6/11/2011,200000000,559852396,359852396,2.79926198
Beowulf,11/5/2007,70000000,195735876,125735876,2.7962268
Get Hard,3/26/2015,40000000,111811453,71811453,2.795286325
Demolition Man,10/8/1993,57000000,159055768,102055768,2.7904520701754385
葉問2: 宗師傳奇,4/21/2010,12902809,36000000,23097191,2.790090126886324
The Tourist,12/8/2010,100000000,278731369,178731369,2.78731369
Enemy of the State,11/20/1998,90000000,250649836,160649836,2.7849981777777777
Life As We Know It,10/2/2010,38000000,105610124,67610124,2.779213789473684
Dinosaur,5/19/2000,127500000,354248063,226748063,2.7784161803921568
Logan's Run,6/23/1976,9000000,25000000,16000000,2.7777777777777777
Trolls,10/13/2016,125000000,346864462,221864462,2.774915696
Men in Black 3,5/23/2012,225000000,624026776,399026776,2.773452337777778
A Nightmare on Elm Street 5: The Dream Child,8/11/1989,8000000,22168359,14168359,2.771044875
Fright Night,8/2/1985,9000000,24922237,15922237,2.7691374444444445
Pixels,7/16/2015,88000000,243637091,155637091,2.7686033068181817
Serendipity,10/5/2001,28000000,77516304,49516304,2.7684394285714284
Date Night,4/8/2010,55000000,152263880,97263880,2.768434181818182
The Mummy: Tomb of the Dragon Emperor,7/1/2008,145000000,401128639,256128639,2.7664044068965516
The Conversation,4/7/1974,1600000,4420000,2820000,2.7625
The Dictator,5/15/2012,65000000,179379533,114379533,2.759685123076923
Плюс один,8/21/2008,336029,927277,591248,2.7595148037818165
The Great Mouse Detective,7/2/1986,14000000,38625550,24625550,2.7589678571428573
Passengers,12/21/2016,110000000,303144152,193144152,2.7558559272727274
The Scorpion King,4/16/2002,60000000,165333180,105333180,2.755553
Urban Legends: Final Cut,9/19/2000,14000000,38574362,24574362,2.7553115714285714
Night at the Museum: Battle of the Smithsonian,5/20/2009,150000000,413106170,263106170,2.7540411333333332
Pirates of the Caribbean: On Stranger Tides,5/14/2011,380000000,1045713802,665713802,2.7518784263157894
Barbershop: The Next Cut,4/15/2016,20000000,55030051,35030051,2.75150255
Night at the Museum: Secret of the Tomb,12/17/2014,127000000,349424282,222424282,2.7513722992125986
Child's Play 2,11/9/1990,13000000,35763605,22763605,2.7510465384615386
Wait Until Dark,10/26/1967,4000000,11000000,7000000,2.75
The Crazies,2/26/2010,20000000,54956140,34956140,2.747807
Carrie,10/16/2013,30000000,82394288,52394288,2.746476266666667
Escape to Victory,6/17/1981,10000000,27453418,17453418,2.7453418
The Prestige,10/19/2006,40000000,109676311,69676311,2.741907775
The Spectacular Now,8/2/2013,2500000,6854611,4354611,2.7418444
Daddy Day Care,5/3/2003,60000000,164433867,104433867,2.74056445
Clash of the Titans,3/15/1981,15000000,41092328,26092328,2.739488533333333
Elizabeth,9/13/1998,30000000,82150642,52150642,2.7383547333333333
Dan in Real Life,10/26/2007,25000000,68377859,43377859,2.73511436
Home,3/18/2015,135000000,368871007,233871007,2.7323778296296295
Экипаж,4/21/2016,10000000,27305571,17305571,2.7305571
C.H.U.D.,8/31/1984,1250000,3412497,2162497,2.7299976
Milk,11/26/2008,20000000,54586584,34586584,2.7293292
Where Eagles Dare,12/4/1968,7700000,21000000,13300000,2.727272727272727
Katy Perry: Part of Me,6/28/2012,12000000,32726956,20726956,2.7272463333333334
Goosebumps,8/5/2015,58000000,158162788,100162788,2.7269446206896553
Full Metal Jacket,6/26/1987,17000000,46357676,29357676,2.726922117647059
Poltergeist,5/20/2015,35000000,95437994,60437994,2.7267998285714286
Sicko,5/18/2007,9000000,24538513,15538513,2.7265014444444446
The Darkness,5/13/2016,4000000,10898293,6898293,2.72457325
The Happening,6/11/2008,60000000,163403799,103403799,2.72339665
Shame,10/2/2011,6500000,17693675,11193675,2.7221038461538463
Real Steel,9/28/2011,110000000,299268508,189268508,2.7206228
Ladri di biciclette,11/24/1948,133000,361712,228712,2.719639097744361
Titanic,4/11/1953,1805000,4905000,3100000,2.7174515235457064
The Perfect Storm,3/15/2000,120000000,325756637,205756637,2.714638641666667
The Player,4/3/1992,8000000,21706101,13706101,2.713262625
The Boss,4/7/2016,29000000,78636257,49636257,2.7115950689655173
Touch of Evil,4/23/1958,829000,2247465,1418465,2.7110554885404103
Warcraft,5/25/2016,160000000,433677183,273677183,2.71048239375
Death Becomes Her,7/30/1992,55000000,149022650,94022650,2.7095027272727275
She's the One,8/26/1996,3500000,9482579,5982579,2.7093082857142856
The Gold Rush,6/25/1925,923000,2500000,1577000,2.7085590465872156
Confessions of a Shopaholic,2/5/2009,40000000,108332743,68332743,2.708318575
The Wedding Planner,1/26/2001,35000000,94728529,59728529,2.7065294
Three Fugitives,1/27/1989,15000000,40590000,25590000,2.706
The Dark Crystal,12/17/1982,15000000,40577001,25577001,2.7051334
Nim's Island,4/3/2008,37000000,100076342,63076342,2.704766
Jack Reacher: Never Go Back,10/19/2016,60000000,162146076,102146076,2.7024346
Låt den rätte komma in,1/26/2008,4000000,10785801,6785801,2.69645025
Double Indemnity,4/24/1944,927262,2500000,1572738,2.696109621660329
Miss Peregrine's Home for Peculiar Children,9/28/2016,110000000,296485719,186485719,2.6953247181818183
Sankofa,5/28/1993,1000000,2691899,1691899,2.691899
War Horse,12/25/2011,66000000,177584879,111584879,2.690679984848485
Project Almanac,1/29/2015,12000000,32248241,20248241,2.687353416666667
Just Go with It,2/10/2011,80000000,214918407,134918407,2.6864800875
A League of Their Own,7/1/1992,40000000,107458785,67458785,2.686469625
The Faculty,12/25/1998,15000000,40283321,25283321,2.6855547333333334
Epic,5/15/2013,100000000,268426634,168426634,2.68426634
Insurgent,3/18/2015,110000000,295238201,185238201,2.6839836454545454
Fences,12/16/2016,24000000,64414761,40414761,2.683948375
The Devil's Advocate,10/17/1997,57000000,152944660,95944660,2.683239649122807
Diary of the Dead,9/8/2007,2000000,5364858,3364858,2.682429
Red Dragon,9/29/2002,78000000,209196298,131196298,2.6820038205128207
The Chronicles of Narnia: The Voyage of the Dawn Treader,8/13/2010,155000000,415686217,260686217,2.6818465612903224
The World Is Not Enough,11/8/1999,135000000,361832400,226832400,2.68024
The Giver,8/11/2014,25000000,66980456,41980456,2.67921824
Aanrijding in Moscou,1/30/2008,560000,1500000,940000,2.6785714285714284
Sherlock Holmes: A Game of Shadows,11/22/2011,125000000,334615000,209615000,2.67692
Public Enemies,7/1/2009,80000000,214104620,134104620,2.67630775
All About Steve,9/4/2009,15000000,40105542,25105542,2.6737028
Valkyrie,12/25/2008,75000000,200276000,125276000,2.6703466666666666
The Maltese Falcon,11/18/1941,375000,1000000,625000,2.6666666666666665
Salt,7/21/2010,110000000,293329073,183329073,2.6666279363636365
American Gangster,11/2/2007,100000000,266465037,166465037,2.66465037
Nanny McPhee and the Big Bang,3/26/2010,35000000,93246388,58246388,2.6641825142857143
Transporter 2,8/2/2005,32000000,85167639,53167639,2.66148871875
Bedtime Stories,12/24/2008,80000000,212874442,132874442,2.660930525
Harold & Kumar Go to White Castle,5/30/2004,9000000,23936908,14936908,2.6596564444444444
World War Z,6/20/2013,200000000,531865000,331865000,2.659325
The Santa Clause 2,10/31/2002,65000000,172855065,107855065,2.6593086923076923
King Kong,12/14/2005,207000000,550000000,343000000,2.657004830917874
The Jackal,11/14/1997,60000000,159330280,99330280,2.655504666666667
Prisoners,9/18/2013,46000000,122126687,76126687,2.6549279782608695
Lone Star,6/21/1996,5000000,13269963,8269963,2.6539926
Mission: Impossible III,5/3/2006,150000000,397850012,247850012,2.6523334133333334
Edward Scissorhands,12/5/1990,20000000,53000000,33000000,2.65
Billy Madison,2/10/1995,10000000,26488734,16488734,2.6488734
Footloose,10/6/2011,24000000,63543328,39543328,2.6476386666666665
Captain America: The First Avenger,7/22/2011,140000000,370569774,230569774,2.646926957142857
August Rush,11/21/2007,25000000,66122026,41122026,2.64488104
Perfume: The Story of a Murderer,9/13/2006,50000000,132180323,82180323,2.64360646
Aitraaz,11/12/2004,3500000,9250000,5750000,2.642857142857143
Ringmaster,11/25/1998,3500000,9247881,5747881,2.6422517142857145
Baggage Claim,9/27/2013,8500000,22456509,13956509,2.6419422352941178
National Lampoon's Christmas Vacation,12/1/1989,27000000,71320000,44320000,2.6414814814814815
Anastasia,11/20/1997,53000000,139804348,86804348,2.637817886792453
Gone in Sixty Seconds,6/9/2000,90000000,237202299,147202299,2.6355811
Scarface,12/8/1983,25000000,65884703,40884703,2.63538812
Old Dogs,11/24/2009,35000000,92219310,57219310,2.6348374285714287
The Mask of Zorro,7/16/1998,95000000,250288523,155288523,2.6346160315789473
魔女の宅急便,7/29/1989,6900000,18172849,11272849,2.633746231884058
Saving Grace,1/24/2000,10000000,26330482,16330482,2.6330482
Days of Thunder,6/27/1990,60000000,157920733,97920733,2.632012216666667
Kismat Konnection,7/18/2008,4180000,11000000,6820000,2.6315789473684212
Creepshow,11/12/1982,8000000,21028755,13028755,2.628594375
Halloween II,8/28/2009,15000000,39421467,24421467,2.6280978
The Age of Adaline,4/16/2015,25000000,65663276,40663276,2.62653104
Starter for 10,9/13/2006,8,21,13,2.625
Lowriders,4/28/2017,916000,2403885,1487885,2.6243286026200874
The Switch,5/11/2010,19000000,49830607,30830607,2.6226635263157894
50 First Dates,2/13/2004,75000000,196482882,121482882,2.61977176
Ghost Rider: Spirit of Vengeance,12/10/2011,57000000,149217355,92217355,2.6178483333333333
Soul Surfer,4/8/2011,18000000,47088990,29088990,2.616055
We Own the Night,5/25/2007,21000000,54926886,33926886,2.615566
Silent Hill: Revelation 3D,10/10/2012,20000000,52302796,32302796,2.6151398
The Good Son,9/24/1993,17000000,44456478,27456478,2.615086941176471
Jumper,2/10/2008,85000000,222231186,137231186,2.6144845411764708
The Client,7/20/1994,45000000,117615211,72615211,2.6136713555555557
Derailed,11/11/2005,22000000,57479076,35479076,2.6126852727272727
Legion,1/21/2010,26000000,67918658,41918658,2.6122560769230767
Underworld: Rise of the Lycans,1/22/2009,35000000,91353501,56353501,2.6101000285714284
Anger Management,4/11/2003,75000000,195745823,120745823,2.6099443066666668
13 Going on 30,4/13/2004,37000000,96455697,59455697,2.6069107297297296
Storks,9/22/2016,70000000,182379278,112379278,2.605418257142857
Lyubov V Bolshom Gorode,3/5/2009,3500000,9112193,5612193,2.6034837142857143
Hillary's America: The Secret History of the Democratic Party,7/1/2016,5000000,13000000,8000000,2.6
Johnson Family Vacation,4/7/2004,12000000,31179516,19179516,2.598293
How High,12/21/2001,12000000,31155435,19155435,2.59628625
The Rite,1/28/2011,37000000,96047633,59047633,2.595881972972973
The Time Traveler's Wife,8/14/2009,39000000,101229792,62229792,2.595635692307692
The Mexican,3/1/2001,57000000,147845033,90845033,2.59377250877193
Night of the Demons,10/14/1988,1200000,3109904,1909904,2.5915866666666667
The Thomas Crown Affair,8/6/1999,48000000,124305181,76305181,2.5896912708333333
Shortbus,5/20/2006,2000000,5179037,3179037,2.5895185
Riddick,9/2/2013,38000000,98337295,60337295,2.587823552631579
World Trade Center,8/9/2006,63000000,162945894,99945894,2.586442761904762
The Number 23,2/23/2007,30000000,77566815,47566815,2.5855605
The Girl with the Dragon Tattoo,12/14/2011,90000000,232617430,142617430,2.584638111111111
Biloxi Blues,3/25/1988,20000000,51684798,31684798,2.5842399
Dolphin Tale,9/23/2011,37000000,95404397,58404397,2.578497216216216
It's Complicated,12/23/2009,85000000,219103655,134103655,2.577690058823529
Baywatch,5/12/2017,69000000,177856751,108856751,2.577634072463768
Kiss of the Dragon,7/6/2001,25000000,64437847,39437847,2.57751388
The Water Horse,12/25/2007,40000000,103071443,63071443,2.576786075
The Whole Nine Yards,2/18/2000,41300000,106371651,65071651,2.575584769975787
The Last Dragon,3/22/1985,10000000,25754284,15754284,2.5754284
Star Trek,5/6/2009,150000000,385680446,235680446,2.5712029733333335
Daybreakers,1/6/2009,20000000,51416464,31416464,2.5708232
The Perks of Being a Wallflower,9/20/2012,13000000,33400000,20400000,2.5692307692307694
Failure to Launch,3/10/2006,50000000,128406887,78406887,2.56813774
The Fog,10/14/2005,18000000,46201432,28201432,2.566746222222222
Evita,12/14/1996,55000000,141047179,86047179,2.564494163636364
Horrible Bosses 2,11/26/2014,42000000,107670357,65670357,2.5635799285714285
Broadcast News,12/16/1987,20000000,51249404,31249404,2.5624702
Taps,12/20/1981,14000000,35856053,21856053,2.561146642857143
Can't Hardly Wait,6/12/1998,10000000,25605015,15605015,2.5605015
Coach Carter,1/14/2005,30000000,76669806,46669806,2.5556602
Na Maloom Afraad,10/6/2014,884130,2259444,1375314,2.5555563095924807
King of New York,7/18/1990,1000000,2554476,1554476,2.554476
The Adjustment Bureau,3/3/2011,50200000,127869379,77669379,2.5471987848605577
Doubt,11/27/2008,20000000,50907234,30907234,2.5453617
Office Christmas Party,11/25/2016,45000000,114501299,69501299,2.544473311111111
The Princess and the Frog,12/8/2009,105000000,267045765,162045765,2.543293
Double Jeopardy,9/24/1999,70000000,177841558,107841558,2.5405936857142857
The Hitcher,1/19/2007,10000000,25399945,15399945,2.5399945
Beastly,1/21/2011,17000000,43165571,26165571,2.5391512352941175
Knock Knock,6/26/2015,2500000,6341684,3841684,2.5366736
New Year's Eve,12/8/2011,56000000,142044638,86044638,2.5365113928571428
स्पेशल 26,2/7/2013,7100000,18000000,10900000,2.535211267605634
Yentl,11/18/1983,12000000,30400000,18400000,2.533333333333333
Die Welle,3/11/2008,7500000,19000000,11500000,2.533333333333333
The Godfather: Part III,12/24/1990,54000000,136766062,82766062,2.532704851851852
Coyote Ugly,7/30/2000,45000000,113916474,68916474,2.5314772
The Roommate,2/4/2011,16000000,40492759,24492759,2.5307974375
Killing Them Softly,9/20/2012,15000000,37930465,22930465,2.5286976666666665
EverAfter,7/31/1998,26000000,65705772,39705772,2.5271450769230768
9 рота,9/19/2005,9500000,24000000,14500000,2.526315789473684
Mad Max: Fury Road,5/13/2015,150000000,378858340,228858340,2.5257222666666665
The Proposition,10/6/2005,2000000,5048693,3048693,2.5243465
Contraband,1/12/2012,25000000,63100000,38100000,2.524
Vamp,7/18/1986,1900000,4790926,2890926,2.52154
Yogi Bear,12/11/2010,80000000,201584141,121584141,2.5198017625
Don't Tell Mom the Babysitter's Dead,6/7/1991,10000000,25196249,15196249,2.5196249
30 Days of Night,10/17/2007,30000000,75505973,45505973,2.5168657666666667
This Is 40,12/20/2012,35000000,88058786,53058786,2.5159653142857143
Above the Law,4/8/1988,7500000,18869631,11369631,2.5159508
Dr. Dolittle 2,6/22/2001,70000000,176104344,106104344,2.515776342857143
Unbroken,12/25/2014,65000000,163442937,98442937,2.514506723076923
Houseguest,1/6/1995,10500000,26325256,15825256,2.507167238095238
Hellraiser III: Hell on Earth,9/11/1992,5000000,12534961,7534961,2.5069922
Nacho Libre,6/16/2006,32000000,80197993,48197993,2.50618728125
Sophie's Choice,12/8/1982,12000000,30036000,18036000,2.503
A Walk in the Clouds,8/11/1995,20000000,50012507,30012507,2.50062535
The Man Who Shot Liberty Valance,4/22/1962,3200000,8000000,4800000,2.5
दि�?से,8/22/1998,5200000,13000000,7800000,2.5
Sweet Charity,1/1/1969,8000000,20000000,12000000,2.5
Italiano medio,1/29/2015,1816720,4541800,2725080,2.5
"\"कि�?\"\"An adrenaline junkie walks away from a whirlwind romance and embraces a new life as a thief\"",7/25/2014,22000000,55000000,33000000,2.5
Baahubali: The Beginning,7/10/2015,40000000,100000000,60000000,2.5
Almost Christmas,11/11/2016,17000000,42487325,25487325,2.499254411764706
Love the Coopers,11/12/2015,17000000,42426912,25426912,2.495700705882353
The General's Daughter,6/18/1999,60000000,149705852,89705852,2.4950975333333334
Batman Begins,6/10/2005,150000000,374218673,224218673,2.4947911533333333
Eyes Wide Shut,7/14/1999,65000000,162091208,97091208,2.4937108923076923
The Prince of Tides,12/25/1991,30000000,74787599,44787599,2.492919966666667
Eragon,12/14/2006,100000000,249288105,149288105,2.49288105
Irrational Man,7/17/2015,11000000,27391084,16391084,2.4900985454545457
Frankenstein,11/4/1994,45000000,112006296,67006296,2.4890288
She's Out of My League,3/11/2010,20000000,49779728,29779728,2.4889864
Elysium,8/7/2013,115000000,286140700,171140700,2.48818
The Peanuts Movie,11/5/2015,99000000,246233113,147233113,2.4872031616161614
X-Men Origins: Wolverine,4/28/2009,150000000,373062864,223062864,2.48708576
White Fang,1/18/1991,14000000,34793160,20793160,2.4852257142857144
Tot yeshchyo Karloson!,3/15/2012,4000000,9938268,5938268,2.484567
Unlawful Entry,6/26/1992,23000000,57138719,34138719,2.4842921304347825
The Fox and the Hound,7/10/1981,12000000,29800000,17800000,2.4833333333333334
Død snø,1/9/2009,800000,1984662,1184662,2.4808275
Dangerous Liaisons,12/16/1988,14000000,34670720,20670720,2.47648
Megamind,10/28/2010,130000000,321887208,191887208,2.476055446153846
Insomnia,5/24/2002,46000000,113714830,67714830,2.4720615217391306
Home Alone 3,12/12/1997,32000000,79082515,47082515,2.47132859375
Sky High,7/29/2005,35000000,86369815,51369815,2.467709
Brick Mansions,4/22/2014,28000000,68896829,40896829,2.460601035714286
Star Trek Into Darkness,5/5/2013,190000000,467365246,277365246,2.4598170842105263
Oz: The Great and Powerful,3/7/2013,200000000,491868548,291868548,2.45934274
Escape Plan,10/9/2013,50000000,122915111,72915111,2.45830222
Ex Machina,1/21/2015,15000000,36869414,21869414,2.457960933333333
Donovan's Reef,6/12/1963,2686000,6600000,3914000,2.4571854058078926
Couples Retreat,9/19/2009,70000000,171844840,101844840,2.4549262857142855
ആമേൻ,3/21/2013,110000,270000,160000,2.4545454545454546
V for Vendetta,3/15/2006,54000000,132511035,78511035,2.4539080555555555
Orca: The Killer Whale,7/22/1977,6000000,14717854,8717854,2.4529756666666667
Scarlet Street,12/28/1945,1202007,2948386,1746379,2.4528858816961963
The Magnificent Seven,10/22/1960,2000000,4905000,2905000,2.4525
Alan Partridge: Alpha Papa,7/24/2013,4000000,9800000,5800000,2.45
Bad Dreams,4/8/1988,4000000,9797098,5797098,2.4492745
Safe House,2/9/2012,85000000,208076205,123076205,2.4479553529411766
Lone Wolf McQuade,4/14/1983,5000000,12232628,7232628,2.4465256
AVP: Alien vs. Predator,8/12/2004,70000000,171183863,101183863,2.445483757142857
Max Payne,10/15/2008,35000000,85416905,50416905,2.440483
Solomon and Sheba,12/25/1959,5000000,12200000,7200000,2.44
Le Pacte des loups,1/31/2001,29000000,70752904,41752904,2.4397553103448275
Paul,2/14/2011,40000000,97552050,57552050,2.43880125
Poison,4/5/1991,250000,609524,359524,2.438096
Poslednyaya skazka Rity,11/1/2012,200000,486937,286937,2.434685
Hercules,7/23/2014,100000000,243400000,143400000,2.434
War for the Planet of the Apes,7/11/2017,152000000,369907963,217907963,2.433605019736842
Cloudy with a Chance of Meatballs,9/17/2009,100000000,242988466,142988466,2.42988466
Scream 4,4/11/2011,40000000,97138686,57138686,2.42846715
Collateral Beauty,12/6/2016,36000000,87416021,51416021,2.4282228055555555
Phantasm II,7/8/1988,3000000,7282851,4282851,2.427617
Date Movie,2/17/2006,20000000,48548426,28548426,2.4274213
Cabin in the Sky,4/9/1943,662141,1606624,944483,2.4264076684573226
The Beguiled,6/23/2017,10500000,25442939,14942939,2.4231370476190475
Eraser,6/21/1996,100000000,242295562,142295562,2.42295562
J. Edgar,11/9/2011,35000000,84606030,49606030,2.417315142857143
8MM,2/26/1999,40000000,96618699,56618699,2.415467475
This Means War,2/14/2012,65000000,156974557,91974557,2.4149931846153847
Sous les jupes des filles,6/4/2014,5000000,12058187,7058187,2.4116374
The Killing Fields,11/2/1984,14400000,34700291,20300291,2.4097424305555557
Déjà Vu,11/22/2006,75000000,180557550,105557550,2.407434
House of 1000 Corpses,4/11/2003,7000000,16829545,9829545,2.404220714285714
Sidewalks of New York,11/23/2001,1000000,2402459,1402459,2.402459
Ostrov Vezeniya,12/5/2013,2000000,4803665,2803665,2.4018325
We Bought a Zoo,12/22/2011,50000000,120081841,70081841,2.40163682
Black or White,9/6/2014,9000000,21571189,12571189,2.3967987777777777
Alien: Covenant,5/9/2017,97000000,232380243,135380243,2.395672608247423
Oliver & Company,11/18/1988,31000000,74151346,43151346,2.3919789032258065
Always,12/22/1989,31000000,74134790,43134790,2.3914448387096776
Barbecue,4/30/2014,6000000,14348529,8348529,2.3914215
Law Abiding Citizen,10/15/2009,53000000,126690726,73690726,2.3903910566037734
Black Christmas,12/25/2006,9000000,21510851,12510851,2.3900945555555557
Lara Croft: Tomb Raider,6/11/2001,115000000,274703340,159703340,2.388724695652174
Get on the Bus,10/16/1996,2400000,5731103,3331103,2.387959583333333
The Nanny Diaries,8/24/2007,20000000,47738099,27738099,2.38690495
Oblivion,4/10/2013,120000000,286168572,166168572,2.3847381
The Nutty Professor,6/26/1996,54000000,128769345,74769345,2.3846175
Home Run,4/19/2013,1200000,2861020,1661020,2.3841833333333335
Percy Jackson & the Olympians: The Lightning Thief,2/1/2010,95000000,226497209,131497209,2.384181147368421
Beverly Hills Cop III,5/24/1994,50000000,119208989,69208989,2.38417978
Unfaithful,5/10/2002,50000000,119137784,69137784,2.38275568
L.I.E. Long Island Expressway,1/20/2001,700000,1667192,967192,2.3817028571428573
Heropanti,5/23/2014,4200000,10000000,5800000,2.380952380952381
The Wizard,12/15/1989,6000000,14278900,8278900,2.3798166666666667
The Heart is Deceitful Above All Things,9/15/2004,74050,176153,102103,2.3788386225523297
The Princess Diaries 2: Royal Engagement,8/6/2004,40000000,95149435,55149435,2.378735875
The To Do List,7/24/2013,1500000,3566225,2066225,2.377483333333333
Angels & Demons,5/13/2009,150000000,356613439,206613439,2.3774229266666667
42,4/12/2013,40000000,95020213,55020213,2.375505325
Rush,9/2/2013,38000000,90247624,52247624,2.3749374736842106
Buffy the Vampire Slayer,7/24/1992,7000000,16624456,9624456,2.3749222857142858
Murphy's Romance,12/25/1985,13000000,30867525,17867525,2.374425
Pat Garrett & Billy the Kid,5/23/1973,4638783,11000000,6361217,2.3713116134123973
Akeelah and the Bee,4/28/2006,8000000,18948425,10948425,2.368553125
Good Luck Chuck,9/21/2007,25000000,59192128,34192128,2.36768512
No Way Out,8/14/1987,15000000,35509515,20509515,2.367301
Cinderfella,12/18/1960,3000000,7100000,4100000,2.3666666666666667
The Place Beyond the Pines,3/20/2013,15000000,35485608,20485608,2.3657072
Flatliners,8/9/1990,26000000,61489265,35489265,2.3649717307692306
La vie d'Adèle - Chapitres 1 et 2,10/9/2013,4300000,10165694,5865694,2.36411488372093
Texas Chainsaw 3D,1/3/2013,20000000,47241945,27241945,2.36209725
Independence Day: Resurgence,6/22/2016,165000000,389681935,224681935,2.3617086969696968
Бой с Тенью,3/5/2005,3500000,8262833,4762833,2.3608094285714287
A.I. Artificial Intelligence,6/29/2001,100000000,235926552,135926552,2.35926552
After Hours,9/13/1985,4500000,10609321,6109321,2.357626888888889
How To Make An American Quilt,10/6/1995,10000000,23574130,13574130,2.357413
TRON: Legacy,12/10/2010,170000000,400062763,230062763,2.3533103705882352
Middle School: The Worst Years of My Life,10/7/2016,8500000,19985196,11485196,2.351199529411765
எந்திரன்,10/1/2010,26400000,62000000,35600000,2.3484848484848486
Dilwale,12/18/2015,26000000,61000000,35000000,2.3461538461538463
Fantastic Voyage,8/24/1966,5115000,12000000,6885000,2.346041055718475
Abduction,9/22/2011,35000000,82087155,47087155,2.345347285714286
Los amantes pasajeros,3/8/2013,5000000,11724119,6724119,2.3448238
Tooth Fairy,1/14/2010,48000000,112462508,64462508,2.3429689166666665
Queen Christina,12/26/1933,1114000,2610000,1496000,2.342908438061041
Six Days Seven Nights,6/12/1998,70000000,164000000,94000000,2.342857142857143
Hitman: Agent 47,8/20/2015,35000000,81967450,46967450,2.3419271428571427
Star Trek V: The Final Frontier,6/9/1989,30000000,70200000,40200000,2.34
Whatever Works,6/19/2009,15000000,35097815,20097815,2.3398543333333333
Death at a Funeral,4/15/2010,21000000,49050886,28050886,2.3357564761904763
Mike and Dave Need Wedding Dates,7/7/2016,33000000,77068246,44068246,2.335401393939394
The Skulls,3/31/2000,15000000,35007180,20007180,2.333812
Silent Rage,4/2/1982,4500000,10500000,6000000,2.3333333333333335
Picture Perfect,8/1/1997,19000000,44332015,25332015,2.333263947368421
Snow White and the Huntsman,5/30/2012,170000000,396600000,226600000,2.3329411764705883
Because of Winn-Dixie,2/18/2005,14000000,32645546,18645546,2.3318247142857143
Training Day,10/5/2001,45000000,104876233,59876233,2.3305829555555557
Shaft,6/15/2000,46000000,107196498,61196498,2.330358652173913
Halloween 5: The Revenge of Michael Myers,10/12/1989,5000000,11642254,6642254,2.3284508
Transformers: The Last Knight,6/21/2017,260000000,604942143,344942143,2.32670055
A Few Best Men,10/14/2011,12468389,29007412,16539023,2.326476339485398
Secretary,1/11/2002,4000000,9304609,5304609,2.32615225
The Forbidden Kingdom,4/18/2008,55000000,127906624,72906624,2.325574981818182
Secret Window,3/12/2004,40000000,92913171,52913171,2.322829275
Open Season,9/29/2006,85000000,197309027,112309027,2.3212826705882352
The Longest Yard,5/19/2005,82000000,190320568,108320568,2.320982536585366
Jungle Fever,6/7/1991,14000000,32482682,18482682,2.3201915714285715
First Knight,7/7/1995,55000000,127600435,72600435,2.320007909090909
Locke,4/10/2014,2000000,4635300,2635300,2.31765
Final Destination,3/16/2000,23000000,53302314,30302314,2.317491913043478
Underworld: Blood Wars,11/28/2016,35000000,81093313,46093313,2.3169518
The Shining,5/22/1980,19000000,44017374,25017374,2.316703894736842
Alien: Resurrection,11/12/1997,70000000,162000000,92000000,2.3142857142857145
Pitch Black,2/18/2000,23000000,53187659,30187659,2.312506913043478
Moby Dick,6/27/1956,4500000,10400000,5900000,2.311111111111111
Hall Pass,2/25/2011,36000000,83160734,47160734,2.310020388888889
Constantine,2/8/2005,100000000,230884728,130884728,2.30884728
Ben-Hur: A Tale of the Christ,12/30/1925,3900000,9000000,5100000,2.3076923076923075
Mississippi Burning,12/8/1988,15000000,34604000,19604000,2.3069333333333333
A Bridge Too Far,6/15/1977,22000000,50750000,28750000,2.3068181818181817
The World's End,7/18/2013,20000000,46089287,26089287,2.30446435
Hawaii,10/10/1966,15000000,34562222,19562222,2.3041481333333333
Risen,2/19/2016,20000000,46069568,26069568,2.3034784
In Bruges,2/8/2008,15000000,34533783,19533783,2.3022522
Miracle,2/6/2004,28000000,64445708,36445708,2.3016324285714287
T2 Trainspotting,1/27/2017,18000000,41412709,23412709,2.3007060555555556
Thirteen,8/20/2003,2000000,4601043,2601043,2.3005215
Olympus Has Fallen,3/20/2013,70000000,161025640,91025640,2.300366285714286
Peggy Sue Got Married,10/5/1986,18000000,41382841,23382841,2.299046722222222
The League of Extraordinary Gentlemen,7/11/2003,78000000,179265204,101265204,2.2982718461538463
Living in Oblivion,1/20/1995,500000,1148752,648752,2.297504
कभी अलविदा ना कहना,8/11/2006,7400000,17000000,9600000,2.2972972972972974
Daredevil,2/14/2003,78000000,179179718,101179718,2.2971758717948716
Far and Away,5/22/1992,60000000,137783840,77783840,2.296397333333333
Ricki and the Flash,7/10/2015,18000000,41325328,23325328,2.2958515555555556
Mrs Palfrey at The Claremont,11/25/2005,750000,1720953,970953,2.294604
Behind Enemy Lines,11/17/2001,40000000,91753202,51753202,2.29383005
Bridge to Terabithia,2/16/2007,60000000,137587063,77587063,2.2931177166666665
Contagion,9/8/2011,60000000,137551594,77551594,2.2925265666666665
Brewster's Millions,5/22/1985,20000000,45833132,25833132,2.2916566
The Expendables 3,8/4/2014,90000000,206172544,116172544,2.2908060444444445
Gong fu guan lan,2/7/2008,10000000,22896728,12896728,2.2896728
Underworld: Awakening,1/19/2012,70000000,160112671,90112671,2.2873238714285713
Mutiny on the Bounty,11/8/1935,1950000,4460000,2510000,2.287179487179487
Zulu,1/22/1964,3500000,8000000,4500000,2.2857142857142856
Бумер,8/2/2003,700000,1600000,900000,2.2857142857142856
Gabbar Singh,5/11/2012,7000000,16000000,9000000,2.2857142857142856
3 Godfathers,12/1/1948,1243000,2841000,1598000,2.285599356395817
The Holiday,12/8/2006,85000000,194168700,109168700,2.2843376470588237
Now and Then,10/20/1995,12000000,27400000,15400000,2.283333333333333
Arrambam,10/31/2013,9200000,21000000,11800000,2.282608695652174
Cleopatra,6/12/1963,31115000,71000000,39885000,2.2818576249397395
The Debt,4/11/2010,20000000,45636368,25636368,2.2818184
The Charge of the Light Brigade,10/20/1936,1200000,2736000,1536000,2.28
Porky's Revenge,3/22/1985,9000000,20518905,11518905,2.2798783333333335
The X Files: I Want to Believe,7/24/2008,30000000,68369434,38369434,2.278981133333333
John Tucker Must Die,7/27/2006,18000000,41009669,23009669,2.2783149444444444
Tangled,11/24/2010,260000000,591794936,331794936,2.2761343692307694
Wrong Turn,5/30/2003,12600000,28650575,16050575,2.2738551587301585
Top Secret!,6/8/1984,9000000,20458340,11458340,2.273148888888889
Сталинград,10/9/2013,30000000,68129518,38129518,2.2709839333333335
The Crush,4/2/1993,6000000,13609396,7609396,2.2682326666666666
Woman Thou Art Loosed,9/30/2004,3000000,6804016,3804016,2.2680053333333334
Striptease,6/28/1996,50000000,113309743,63309743,2.26619486
Another Year,11/5/2010,8000000,18124262,10124262,2.26553275
Rambo,1/24/2008,50000000,113244290,63244290,2.2648858
Pacific Rim,7/11/2013,180000000,407602906,227602906,2.264460588888889
Road to Perdition,7/12/2002,80000000,181001478,101001478,2.262518475
Becoming Jane,3/2/2007,16500000,37311672,20811672,2.2613134545454545
Tombstone,12/25/1993,25000000,56505065,31505065,2.2602026
Journey to the Center of the Earth,7/10/2008,45000000,101702060,56702060,2.2600457777777776
Cradle 2 the Grave,2/28/2003,25000000,56489558,31489558,2.25958232
Legok na Pomine,2/27/2014,2153912,4864560,2710648,2.2584766694275347
இன்ற�?நேற்று நாளை,6/26/2015,620000,1400000,780000,2.2580645161290325
Cellular,9/6/2004,25000000,56422687,31422687,2.25690748
Stuart Little,12/17/1999,133000000,300135367,167135367,2.256656894736842
Jaws: The Revenge,7/17/1987,23000000,51881013,28881013,2.2556962173913044
Rough Night,6/15/2017,20000000,45056771,25056771,2.25283855
Where the Heart Is,4/27/2000,15000000,33771174,18771174,2.2514116
Get Him to the Greek,6/4/2010,40000000,90029656,50029656,2.2507414
The Way of the Gun,9/8/2000,8500000,19125401,10625401,2.2500471764705883
Re-Animator,10/18/1985,900000,2023414,1123414,2.248237777777778
Talladega Nights: The Ballad of Ricky Bobby,8/4/2006,72500000,162966177,90466177,2.2478093379310344
Scaramouche,5/8/1952,3005000,6746000,3741000,2.2449251247920134
The First Power,4/6/1990,10000000,22424195,12424195,2.2424195
Kiss the Girls,10/3/1997,27000000,60527873,33527873,2.2417730740740742
You Don't Mess with the Zohan,6/5/2008,90000000,201596308,111596308,2.239958977777778
Knight and Day,6/15/2010,117000000,261930431,144930431,2.2387216324786325
Prince of Persia: The Sands of Time,5/19/2010,150000000,335154643,185154643,2.2343642866666666
Casino,11/22/1995,52000000,116112375,64112375,2.2329302884615383
Пиковая дама: Черный обряд,9/10/2015,1000000,2228115,1228115,2.228115
Underworld: Evolution,1/12/2006,50000000,111340801,61340801,2.22681602
Red Eye,8/4/2005,26000000,57891803,31891803,2.2266078076923077
Trading Places,6/7/1983,40600000,90400000,49800000,2.226600985221675
The Curious Case of Benjamin Button,11/24/2008,150000000,333932083,183932083,2.2262138866666668
Eagle Eye,9/25/2008,80000000,178066569,98066569,2.2258321125
Flubber,11/26/1997,80000000,177977226,97977226,2.224715325
4: Rise of the Silver Surfer,6/13/2007,130000000,289047763,159047763,2.223444330769231
Great Expectations,1/19/1998,25000000,55494066,30494066,2.21976264
Executive Decision,3/15/1996,55000000,121969216,66969216,2.217622109090909
The Cabin in the Woods,4/12/2012,30000000,66486080,36486080,2.2162026666666668
The Dukes of Hazzard,8/5/2005,50000000,110803676,60803676,2.21607352
Before Sunrise,1/27/1995,2500000,5535405,3035405,2.214162
The Monuments Men,1/24/2014,70000000,154984035,84984035,2.214057642857143
The Back-Up Plan,4/23/2010,35000000,77477008,42477008,2.2136288
Dreamgirls,12/25/2006,70000000,154937680,84937680,2.213395428571429
Snowpiercer,8/1/2013,39200000,86758912,47558912,2.2132375510204083
The Great Wall,12/16/2016,150000000,331957105,181957105,2.213047366666667
Analyze This,3/5/1999,80000000,176885658,96885658,2.211070725
Pete's Dragon,8/10/2016,65000000,143695338,78695338,2.210697507692308
X-Men: First Class,5/24/2011,160000000,353624124,193624124,2.210150775
The Phantom of the Opera,12/8/2004,70000000,154648887,84648887,2.2092698142857143
Dick Tracy,6/15/1990,47000000,103738726,56738726,2.2072069361702127
The Words,9/7/2012,6000000,13231461,7231461,2.2052435
Moneyball,9/22/2011,50000000,110206216,60206216,2.20412432
Season of the Witch,1/7/2011,40000000,88100000,48100000,2.2025
Expelled: No Intelligence Allowed,4/18/2008,3500000,7700000,4200000,2.2
99,5/15/2009,3000000,6600000,3600000,2.2
Captive,9/5/2012,11180,24591,13411,2.1995527728085866
Max,6/26/2015,20000000,43967255,23967255,2.19836275
Bølgen,8/28/2015,5904067,12975143,7071076,2.197661882902074
Frequency,4/28/2000,31000000,68106245,37106245,2.1969756451612903
Exorcist II: The Heretic,6/17/1977,14000000,30749142,16749142,2.1963672857142855
Spawn,7/31/1997,40000000,87840042,47840042,2.19600105
Courage Under Fire,7/4/1996,46000000,100860818,54860818,2.1926264782608698
Las aventuras de Tadeo Jones,8/31/2012,10500000,23000000,12500000,2.1904761904761907
Cold Mountain,12/24/2003,79000000,173013509,94013509,2.190044417721519
I Now Pronounce You Chuck & Larry,7/12/2007,85000000,186072214,101072214,2.189084870588235
The Game,9/12/1997,50000000,109423648,59423648,2.18847296
The Cable Guy,6/10/1996,47000000,102825796,55825796,2.187782893617021
X-Men: The Last Stand,5/24/2006,210000000,459359555,249359555,2.1874264523809526
Blind Date,3/27/1987,18000000,39321715,21321715,2.184539722222222
Half Baked,1/16/1998,8000000,17460020,9460020,2.1825025
The Last House on the Left,3/13/2009,15000000,32721635,17721635,2.1814423333333335
Monsters vs Aliens,3/19/2009,175000000,381509870,206509870,2.1800564
Corky Romano,10/12/2001,11000000,23978402,12978402,2.179854727272727
My Blueberry Nights,5/16/2007,10000000,21786738,11786738,2.1786738
Sorority Row,9/9/2009,12500000,27206120,14706120,2.1764896
Terminator 3: Rise of the Machines,7/2/2003,200000000,435000000,235000000,2.175
Ji jie hao,10/9/2007,16000000,34786960,18786960,2.174185
Josh,6/9/2000,6900000,15000000,8100000,2.1739130434782608
The Illusionist,8/18/2006,40000000,86915017,46915017,2.172875425
Hotel Rwanda,9/11/2004,17500000,38000000,20500000,2.1714285714285713
Zoolander,9/28/2001,28000000,60780981,32780981,2.1707493214285716
The November Man,8/27/2014,15000000,32556119,17556119,2.1704079333333333
Kick-Ass 2,7/17/2013,28000000,60700000,32700000,2.1678571428571427
Kandagar,2/4/2010,7000000,15172408,8172408,2.167486857142857
But I'm a Cheerleader,9/12/1999,1200000,2600000,1400000,2.1666666666666665
Jingle All the Way,11/15/1996,60000000,129832389,69832389,2.16387315
Conversations with Other Women,6/7/2006,450000,973525,523525,2.163388888888889
The Rookie,12/6/1990,10000000,21633874,11633874,2.1633874
2 Guns,8/2/2013,61000000,131940411,70940411,2.162957557377049
Man's Best Friend,11/19/1993,6000000,12974636,6974636,2.1624393333333334
102 Dalmatians,10/7/2000,85000000,183611771,98611771,2.160138482352941
Charlie's Angels: Full Throttle,6/27/2003,120000000,259175788,139175788,2.1597982333333334
Mud,5/1/2013,10000000,21587700,11587700,2.15877
Takers,8/26/2010,32000000,69055695,37055695,2.15799046875
Poltergeist II: The Other Side,5/23/1986,19000000,40996665,21996665,2.1577192105263157
War Dogs,8/17/2016,40000000,86234523,46234523,2.155863075
The Darkest Hour,12/22/2011,30000000,64626786,34626786,2.1542262
The Count of Monte Cristo,1/23/2002,35000000,75395048,40395048,2.1541442285714285
Only God Forgives,5/30/2013,4800000,10337387,5537387,2.1536222916666667
Mirror Mirror,3/15/2012,85000000,183018522,98018522,2.153159082352941
Cheaper by the Dozen 2,12/21/2005,60000000,129181830,69181830,2.1530305
ಲೂಸಿಯಾ,10/19/2013,79000,170000,91000,2.151898734177215
Far from Heaven,9/1/2002,13500000,29027914,15527914,2.150215851851852
House on Haunted Hill,10/29/1999,19000000,40846082,21846082,2.149793789473684
Revolutionary Road,12/19/2008,35000000,75225693,40225693,2.1493055142857145
Married to the Mob,8/19/1988,10000000,21486757,11486757,2.1486757
The Imaginarium of Doctor Parnassus,10/1/2009,30000000,64352607,34352607,2.1450869
ലോഹം,8/20/2015,1050255,2250547,1200292,2.142857686942695
Dial M for Murder,5/29/1954,1400000,3000000,1600000,2.142857142857143
The Skeleton Key,7/29/2005,43000000,91974818,48974818,2.1389492558139533
Robin Hood,11/8/1973,15000000,32056467,17056467,2.1370978
Pet Sematary II,8/28/1992,8000000,17092453,9092453,2.136556625
The Lincoln Lawyer,3/17/2011,40000000,85412898,45412898,2.13532245
A Perfect Murder,6/5/1998,60000000,128038368,68038368,2.1339728
The Pyramid,12/4/2014,6500000,13865435,7365435,2.133143846153846
Zohi Sdom,8/5/2010,2745000,5850000,3105000,2.1311475409836067
Chappie,3/4/2015,49000000,104399548,55399548,2.1306030204081634
From Hell,10/19/2001,35000000,74558115,39558115,2.1302318571428573
Tomcats,3/30/2001,11000000,23430766,12430766,2.130069636363636
The Heartbreak Kid,10/5/2007,60000000,127766650,67766650,2.1294441666666666
Madea's Big Happy Family,4/22/2011,25000000,53213633,28213633,2.12854532
Baby Mama,4/23/2008,30000000,63833449,33833449,2.1277816333333335
The Bourne Legacy,8/8/2012,130000000,276572938,146572938,2.1274841384615386
My Best Girl,10/31/1927,483103,1027757,544654,2.1274076128693054
Race to Witch Mountain,3/12/2009,50000000,106303988,56303988,2.12607976
Hanna,4/7/2011,30000000,63782078,33782078,2.1260692666666667
The Last Airbender,6/30/2010,150000000,318502923,168502923,2.12335282
Zookeeper,7/6/2011,80000000,169852759,89852759,2.1231594875
Red Riding Hood,3/11/2011,42000000,89162162,47162162,2.122908619047619
Annie Get Your Gun,5/17/1950,3768785,8000000,4231215,2.122700021359669
End of Days,11/24/1999,100000000,211989043,111989043,2.11989043
Gulliver's Travels,12/25/2010,112000000,237382724,125382724,2.1194886071428574
Rise of the Guardians,11/21/2012,145000000,306941670,161941670,2.116839103448276
Dick,8/4/1999,13000000,27500000,14500000,2.1153846153846154
Made of Honor,5/2/2008,40000000,84601681,44601681,2.115042025
Side Effects,2/7/2013,30000000,63372757,33372757,2.1124252333333335
The Great Race,7/1/1965,12000000,25333333,13333333,2.1111110833333333
Changing Lanes,4/7/2002,45000000,94935764,49935764,2.1096836444444445
The Spitfire Grill,8/23/1996,6000000,12643776,6643776,2.107296
The Good Girl,1/12/2002,8000000,16856124,8856124,2.1070155
Lake Placid,7/15/1999,27000000,56870414,29870414,2.1063116296296296
Little Big Man,12/14/1970,15000000,31559552,16559552,2.103970133333333
Hereafter,10/15/2010,50000000,105197635,55197635,2.1039527
A Most Wanted Man,7/25/2014,15000000,31554855,16554855,2.103657
Bad Boys II,7/18/2003,130000000,273339556,143339556,2.1026119692307694
Flirting with Disaster,3/22/1996,7000000,14702438,7702438,2.100348285714286
Agent Cody Banks,3/14/2003,28000000,58795814,30795814,2.0998505
Chicken Little,11/4/2005,150000000,314432665,164432665,2.096217766666667
The Night Before,11/20/2015,25000000,52395996,27395996,2.09583984
The Secret of NIMH,6/17/1982,7000000,14665733,7665733,2.095104714285714
Turbo,7/11/2013,135000000,282570682,147570682,2.093116162962963
The Transporter,10/2/2002,21000000,43928932,22928932,2.091853904761905
The Secret Life of Walter Mitty,12/18/2013,90000000,188133322,98133322,2.0903702444444443
The Hitchhiker's Guide to the Galaxy,1/15/2005,50000000,104478416,54478416,2.08956832
The Edge of Seventeen,11/18/2016,9000000,18803648,9803648,2.089294222222222
Beyond the Lights,9/10/2014,7000000,14618727,7618727,2.0883895714285714
Runner Runner,9/24/2013,30000000,62616646,32616646,2.0872215333333335
Hotel for Dogs,1/16/2009,35000000,73034460,38034460,2.0866988571428573
Sparrows,5/14/1926,463455,966878,503423,2.086239224951721
Moms' Night Out,3/25/2014,5000000,10429707,5429707,2.0859414
This Is Where I Leave You,9/10/2014,19800000,41296320,21496320,2.085672727272727
Lucky Number Slevin,2/24/2006,27000000,56308881,29308881,2.0855141111111113
War and Peace,8/21/1956,6000000,12500000,6500000,2.0833333333333335
Mr. Brooks,6/1/2007,20000000,41637263,21637263,2.08186315
Edge of Tomorrow,5/27/2014,178000000,370541256,192541256,2.081692449438202
Never Back Down,3/4/2008,20000000,41627431,21627431,2.08137155
Orphan,7/24/2009,20000000,41596251,21596251,2.07981255
Ghost Rider,2/16/2007,110000000,228738393,118738393,2.079439936363636
The Big Hit,4/24/1998,13000000,27007143,14007143,2.0774725384615387
Stagecoach,3/2/1939,531374,1103757,572383,2.0771753981188392
The Dead Zone,10/21/1983,10000000,20766616,10766616,2.0766616
Coraline,2/5/2009,60000000,124596398,64596398,2.0766066333333333
The Bone Collector,11/4/1999,73000000,151493655,78493655,2.0752555479452055
Blue Crush,8/8/2002,25000000,51842679,26842679,2.07370716
Glee: The Concert Movie,8/11/2011,9000000,18663238,9663238,2.073693111111111
Mirrors,8/15/2008,35000000,72436439,37436439,2.069612542857143
Seed of Chucky,11/11/2004,12000000,24829644,12829644,2.069137
Maximum Risk,9/13/1996,25000000,51702483,26702483,2.06809932
The Golden Compass,12/4/2007,180000000,372234864,192234864,2.0679714666666666
Dumb and Dumberer: When Harry Met Lloyd,6/13/2003,19000000,39267515,20267515,2.066711315789474
Bolt,11/21/2008,150000000,309979994,159979994,2.0665332933333334
Lawless,8/29/2012,26000000,53676580,27676580,2.064483846153846
Man of the Year,10/9/2006,20000000,41237648,21237648,2.0618824
Capone,4/16/1975,970000,2000000,1030000,2.0618556701030926
Sleepy Hollow,11/18/1999,100000000,206071502,106071502,2.06071502
U-571,4/20/2000,62000000,127666415,65666415,2.0591357258064518
Annie,12/19/2014,65000000,133821816,68821816,2.058797169230769
Her,12/18/2013,23000000,47351251,24351251,2.058750043478261
Two Girls and a Guy,9/7/1997,1000000,2057193,1057193,2.057193
Friends with Money,9/7/2006,6500000,13368437,6868437,2.056682615384615
Amistad,12/3/1997,36000000,74000000,38000000,2.0555555555555554
Across to Singapore,4/7/1928,290000,596000,306000,2.0551724137931036
Changeling,1/30/2008,55000000,113020255,58020255,2.0549137272727274
Four Brothers,8/11/2005,45000000,92374674,47374674,2.0527705333333333
The Last Boy Scout,12/11/1991,29000000,59509925,30509925,2.052066379310345
Godzilla 1985,12/15/1984,2000000,4100000,2100000,2.05
The Misfits,1/1/1961,4000000,8200000,4200000,2.05
Hombre,3/21/1967,5860000,12000000,6140000,2.04778156996587
Four Christmases,11/26/2008,80000000,163733697,83733697,2.0466712125
Drop Dead Fred,4/19/1991,6788000,13878334,7090334,2.0445394814378313
Tropic Thunder,8/9/2008,92000000,188072649,96072649,2.0442679239130435
鐵道飛虎,12/23/2016,50000000,102205175,52205175,2.0441035
Friday Night Lights,10/8/2004,30000000,61255921,31255921,2.0418640333333333
A Guy Named Joe,3/1/1944,2627000,5363000,2736000,2.041492196421774
Tower Heist,11/2/2011,75000000,152930623,77930623,2.0390749733333333
Lethal Weapon 4,7/10/1998,140000000,285444603,145444603,2.0388900214285712
Invictus,12/10/2009,60000000,122233971,62233971,2.03723285
The Interpreter,4/8/2005,80000000,162944923,82944923,2.0368115375
Reno 911!: Miami,2/23/2007,10000000,20342161,10342161,2.0342161
The 'Burbs,2/17/1989,18000000,36602000,18602000,2.0334444444444446
Backdraft,5/24/1991,75000000,152368585,77368585,2.0315811333333333
Harlem Nights,11/17/1989,30000000,60864870,30864870,2.028829
Bride of Chucky,10/16/1998,25000000,50671850,25671850,2.026874
The Haunted Mansion,11/25/2003,90000000,182290266,92290266,2.0254474
Hell's Angels,11/15/1930,3950000,8000000,4050000,2.0253164556962027
RoboCop,1/30/2014,120000000,242688965,122688965,2.0224080416666665
DragonHeart,5/31/1996,57000000,115267375,58267375,2.022234649122807
The Remains of the Day,11/5/1993,11500000,23237911,11737911,2.0206879130434783
Fun with Dick and Jane,12/21/2005,100000000,202026112,102026112,2.02026112
Bad Lieutenant,9/16/1992,1000000,2019469,1019469,2.019469
The Pacifier,3/4/2005,56000000,113006880,57006880,2.01798
The Fighting Temptations,9/17/2003,15000000,30238577,15238577,2.0159051333333333
Galaxy Quest,12/23/1999,45000000,90683916,45683916,2.0151981333333335
The Great Debaters,12/27/2007,15000000,30226144,15226144,2.0150762666666666
Bug,5/19/2006,4000000,8059140,4059140,2.014785
Kaminey,8/14/2009,9000000,18130000,9130000,2.0144444444444445
No Holds Barred,6/2/1989,8000000,16093651,8093651,2.011706375
Alien Nation,10/7/1988,16000000,32155047,16155047,2.0096904375
When the Game Stands Tall,8/22/2014,15000000,30127963,15127963,2.008530866666667
Love Happens,9/18/2009,18000000,36133014,18133014,2.0073896666666666
Cube,9/9/1997,250000,501818,251818,2.007272
Double Impact,7/31/1991,15000000,30102717,15102717,2.0068478
Wrath of the Titans,3/27/2012,150000000,301000000,151000000,2.006666666666667
Eddie the Eagle,2/26/2016,23000000,46152411,23152411,2.0066265652173914
Before I Fall,3/2/2017,5000000,10025571,5025571,2.0051142
Road House,5/19/1989,15000000,30050028,15050028,2.0033352
Hollow Man,8/4/2000,95000000,190213455,95213455,2.002246894736842
In Too Deep,8/25/1999,7000000,14011454,7011454,2.0016362857142855
Cars 3,6/15/2017,175000000,350170057,175170057,2.000971754285714
Don't Say a Word,9/28/2001,50000000,100020092,50020092,2.00040184
Alexander's Ragtime Band,5/24/1938,2000000,4000000,2000000,2.0
Teenage Mutant Ninja Turtles III,3/17/1993,21000000,42000000,21000000,2.0
Free Birds,10/30/2013,55000000,110000000,55000000,2.0
La lengua de las mariposas,9/24/1999,3000000,6000000,3000000,2.0
Redd Inc.,11/3/2012,500000,1000000,500000,2.0
Tales from the Hood,5/24/1995,6000000,12000000,6000000,2.0
Jab We Met,10/26/2007,2300000,4600000,2300000,2.0
The Prophecy,9/1/1995,8,16,8,2.0
Tere Naam,8/15/2003,1,2,1,2.0
Dillinger,7/20/1973,1000000,2000000,1000000,2.0
The Legend of Bhagat Singh,6/7/2002,3000000,6000000,3000000,2.0
Dostana,11/13/2008,10000000,20000000,10000000,2.0
Intolerable Cruelty,9/2/2003,60000000,119940815,59940815,1.9990135833333333
21,3/27/2008,35000000,69823199,34823199,1.994948542857143
What to Expect When You're Expecting,5/17/2012,40000000,79700000,39700000,1.9925
The Best Little Whorehouse in Texas,7/23/1982,35000000,69701637,34701637,1.9914753428571428
Daylight,12/6/1996,80000000,159212469,79212469,1.9901558625
Blade: Trinity,12/8/2004,65000000,128905366,63905366,1.983159476923077
127 Hours,11/5/2010,18000000,35692920,17692920,1.98294
Space Cowboys,7/31/2000,65000000,128884132,63884132,1.9828328
The Legend of Tarzan,6/29/2016,180000000,356743061,176743061,1.9819058944444445
License to Wed,7/4/2007,35000000,69307224,34307224,1.9802064
Never Die Alone,3/26/2004,3000000,5923000,2923000,1.9743333333333333
House of the Dead,4/11/2003,7000000,13818181,6818181,1.974025857142857
The Pirates! In an Adventure with Scientists!,3/12/2012,60000000,118338361,58338361,1.9723060166666666
Jennifer's Body,9/18/2009,16000000,31556061,15556061,1.9722538125
Dil Chahta Hai,7/24/2001,2079000,4099000,2020000,1.9716209716209716
Step Brothers,7/25/2008,65000000,128107642,63107642,1.9708868
Dumbo,10/22/1941,812000,1600000,788000,1.9704433497536946
Guess Who,3/25/2005,35000000,68915888,33915888,1.9690253714285715
Delivery Man,10/10/2013,26000000,51164106,25164106,1.9678502307692307
Poetic Justice,7/23/1993,14000000,27515786,13515786,1.9654132857142856
Alpha and Omega,9/17/2010,20000000,39300000,19300000,1.965
The Book of Eli,1/14/2010,80000000,157107755,77107755,1.9638469375
All Dogs Go to Heaven,11/17/1989,13800000,27100027,13300027,1.9637700724637681
Laura,10/11/1944,1020000,2000000,980000,1.9607843137254901
Freedom Writers,1/5/2007,21000000,41170784,20170784,1.9605135238095237
The Adventures of Robin Hood,5/13/1938,2033000,3981000,1948000,1.958189867191343
Atanarjuat,2/1/2002,1934000,3786801,1852801,1.9580149948293692
Homefront,11/27/2013,22000000,43058898,21058898,1.9572226363636365
The Patriot,6/28/2000,110000000,215294342,105294342,1.957221290909091
The Grudge 2,10/13/2006,20000000,39143839,19143839,1.95719195
Hunting Elephants,7/3/2013,2300000,4500000,2200000,1.9565217391304348
Confessions of a Teenage Drama Queen,2/17/2004,15000000,29331068,14331068,1.9554045333333334
Ghost Ship,10/25/2002,35000000,68349884,33349884,1.9528538285714285
Silent Hill,4/21/2006,50000000,97607453,47607453,1.95214906
G-Force,7/21/2009,150000000,292817841,142817841,1.95211894
Moon,6/12/2009,5000000,9760104,4760104,1.9520208
The Book of Life,10/1/2014,50000000,97437106,47437106,1.94874212
Must Love Dogs,7/21/2005,30000000,58405313,28405313,1.9468437666666667
Superman III,6/17/1983,39000000,75850624,36850624,1.9448877948717949
Narc,1/14/2002,6500000,12633747,6133747,1.9436533846153845
"\"रम�?राघव �?�?\"\"Set in present day Mumbai the story follows the life of a serial killer Ramanna who is inspired by an infamous serial killer from the 1960s Raman Raghav. His strange obsession with Raghavan\"",6/24/2016,521873,1013926,492053,1.942859661258582
Les petits mouchoirs,10/20/2010,25000000,48531470,23531470,1.9412588
Tron,7/9/1982,17000000,33000000,16000000,1.9411764705882353
F.C. De Kampioenen: Kampioen zijn blijft plezant,12/17/2013,3849796,7471304,3621508,1.9407012735220255
Percy Jackson: Sea of Monsters,8/7/2013,90000000,174578751,84578751,1.9397639
Gangs of New York,12/14/2002,100000000,193772504,93772504,1.93772504
Mother's Day,4/28/2016,25000000,48418160,23418160,1.9367264
Stardust,8/9/2007,70000000,135560026,65560026,1.9365718
Central do Brasil,1/16/1998,2900000,5596708,2696708,1.9298993103448276
The Princess Bride,9/18/1987,16000000,30857814,14857814,1.928613375
Nine Lives,8/3/2016,30000000,57814445,27814445,1.9271481666666668
Assassin's Creed,12/21/2016,125000000,240697856,115697856,1.925582848
Wall Street: Money Never Sleeps,9/2/2010,70000000,134748021,64748021,1.9249717285714285
Blue Thunder,2/5/1983,22000000,42313354,20313354,1.9233342727272726
Cannonball,7/6/1976,780000,1500000,720000,1.9230769230769231
The Shadow,7/1/1994,25000000,48063435,23063435,1.9225374
Bee Movie,10/28/2007,150000000,287594577,137594577,1.91729718
Aquamarine,3/3/2006,12000000,23006849,11006849,1.9172374166666666
The Last Starfighter,7/13/1984,15000000,28733290,13733290,1.9155526666666667
Step Up All In,7/16/2014,45000000,86165646,41165646,1.9147921333333333
Exodus: Gods and Kings,12/3/2014,140000000,268031828,128031828,1.9145130571428572
The Quest,4/19/1996,30000000,57400547,27400547,1.9133515666666667
The Last Emperor,10/21/1987,23000000,43984230,20984230,1.9123578260869565
Young Adult,12/16/2011,12000000,22939027,10939027,1.9115855833333333
Rounders,9/11/1998,12000000,22921898,10921898,1.9101581666666667
Memoirs of a Geisha,12/6/2005,85000000,162242962,77242962,1.9087407294117646
Raw Deal,6/6/1986,8500000,16209459,7709459,1.9069951764705881
Batman & Robin,6/20/1997,125000000,238207122,113207122,1.905656976
The Andromeda Strain,3/12/1971,6500000,12376563,5876563,1.9040866153846154
Contact,7/11/1997,90000000,171120329,81120329,1.901336988888889
Jane Austen's Mafia!,7/24/1998,10000000,19000000,9000000,1.9
Rushmore,9/17/1998,9000000,17096053,8096053,1.8995614444444444
A Walk Among the Tombstones,9/18/2014,28000000,53181600,25181600,1.8993428571428572
The Legend of Zorro,10/24/2005,75000000,142400065,67400065,1.8986675333333334
The Green Hornet,1/12/2011,120000000,227817248,107817248,1.8984770666666666
A History of Violence,9/23/2005,32000000,60740827,28740827,1.89815084375
Convoy,6/27/1978,12000000,22765081,10765081,1.8970900833333333
The Good Dinosaur,11/14/2015,175000000,331926147,156926147,1.89672084
Rudy,9/17/1993,12000000,22750363,10750363,1.8958635833333333
Jack and Jill,11/11/2011,79000000,149673788,70673788,1.894604911392405
This Is Spinal Tap,5/4/1984,2500000,4736202,2236202,1.8944808
Drugstore Cowboy,9/9/1989,2500000,4729352,2229352,1.8917408
The Last of the Mohicans,9/25/1992,40000000,75505856,35505856,1.8876464
The Thin Red Line,12/25/1998,52000000,98126565,46126565,1.887049326923077
Hellboy II: The Golden Army,7/11/2008,85000000,160388063,75388063,1.886918388235294
12,6/6/2007,4000000,7537453,3537453,1.88436325
How Stella Got Her Groove Back,8/14/1998,20000000,37672350,17672350,1.8836175
Bedazzled,10/19/2000,48000000,90383208,42383208,1.8829835
Death Wish 3,11/1/1985,9000000,16945171,7945171,1.8827967777777779
Mr. Peabody & Sherman,2/7/2014,145000000,272912430,127912430,1.8821546896551724
Black Hawk Down,12/28/2001,92000000,172989651,80989651,1.8803222934782609
Lucky Lady,12/25/1975,13000000,24441725,11441725,1.8801326923076922
Syriana,11/23/2005,50000000,94000000,44000000,1.88
The Covenant,9/8/2006,20000000,37597471,17597471,1.87987355
Snakes on a Plane,8/6/2006,33000000,62022014,29022014,1.8794549696969698
3 Days to Kill,2/14/2014,28000000,52597999,24597999,1.8784999642857143
Seven Years in Tibet,9/12/1997,70000000,131457682,61457682,1.8779668857142857
Van Helsing,5/5/2004,160000000,300257475,140257475,1.87660921875
After Earth,5/30/2013,130000000,243843127,113843127,1.8757163615384616
Glyanets,8/23/2007,2500000,4684165,2184165,1.873666
GoodFellas,9/12/1990,25000000,46836394,21836394,1.87345576
The Choice,2/4/2016,10000000,18730891,8730891,1.8730891
Deep Impact,5/8/1998,75000000,140464664,65464664,1.8728621866666666
天將雄師,2/19/2015,65000000,121545703,56545703,1.8699338923076922
Antwone Fisher,12/19/2002,12500000,23367586,10867586,1.86940688
Monster House,7/21/2006,75000000,140175006,65175006,1.86900008
葉問,12/12/2008,11715578,21888598,10173020,1.8683327446584368
The Birth of a Nation,9/9/2016,8500000,15861566,7361566,1.866066588235294
The Chronicles of Narnia: Prince Caspian,5/15/2008,225000000,419651413,194651413,1.8651173911111112
Escape from Planet Earth,2/14/2013,40000000,74597643,34597643,1.864941075
Black Mass,9/4/2015,53000000,98837872,45837872,1.8648655094339623
Crocodile Dundee in Los Angeles,4/12/2001,21150000,39438674,18288674,1.864712718676123
The Fast and the Furious: Tokyo Drift,6/3/2006,85000000,158468292,73468292,1.8643328470588236
A Very Harold & Kumar Christmas,11/4/2011,19000000,35387212,16387212,1.862484842105263
Munich,12/22/2005,70000000,130358911,60358911,1.862270157142857
Бой с тенью 2: Реванш,10/18/2007,6000000,11171900,5171900,1.8619833333333333
Clash of the Titans,4/1/2010,125000000,232713139,107713139,1.861705112
Finding Forrester,12/21/2000,43000000,80049764,37049764,1.861622418604651
Man on Fire,4/23/2004,70000000,130293714,60293714,1.8613387714285714
Vacancy,4/20/2007,19000000,35300645,16300645,1.8579286842105263
Terminator Salvation,5/20/2009,200000000,371353001,171353001,1.856765005
Star Trek Beyond,7/7/2016,185000000,343471816,158471816,1.8566044108108108
Uptown Girls,8/15/2003,20000000,37095657,17095657,1.85478285
The Polar Express,11/10/2004,165000000,305875730,140875730,1.853792303030303
Pink Floyd: The Wall,7/14/1982,12000000,22244207,10244207,1.8536839166666668
We Are Your Friends,8/26/2015,6000000,11122090,5122090,1.8536816666666667
The Longest Ride,4/9/2015,34000000,63013281,29013281,1.853331794117647
Cop Out,2/26/2010,30000000,55583804,25583804,1.8527934666666668
Hard Times,9/4/1975,2700000,5000000,2300000,1.8518518518518519
Savages,7/6/2012,45000000,82966152,37966152,1.8436922666666666
Rush Hour 3,8/8/2007,140000000,258022233,118022233,1.84301595
Bernie,4/27/2012,5000000,9206470,4206470,1.841294
Firewall,2/10/2006,45000000,82800000,37800000,1.84
Sudden Death,12/22/1995,35000000,64350171,29350171,1.8385763142857143
Death on the Nile,10/6/1978,7920000,14560084,6640084,1.8383944444444444
Baby Boy,6/27/2001,16000000,29381649,13381649,1.8363530625
My Best Friend's Girl,9/19/2008,20000000,36620508,16620508,1.8310254
A Dangerous Method,9/30/2011,15000000,27462041,12462041,1.8308027333333334
Burnt,10/2/2015,20000000,36606743,16606743,1.83033715
Fan,4/15/2016,16000000,29251596,13251596,1.82822475
Skiptrace,7/21/2016,32000000,58500000,26500000,1.828125
The Three Stooges,4/13/2012,30000000,54819301,24819301,1.8273100333333334
Conspiracy Theory,8/7/1997,75000000,136982834,61982834,1.8264377866666666
Les Poupées Russes,6/15/2005,13000000,23727301,10727301,1.825177
Diary of a Wimpy Kid: The Long Haul,5/19/2017,22000000,40120144,18120144,1.823642909090909
Layer Cake,9/30/2004,6500000,11850214,5350214,1.8231098461538462
Filth,9/23/2013,5000000,9114264,4114264,1.8228528
Any Given Sunday,12/16/1999,55000000,100230832,45230832,1.8223787636363635
Lilo & Stitch,6/21/2002,80000000,145771527,65771527,1.8221440875
Gone Baby Gone,10/19/2007,19000000,34619699,15619699,1.8220894210526315
Den Skaldede Frisør,9/4/2012,5500000,10016934,4516934,1.8212607272727273
What About Bob?,5/17/1991,35000000,63710000,28710000,1.8202857142857143
All About the Benjamins,3/8/2002,14000000,25482931,11482931,1.8202093571428573
Rango,3/2/2011,135000000,245724603,110724603,1.8201822444444444
Teenage Mutant Ninja Turtles: Out of the Shadows,6/1/2016,135000000,245623848,110623848,1.8194359111111111
Barry Lyndon,12/18/1975,11000000,20000000,9000000,1.8181818181818181
Blue Streak,9/17/1999,65000000,117758500,52758500,1.8116692307692308
The Great Outdoors,6/17/1988,24000000,43455230,19455230,1.8106345833333333
The Spiderwick Chronicles,2/14/2008,90000000,162839667,72839667,1.8093296333333333
Hairspray,7/13/2007,50000000,90450008,40450008,1.80900016
Cien años de perdón,3/3/2016,6700000,12118661,5418661,1.8087553731343284
A Knight's Tale,5/11/2001,65000000,117487473,52487473,1.8074995846153845
Adventureland,4/3/2009,9500000,17164377,7664377,1.8067765263157896
Lions for Lambs,10/22/2007,35000000,63215872,28215872,1.8061677714285713
The Gorgeous Hussy,8/28/1936,1119000,2019000,900000,1.804289544235925
The Boxtrolls,9/10/2014,60000000,108255770,48255770,1.8042628333333333
The Magnificent Seven,9/14/2016,90000000,162360636,72360636,1.8040070666666668
Shalako,11/6/1968,1455000,2620000,1165000,1.8006872852233677
Rockstar,11/11/2011,10920000,19660000,8740000,1.8003663003663004
Turbo: A Power Rangers Movie,3/27/1997,10000000,17979739,7979739,1.7979739
The Five-Year Engagement,4/27/2012,30000000,53909751,23909751,1.7969917
Be Cool,3/4/2005,53000000,95226116,42226116,1.7967191698113207
The Three Musketeers,11/11/1993,30000000,53898845,23898845,1.7966281666666666
Payback,2/5/1999,90000000,161626121,71626121,1.7958457888888888
Hot Tub Time Machine,3/26/2010,36000000,64572262,28572262,1.7936739444444445
The Black Hole,12/18/1979,20000000,35841901,15841901,1.79209505
Hulk,6/19/2003,137000000,245360480,108360480,1.790952408759124
The Physician,12/25/2013,32000000,57284237,25284237,1.79013240625
Stranger Than Fiction,9/9/2006,30000000,53653224,23653224,1.7884408
Secret in Their Eyes,10/14/2015,19500000,34854990,15354990,1.7874353846153845
Robin Hood: Men in Tights,7/28/1993,20000000,35739755,15739755,1.78698775
वांटेड,9/18/2009,75,134,59,1.7866666666666666
Singh Is Kinng,1/1/2008,14000000,25000000,11000000,1.7857142857142858
ParaNorman,8/3/2012,60000000,107139399,47139399,1.78565665
A Night at the Roxbury,10/1/1998,17000000,30331165,13331165,1.7841861764705882
Rat Race,7/30/2001,48000000,85498534,37498534,1.7812194583333334
Goemon,3/17/2009,9000000,16000000,7000000,1.7777777777777777
Saul fia,6/11/2015,1000000,1777043,777043,1.777043
Postcards from the Edge,9/12/1990,22000000,39071603,17071603,1.7759819545454545
പ്രേമം,5/29/2015,6200000,11000000,4800000,1.7741935483870968
Just Like Heaven,9/16/2005,58000000,102854431,44854431,1.7733522586206896
Снежная королева,10/11/2012,7000000,12400000,5400000,1.7714285714285714
Wazir,1/7/2016,5200000,9200000,4000000,1.7692307692307692
Atlantic City,9/2/1980,7200000,12729678,5529678,1.7680108333333333
Shanghai Knights,2/6/2003,50000000,88323487,38323487,1.76646974
Flesh and the Devil,12/25/1926,373000,658000,285000,1.7640750670241288
The Three Musketeers,8/31/2011,75000000,132274484,57274484,1.7636597866666666
Stir of Echoes,9/10/1999,12000000,21133087,9133087,1.7610905833333332
Alice Through the Looking Glass,5/25/2016,170000000,299370084,129370084,1.7610004941176471
Sparkle,8/17/2012,14000000,24637469,10637469,1.7598192142857143
Being John Malkovich,9/30/1999,13000000,22863596,9863596,1.758738153846154
Big Fish,12/25/2003,70000000,122919055,52919055,1.7559865
Zack and Miri Make a Porno,9/18/2008,24000000,42105111,18105111,1.754379625
Carnosaur,5/21/1993,1000000,1753979,753979,1.753979
Surf's Up,6/8/2007,85000000,149044513,64044513,1.7534648588235293
Gangster Squad,1/10/2013,60000000,105200903,45200903,1.7533483833333334
Along Came a Spider,4/6/2001,60000000,105178561,45178561,1.7529760166666666
Boomerang,6/30/1992,40000000,70100000,30100000,1.7525
God's Not Dead,3/21/2014,17000000,29789000,12789000,1.7522941176470588
Yves Saint Laurent,1/8/2014,12000000,21026290,9026290,1.7521908333333334
Elle s'appelait Sarah,9/16/2010,10000000,17511906,7511906,1.7511906
Legend of the Guardians: The Owls of Ga'Hoole,7/10/2010,80000000,140073390,60073390,1.750917375
Joe Dirt,4/10/2001,17700000,30987695,13287695,1.750717231638418
RV,4/28/2006,50000000,87528173,37528173,1.75056346
Tea with Mussolini,3/25/1999,12000000,21001563,9001563,1.75013025
Somebody Up There Likes Me,7/3/1956,1920000,3360000,1440000,1.75
In the Land of Women,4/16/2007,10000000,17500000,7500000,1.75
The Walk,9/30/2015,35000000,61181942,26181942,1.7480554857142858
The World According to Garp,8/13/1982,17000000,29712172,12712172,1.7477748235294117
Reality Bites,2/18/1994,11500000,20079850,8579850,1.7460739130434784
The Fisher King,9/9/1991,24000000,41895491,17895491,1.7456454583333334
The Broken Hearts Club: A Romantic Comedy,2/1/2000,1000000,1744858,744858,1.744858
The American President,11/17/1995,62000000,107879496,45879496,1.739991870967742
Billu,2/13/2009,5750000,10000000,4250000,1.7391304347826086
Under Siege 2: Dark Territory,7/13/1995,60000000,104324083,44324083,1.7387347166666667
The Saint,4/3/1997,68000000,118063304,50063304,1.7362250588235295
The Virgin Suicides,4/21/1999,6000000,10409377,4409377,1.7348961666666667
Life,3/22/2017,58000000,100541806,42541806,1.7334794137931036
The Matador,5/12/2005,10000000,17297244,7297244,1.7297244
G.I. Joe: The Rise of Cobra,8/4/2009,175000000,302469017,127469017,1.7283943828571429
Crank: High Voltage,4/16/2009,20000000,34560577,14560577,1.72802885
Our Idiot Brother,8/26/2011,10000000,17273593,7273593,1.7273593
Captain Phillips,10/10/2013,55000000,95000000,40000000,1.7272727272727273
Adaptation.,12/6/2002,19000000,32801173,13801173,1.7263775263157894
Stigmata,9/10/1999,29000000,50041732,21041732,1.7255769655172415
The Invention of Lying,9/13/2009,18500000,31912793,13412793,1.7250158378378377
Space Chimps,7/17/2008,37000000,63800345,26800345,1.7243336486486487
Pocketful of Miracles,12/18/1961,2900000,5000000,2100000,1.7241379310344827
The Mothman Prophecies,1/25/2002,32000000,55157539,23157539,1.72367309375
The D Train,5/8/2015,447524,771317,323793,1.7235209731768575
Secretariat,8/20/2010,35000000,60251371,25251371,1.7214677428571428
House of Wax,4/30/2005,40000000,68766121,28766121,1.719153025
Legend,9/9/2015,25000000,42972994,17972994,1.71891976
Son of Rambow,1/22/2007,4000000,6870249,2870249,1.71756225
Курочка Ряба,10/1/1994,2700000,4635143,1935143,1.7167196296296297
Arachnophobia,8/9/1990,31000000,53208180,22208180,1.7163929032258065
The Natural,5/11/1984,28000000,47951979,19951979,1.7125706785714285
Mortal Kombat: Annihilation,11/21/1997,30000000,51376861,21376861,1.7125620333333333
Something Borrowed,5/5/2011,35000000,59901913,24901913,1.7114832285714285
Forbidden Planet,3/15/1956,1900000,3250000,1350000,1.7105263157894737
Blood Diamond,12/7/2006,100000000,170877916,70877916,1.70877916
The Tree of Life,5/18/2011,32000000,54674226,22674226,1.7085695625
The Texas Chainsaw Massacre 2,8/22/1986,4700000,8025872,3325872,1.707632340425532
U.S. Marshals,3/6/1998,60000000,102367405,42367405,1.7061234166666666
Seabiscuit,7/22/2003,87000000,148336445,61336445,1.7050166091954022
The Next Three Days,11/18/2010,30000000,51148651,21148651,1.7049550333333334
The Naked Gun 33�? The Final Insult,3/18/1994,30000000,51132598,21132598,1.7044199333333334
The Other Guys,8/6/2010,100000000,170432927,70432927,1.70432927
Endless Love,2/12/2014,20000000,34077920,14077920,1.703896
Lost in Space,4/3/1998,80000000,136159423,56159423,1.7019927875
Piranha 3DD,5/11/2012,5000000,8493728,3493728,1.6987456
King Arthur,7/7/2004,120000000,203567857,83567857,1.6963988083333332
Cousins,2/10/1989,13000000,22030000,9030000,1.6946153846153846
She's the Man,3/17/2006,20000000,33889159,13889159,1.69445795
Charlotte's Web,12/15/2006,85000000,144000000,59000000,1.6941176470588235
The Emperor's New Groove,12/9/2000,100000000,169327687,69327687,1.69327687
Dil Dhadakne Do,6/5/2015,13000000,22000000,9000000,1.6923076923076923
Sholem Aleichem: Laughing In The Darkness,2/24/2012,500000,845188,345188,1.690376
The Sweeney,9/11/2012,3730500,6294161,2563661,1.6872164589197158
Florence Foster Jenkins,5/6/2016,29000000,48902953,19902953,1.686308724137931
Star Trek: Insurrection,12/10/1998,70000000,118000000,48000000,1.6857142857142857
Joy,12/24/2015,60000000,101134059,41134059,1.68556765
Videocracy,9/4/2009,700000,1179676,479676,1.6852514285714286
Jersey Boys,6/5/2014,40000000,67347013,27347013,1.683675325
Fever Pitch,4/6/2005,30000000,50451307,20451307,1.6817102333333334
Spaceballs,6/24/1987,22700000,38119483,15419483,1.6792723788546255
Who Killed the Electric Car?,8/4/2006,1000000,1678874,678874,1.678874
The Namesake,9/2/2006,12000000,20138836,8138836,1.6782363333333334
Unstoppable,11/4/2010,100000000,167805466,67805466,1.67805466
Friday After Next,11/22/2002,20000000,33526835,13526835,1.67634175
Marmaduke,6/4/2010,50000000,83761844,33761844,1.67523688
The Judge,10/8/2014,50000000,83719388,33719388,1.67438776
Accepted,8/18/2006,23000000,38505009,15505009,1.6741308260869565
De rouille et d'os,5/17/2012,15400000,25762027,10362027,1.6728588961038962
Ninotchka,10/6/1939,1365000,2279000,914000,1.6695970695970697
Dogville,5/19/2003,10000000,16680836,6680836,1.6680836
The Siege,11/6/1998,70000000,116672912,46672912,1.6667558857142857
The Wrong Man,12/22/1956,1200000,2000000,800000,1.6666666666666667
The Sand Pebbles,12/20/1966,12000000,20000000,8000000,1.6666666666666667
Beginners,9/11/2010,3200000,5332926,2132926,1.666539375
Brothers,1/27/2009,26000000,43318349,17318349,1.666090346153846
Undercover Brother,5/31/2002,25000000,41604473,16604473,1.66417892
The Hours,12/27/2002,25000000,41597830,16597830,1.6639132
Dikari,11/23/2006,800000,1328612,528612,1.660765
The Immortals,10/5/1995,50,83,33,1.66
The Punisher,4/15/2004,33000000,54700105,21700105,1.6575789393939393
An American in Paris,8/8/1951,2723903,4500000,1776097,1.6520412070473875
The Craft,5/3/1996,15000000,24769466,9769466,1.6512977333333334
Lara Croft Tomb Raider: The Cradle of Life,7/21/2003,95000000,156505388,61505388,1.6474251368421053
Evil Dead II,3/13/1987,3600000,5923044,2323044,1.64529
Sweet November,2/16/2001,40000000,65754228,25754228,1.6438557
Hannibal Rising,2/6/2007,50000000,82169884,32169884,1.64339768
The Sisterhood of the Traveling Pants 2,8/6/2008,27000000,44352417,17352417,1.6426821111111112
Requiem for a Dream,10/27/2000,4500000,7390108,2890108,1.6422462222222223
Entourage,6/3/2015,30000000,49263404,19263404,1.6421134666666666
The Machinist,2/9/2004,5000000,8203235,3203235,1.640647
Death Race,8/22/2008,45000000,73762516,28762516,1.6391670222222223
Bugsy,12/10/1991,30000000,49114016,19114016,1.6371338666666666
Dark Shadows,5/8/2012,150000000,245527149,95527149,1.63684766
Willow,5/1/1988,35000000,57269863,22269863,1.6362818
Falling Down,2/26/1993,25000000,40903593,15903593,1.63614372
The Mysterious Lady,8/4/1928,337,551,214,1.6350148367952522
Radio,10/24/2003,32000000,52277485,20277485,1.63367140625
The Boy in the Striped Pyjamas,5/7/2008,12500000,20416563,7916563,1.63332504
The Last Witch Hunter,10/21/2015,90000000,146936910,56936910,1.6326323333333332
A Perfect Getaway,6/8/2009,14000000,22852638,8852638,1.6323312857142858
Predator 2,11/20/1990,35000000,57120318,22120318,1.6320090857142857
Cheetah,8/18/1989,5000000,8153677,3153677,1.6307354
Allegiant,3/9/2016,110000000,179246868,69246868,1.6295169818181818
Kingdom of Heaven,5/3/2005,130000000,211643158,81643158,1.6280242923076924
Burlesque,11/23/2010,55000000,89519773,34519773,1.6276322363636364
Abraham Lincoln: Vampire Hunter,6/20/2012,69000000,112265139,43265139,1.627031
A Christmas Carol,11/4/2009,200000000,325233863,125233863,1.626169315
Out of Sight,6/26/1998,48000000,77745568,29745568,1.6196993333333334
Body of Lies,10/10/2008,70000000,113280098,43280098,1.6182871142857143
War,8/24/2007,25000000,40452643,15452643,1.61810572
The Spy Next Door,1/15/2010,28000000,45236543,17236543,1.6155908214285715
Mo' Better Blues,8/3/1990,10000000,16153593,6153593,1.6153593
Last Action Hero,6/18/1993,85000000,137298489,52298489,1.6152763411764706
9,8/19/2009,30000000,48428063,18428063,1.6142687666666666
The A-Team,6/10/2010,110000000,177238796,67238796,1.6112617818181818
The Informant!,9/18/2009,22000000,35424826,13424826,1.6102193636363635
Lockout,4/12/2012,20000000,32204030,12204030,1.6102015
Muppets Most Wanted,3/20/2014,50000000,80383290,30383290,1.6076658
2046,5/20/2004,12000000,19271312,7271312,1.6059426666666667
La Vérité si je Mens ! 3,1/31/2012,25496629,40924982,15428353,1.605113444604775
Paycheck,12/25/2003,60000000,96269812,36269812,1.6044968666666666
The Big Red One,5/28/1980,4500000,7206220,2706220,1.6013822222222223
Fight Club,10/15/1999,63000000,100853753,37853753,1.6008532222222223
You Again,9/24/2010,20000000,32005248,12005248,1.6002624
Svinalängorna,12/10/2010,3000000,4800080,1800080,1.6000266666666667
Tutto tutto niente niente,11/30/2012,5579750,8927600,3347850,1.6
Exit Wounds,3/13/2001,50000000,79958599,29958599,1.59917198
Defiance,12/31/2008,32000000,51155219,19155219,1.59860059375
The Sweetest Thing,4/12/2002,43000000,68696770,25696770,1.5975993023255814
Norbit,2/8/2007,60000000,95673607,35673607,1.5945601166666667
Joy Ride,10/5/2001,23000000,36642838,13642838,1.5931668695652175
Ghostbusters,7/14/2016,144000000,229147509,85147509,1.5913021458333334
Chi bi,7/10/2008,80341000,127814609,47473609,1.590901395302523
Team America: World Police,10/10/2004,32000000,50907422,18907422,1.5908569375
А зори здесь тихие...,4/30/2015,3300000,5249225,1949225,1.5906742424242424
Total Recall,8/2/2012,125000000,198802074,73802074,1.590416592
Fool's Gold,2/7/2008,70000000,111231041,41231041,1.5890148714285715
Meet Joe Black,11/12/1998,90000000,142940100,52940100,1.5882233333333333
10 to Midnight,3/11/1983,4520000,7175592,2655592,1.5875203539823008
Little Man,8/31/2006,64000000,101595121,37595121,1.587423765625
La science des rêves,2/11/2006,6000000,9524340,3524340,1.58739
Charlie Wilson's War,12/19/2007,75000000,119000410,44000410,1.5866721333333333
Paint Your Wagon,10/15/1969,20000000,31678778,11678778,1.5839389
Bon Cop Bad Cop,7/6/2006,8000000,12671300,4671300,1.5839125
Indigènes,5/25/2006,14500000,22963701,8463701,1.5837035172413794
Buffalo '66,1/20/1998,1500000,2375097,875097,1.583398
சிவாஜி,6/14/2007,12000000,19000000,7000000,1.5833333333333333
Walking With Dinosaurs,12/18/2013,80000000,126546518,46546518,1.581831475
Child's Play 3,8/30/1991,13000000,20560255,7560255,1.5815580769230768
The Long Riders,5/12/1980,10000000,15795189,5795189,1.5795189
Heavy Traffic,8/8/1973,950000,1500000,550000,1.5789473684210527
Leap Year,1/8/2010,19000000,29922472,10922472,1.5748669473684211
9 Songs,7/16/2004,1000000,1574623,574623,1.574623
The Green Berets,7/4/1968,7000000,11000000,4000000,1.5714285714285714
Blow,4/4/2001,53000000,83282296,30282296,1.5713640754716982
High Fidelity,3/17/2000,30000000,47126295,17126295,1.5708765
Now You See Me,5/29/2013,75000000,117698894,42698894,1.5693185866666666
The Reaping,4/5/2007,40000000,62771059,22771059,1.569276475
Shooter,3/22/2007,61000000,95696996,34696996,1.568803213114754
Looper,9/26/2012,30000000,47042000,17042000,1.5680666666666667
The Gambler,12/25/2014,25000000,39171130,14171130,1.5668452
Machete,9/1/2010,20000000,31327899,11327899,1.56639495
The Devil's Own,3/12/1997,90000000,140807547,50807547,1.5645283
Il peggior Natale della mia vita,12/22/2012,6843500,10703234,3859734,1.564
The Sisterhood of the Traveling Pants,6/1/2005,25000000,39053061,14053061,1.56212244
Bound,9/13/1996,4500000,7011317,2511317,1.5580704444444444
लगान,6/15/2001,5200000,8100000,2900000,1.5576923076923077
Cats & Dogs,7/4/2001,60000000,93375151,33375151,1.5562525166666668
Two Weeks Notice,12/19/2002,60000000,93354918,33354918,1.5559153
Spy Game,11/18/2001,92000000,143049560,51049560,1.5548865217391303
What Lies Beneath,7/21/2000,100000000,155464351,55464351,1.55464351
Robin Hood,5/12/2010,200000000,310669540,110669540,1.5533477
The Last Wave,1/1/1977,810000,1258000,448000,1.5530864197530865
Jodhaa Akbar,2/15/2008,8376800,13000000,4623200,1.551905262152612
Jackie,12/2/2016,9000000,13960394,4960394,1.5511548888888889
Atlantis: The Lost Empire,6/2/2001,120000000,186053725,66053725,1.5504477083333332
Little Shop of Horrors,12/19/1986,25000000,38748395,13748395,1.5499358
Il Divo,5/23/2008,7275000,11260366,3985366,1.5478166323024054
The Time Machine,3/4/2002,80000000,123729176,43729176,1.5466147
Bewitched,6/21/2005,85000000,131426169,46426169,1.5461902235294118
Ghost in the Shell,3/29/2017,110000000,169801921,59801921,1.5436538272727274
Jason X,7/24/2001,11000000,16951798,5951798,1.5410725454545455
The Dressmaker,10/1/2015,11930000,18340000,6410000,1.537300922045264
The Ninth Gate,8/24/1999,38000000,58401898,20401898,1.536892052631579
Jay and Silent Bob Strike Back,8/22/2001,22000000,33788161,11788161,1.5358255
Dante's Peak,2/7/1997,116000000,178127760,62127760,1.5355841379310344
City Heat,12/5/1984,25000000,38348988,13348988,1.53395952
Repo Man,2/20/1984,1500000,2300000,800000,1.5333333333333334
Wild at Heart,5/1/1990,9500000,14560247,5060247,1.5326575789473684
Million Dollar Arm,5/9/2014,25000000,38307627,13307627,1.53230508
Spirit: Stallion of the Cimarron,5/24/2002,80000000,122563539,42563539,1.5320442375
Surrogates,9/24/2009,80000000,122444772,42444772,1.53055965
Black Rain,9/22/1989,30000000,45892212,15892212,1.5297404
Our Family Wedding,3/12/2010,14000000,21409028,7409028,1.5292162857142857
We Were Soldiers,3/1/2002,75000000,114660784,39660784,1.5288104533333333
Men of Honor,9/13/2000,32000000,48814909,16814909,1.52546590625
Return to Me,4/7/2000,24000000,36609995,12609995,1.5254164583333334
Battle for Terra,9/6/2007,4000000,6101046,2101046,1.5252615
The Little Prince,7/29/2015,64000000,97571250,33571250,1.52455078125
Colombiana,7/27/2011,40000000,60965854,20965854,1.52414635
Bande à part,8/5/1964,120000,182857,62857,1.5238083333333334
The Darjeeling Limited,9/29/2007,16000000,24377151,8377151,1.5235719375
What's Your Number?,9/30/2011,20000000,30426096,10426096,1.5213048
High Crimes,4/3/2002,42000000,63781810,21781810,1.5186145238095239
The Tigger Movie,2/11/2000,30000000,45554533,15554533,1.5184844333333334
U2 3D,5/19/2007,15000000,22730842,7730842,1.5153894666666667
Belle,9/8/2013,10900000,16505460,5605460,1.514262385321101
赤壁 2,1/7/2009,80000000,121059225,41059225,1.5132403125
Beasts of No Nation,9/11/2015,6000000,9077700,3077700,1.51295
The Drop,9/12/2014,12600000,19054534,6454534,1.5122646031746032
Marie Antoinette,5/24/2006,40000000,60474340,20474340,1.5118585
Ninja Assassin,9/29/2009,40000000,60462347,20462347,1.511558675
Samyy Luchshiy Film 3-DE,1/19/2011,6500000,9816332,3316332,1.510204923076923
Smart People,4/11/2008,7000000,10569964,3569964,1.5099948571428572
Waterworld,7/28/1995,175000000,264218220,89218220,1.5098184
The Mortal Instruments: City of Bones,8/21/2013,60000000,90565421,30565421,1.5094236833333334
Sister Act 2: Back in the Habit,12/9/1993,38000000,57319029,19319029,1.5083955
My Old Lady,9/9/2014,5000000,7527232,2527232,1.5054464
Hellboy,4/2/2004,66000000,99318987,33318987,1.5048331363636365
The Taking of Pelham 1 2 3,6/11/2009,100000000,150166126,50166126,1.50166126
The Ghost and the Darkness,10/11/1996,50000000,75000000,25000000,1.5
3 Strikes,3/1/2000,6000000,9000000,3000000,1.5
Dingo,6/2/1991,200000,300000,100000,1.5
Topaz,12/18/1969,4000000,6000000,2000000,1.5
24,5/5/2016,10000000,15000000,5000000,1.5
Aadukalam,1/14/2011,4000000,6000000,2000000,1.5
Planet 51,11/19/2009,70000000,104945765,34945765,1.4992252142857143
Hostage,3/10/2005,52000000,77944725,25944725,1.4989370192307692
Justice League: The New Frontier,2/26/2008,3500000,5231128,1731128,1.494608
Lemony Snicket's A Series of Unfortunate Events,12/16/2004,140000000,209073645,69073645,1.4933831785714287
Clockstoppers,3/17/2002,26000000,38793283,12793283,1.4920493461538462
Clockstoppers,3/17/2002,26000000,38793283,12793283,1.4920493461538462
Another Gay Movie,4/28/2006,500000,745327,245327,1.490654
Glory,12/15/1989,18000000,26828365,8828365,1.4904647222222223
La Belle et la Bête,2/12/2014,33000000,49100000,16100000,1.4878787878787878
Message in a Bottle,2/22/1999,80000000,118880016,38880016,1.4860002
Return of the Living Dead Part II,1/15/1988,6200000,9205924,3005924,1.4848264516129033
The One,11/2/2001,49000000,72700000,23700000,1.4836734693877551
Unforgettable,4/20/2017,12000000,17768012,5768012,1.4806676666666667
Don't Be Afraid of the Dark,11/6/2010,25000000,36993168,11993168,1.47972672
The Hurricane,9/17/1999,50000000,73956241,23956241,1.47912482
Natural Born Killers,8/25/1994,34000000,50282766,16282766,1.4789048823529412
Straw Dogs,12/29/1971,2200000,3251794,1051794,1.478088181818182
Mary of Scotland,8/28/1936,864000,1276000,412000,1.4768518518518519
Hot Pursuit,5/8/2015,35000000,51680201,16680201,1.4765771714285714
The Rocketeer,6/21/1991,42000000,62000000,20000000,1.4761904761904763
Монгол,9/20/2007,18000000,26527510,8527510,1.4737505555555555
Justice League: War,2/2/2014,3500000,5155325,1655325,1.47295
Private Parts,3/7/1997,28000000,41230799,13230799,1.4725285357142857
Nebraska,9/21/2013,12000000,17654912,5654912,1.4712426666666667
Did You Hear About the Morgans?,12/17/2009,58000000,85280250,27280250,1.4703491379310345
Morning Glory,1/12/2010,40000000,58785180,18785180,1.4696295
Nutty Professor II: The Klumps,7/27/2000,84000000,123307945,39307945,1.4679517261904762
Tasogare Seibei,11/2/2002,5000000,7338987,2338987,1.4677974
Rope,8/23/1948,1500000,2200000,700000,1.4666666666666666
Honey I Blew Up the Kid,7/16/1992,40000000,58662452,18662452,1.4665613
Pure Luck,8/9/1991,17010000,24941969,7931969,1.4663121105232215
Fright Night,8/18/2011,17000000,24922237,7922237,1.4660139411764705
Used Cars,7/11/1980,8000000,11715321,3715321,1.464415125
Taxi,10/6/2004,25000000,36609966,11609966,1.46439864
State of Play,4/17/2009,60000000,87784194,27784194,1.4630699
The Wash,11/16/2001,7000000,10229331,3229331,1.461333
Café Society,5/11/2016,30000000,43763247,13763247,1.4587749
Yu-Gi-Oh! The Movie,8/13/2004,20000000,29170410,9170410,1.4585205
S.W.A.T.,8/8/2003,80000000,116643346,36643346,1.458041825
Dolphin Tale 2,9/12/2014,36000000,52424533,16424533,1.4562370277777779
Vegas Vacation,2/13/1997,25000000,36400360,11400360,1.4560144
Taking Lives,3/19/2004,45000000,65470529,20470529,1.4549006444444443
Beauty Shop,6/2/2005,25000000,36351350,11351350,1.454054
Diana,9/19/2013,15000000,21766271,6766271,1.4510847333333334
Haywire,11/6/2011,23000000,33372606,10372606,1.4509828695652174
The Change-Up,8/5/2011,52000000,75450437,23450437,1.4509699423076923
Love! Valour! Compassion!,5/16/1997,2000000,2900000,900000,1.45
Battleship,4/11/2012,209000000,303025485,94025485,1.4498827033492823
Snatched,5/3/2017,42000000,60845711,18845711,1.4487074047619048
Superman Returns,6/28/2006,270000000,391081192,121081192,1.4484488592592593
Mars Attacks!,12/12/1996,70000000,101371017,31371017,1.4481573857142858
30 Minutes or Less,8/11/2011,28000000,40547440,12547440,1.448122857142857
Force 10 from Navarone,11/1/1978,5000000,7230000,2230000,1.446
2010,12/6/1984,28000000,40400657,12400657,1.442880607142857
Swordfish,6/7/2001,102000000,147080413,45080413,1.4419648333333333
The Man from U.N.C.L.E.,8/13/2015,75000000,108145109,33145109,1.4419347866666667
Max Keeble's Big Move,10/5/2001,12000000,17292381,5292381,1.44103175
Three Kings,9/27/1999,75000000,108000000,33000000,1.44
The Host,3/22/2013,44000000,63327201,19327201,1.439254568181818
Concussion,11/12/2015,35000000,50363790,15363790,1.4389654285714286
The Lovely Bones,12/26/2009,65000000,93525586,28525586,1.4388551692307692
Eye in the Sky,9/11/2015,13000000,18704595,5704595,1.438815
Rapid Fire,7/24/1992,10000000,14356479,4356479,1.4356479
El espinazo del diablo,4/20/2001,4500000,6459020,1959020,1.4353377777777778
The Sorcerer's Apprentice,7/13/2010,150000000,215283742,65283742,1.4352249466666667
Hardcore Henry,9/12/2015,10000000,14333790,4333790,1.433379
Чёрная Молния,12/31/2009,15000000,21500000,6500000,1.4333333333333333
The Huntsman: Winter's War,4/6/2016,115000000,164602163,49602163,1.431323156521739
Run All Night,3/11/2015,50000000,71561644,21561644,1.43123288
Mala noćna muzika,1/1/2002,200000,286000,86000,1.43
Cocoon: The Return,9/13/1988,17500000,25024919,7524919,1.4299953714285714
RockNRolla,9/4/2008,18000000,25739015,7739015,1.4299452777777777
A Lot Like Love,4/22/2005,30000000,42886719,12886719,1.4295573
Sylvia,10/17/2003,7000000,10000000,3000000,1.4285714285714286
Barnyard,8/4/2006,51000000,72779000,21779000,1.4270392156862746
La migliore offerta,1/1/2013,13500000,19255873,5755873,1.426360962962963
Enemy at the Gates,3/13/2001,68000000,96976270,28976270,1.4261216176470588
Blue Velvet,8/1/1986,6000000,8551228,2551228,1.4252046666666667
Watchmen,3/5/2009,130000000,185258983,55258983,1.4250691
Power Rangers,3/23/2017,100000000,142337240,42337240,1.4233724
Snake Eyes,8/7/1998,73000000,103891409,30891409,1.4231699863013698
Malcolm X,11/18/1992,34000000,48169908,14169908,1.416762
Stuart Little 2,7/19/2002,120000000,169956806,49956806,1.4163067166666667
Highlander III: The Sorcerer,11/29/1994,26000000,36800000,10800000,1.4153846153846155
Harry Brown,11/11/2009,7300000,10329747,3029747,1.4150338356164383
Vampire in Brooklyn,10/26/1995,14000000,19800000,5800000,1.4142857142857144
Master and Commander: The Far Side of the World,11/14/2003,150000000,212011111,62011111,1.4134074066666666
Le scaphandre et le papillon,5/22/2007,14000000,19777647,5777647,1.4126890714285714
The Running Man,11/13/1987,27000000,38122105,11122105,1.4119298148148147
Hocus Pocus,7/16/1993,28000000,39514713,11514713,1.41123975
It's Alive,8/15/2008,11000000,15500000,4500000,1.4090909090909092
And So It Goes,7/20/2014,18000000,25312387,7312387,1.4062437222222222
The Perfect Weapon,3/15/1991,10000000,14061361,4061361,1.4061361
Allied,11/17/2016,85000000,119520023,34520023,1.4061179176470588
Five Graves to Cairo,5/3/1943,855000,1200000,345000,1.4035087719298245
Swiss Army Man,6/24/2016,3000000,4210454,1210454,1.4034846666666667
Punchline,10/7/1988,15000000,21032267,6032267,1.4021511333333334
Captive,9/17/2015,2000000,2801508,801508,1.400754
Flicka,10/20/2006,15000000,21000000,6000000,1.4
Fantastic Four,8/5/2015,120000000,167977596,47977596,1.3998133
The Sitter,12/9/2011,25000000,34942188,9942188,1.39768752
Curious George,2/10/2006,50000000,69834815,19834815,1.3966963
Breakdown,5/2/1997,36000000,50159144,14159144,1.3933095555555555
Pay It Forward,10/12/2000,40000000,55707411,15707411,1.392685275
Night of the Living Dead,10/18/1990,4200000,5835247,1635247,1.389344523809524
Before the Devil Knows You're Dead,9/26/2007,18000000,25005257,7005257,1.3891809444444445
The Adventures of Sharkboy and Lavagirl,6/10/2005,50000000,69425966,19425966,1.38851932
13 Hours: The Secret Soldiers of Benghazi,1/13/2016,50000000,69411370,19411370,1.3882274
Love & Basketball,4/21/2000,20000000,27728118,7728118,1.3864059
Admission,3/21/2013,13000000,18000000,5000000,1.3846153846153846
Catch-22,6/24/1970,18000000,24911670,6911670,1.3839816666666667
The Spanish Prisoner,9/8/1997,10000000,13835130,3835130,1.383513
Gridiron Gang,9/15/2006,30000000,41480851,11480851,1.3826950333333334
Lakeview Terrace,9/19/2008,20000000,27640028,7640028,1.3820014
The Best of Me,10/16/2014,26000000,35926213,9926213,1.381777423076923
Extremely Loud & Incredibly Close,12/24/2011,40000000,55247881,15247881,1.381197025
The Crow: City of Angels,8/29/1996,13000000,17917287,4917287,1.3782528461538461
I Love Trouble,6/29/1994,45000000,61947267,16947267,1.3766059333333334
The Long Kiss Goodnight,10/11/1996,65000000,89456761,24456761,1.3762578615384615
Keanu,4/21/2016,15000000,20566327,5566327,1.3710884666666667
Kama Sutra - A Tale of Love,9/11/1996,3000000,4109095,1109095,1.3696983333333332
White House Down,6/27/2013,150000000,205366737,55366737,1.36911158
Country Strong,12/22/2010,15000000,20529194,5529194,1.3686129333333332
Shikshanachya Aaicha Gho,1/15/2010,380000,520000,140000,1.368421052631579
Small Soldiers,7/10/1998,40000000,54682547,14682547,1.367063675
The Green Inferno,9/4/2014,5000000,6833445,1833445,1.366689
Lucas,3/28/1986,6000000,8200000,2200000,1.3666666666666667
Astérix aux Jeux Olympiques,1/13/2008,97250400,132900000,35649600,1.366575355988253
Les Aventures extraordinaires d'Adèle Blanc-Sec,4/9/2010,25000000,34100000,9100000,1.364
Testament,11/4/1983,1500000,2044892,544892,1.3632613333333334
Enough,5/24/2002,38000000,51801187,13801187,1.3631891315789473
Just My Luck,5/12/2006,28000000,38159905,10159905,1.36285375
Swoon,9/11/1992,250000,340147,90147,1.360588
Badmaa$h Company,5/7/2010,6250000,8500000,2250000,1.36
From Dusk Till Dawn,1/19/1996,19000000,25836616,6836616,1.3598218947368421
Khumba,7/18/2013,20000000,27187375,7187375,1.35936875
Crimson Peak,10/13/2015,55000000,74679822,19679822,1.3578149454545454
Extract,9/3/2009,8000000,10848783,2848783,1.356097875
Elizabeth: The Golden Age,9/9/2007,55000000,74237563,19237563,1.3497738727272728
Tim,7/13/1979,600000,809000,209000,1.3483333333333334
Poltergeist III,6/10/1988,10500000,14144000,3644000,1.347047619047619
Jarhead,11/4/2005,72000000,96889998,24889998,1.3456944166666667
The Ballad of Cable Hogue,5/13/1970,3716946,5000000,1283054,1.3451903794136368
Safe,4/16/2012,30000000,40346186,10346186,1.3448728666666667
The Women,1/1/1939,1688000,2270000,582000,1.34478672985782
Mulholland Drive,5/16/2001,15000000,20117339,5117339,1.3411559333333334
Paris Can Wait,9/12/2016,5000000,6700000,1700000,1.34
Caligola,1/21/1979,17500000,23438120,5938120,1.3393211428571428
Wimbledon,9/13/2004,31000000,41512007,10512007,1.339097
The Emoji Movie,7/28/2017,50000000,66913939,16913939,1.33827878
The Ghost Writer,2/12/2010,45000000,60222298,15222298,1.3382732888888889
Runaway Jury,10/9/2003,60000000,80154140,20154140,1.3359023333333333
The Tailor of Panama,2/11/2001,21000000,28008462,7008462,1.3337362857142858
The Meddler,4/5/2016,3200000,4267218,1067218,1.333505625
Willy Wonka & the Chocolate Factory,6/29/1971,3000000,4000000,1000000,1.3333333333333333
Pollock,9/6/2000,6,8,2,1.3333333333333333
예의없는 것들,8/24/2006,3,4,1,1.3333333333333333
I'm Not Ashamed,10/21/2016,1500000,2000000,500000,1.3333333333333333
Khatta Meetha,7/23/2010,7500000,10000000,2500000,1.3333333333333333
Atithi Tum Kab Jaoge,2/26/2010,3750000,5000000,1250000,1.3333333333333333
Viy,1/30/2014,26000000,34592118,8592118,1.330466076923077
Robot & Frank,8/16/2012,2500000,3325038,825038,1.3300152
Armed and Dangerous,8/15/1986,12000000,15945534,3945534,1.3287945
The Boondock Saints II: All Saints Day,11/24/2009,8000000,10629321,2629321,1.328665125
Next of Kin,10/20/1989,12000000,15942628,3942628,1.3285523333333333
Broadway Danny Rose,1/27/1984,8000000,10600497,2600497,1.325062125
An Ideal Husband,4/15/1999,14000000,18535191,4535191,1.3239422142857142
Altered States,12/25/1980,15000000,19853892,4853892,1.3235928
Cats & Dogs 2 : The Revenge of Kitty Galore,7/30/2010,85000000,112483764,27483764,1.3233384
Parker,1/23/2013,35000000,46216641,11216641,1.3204754571428572
Herbie Fully Loaded,6/22/2005,50000000,66002004,16002004,1.32004008
The Next Karate Kid,7/18/1994,12000000,15826984,3826984,1.3189153333333334
Dark Angel,1/26/1990,7000000,9229401,2229401,1.318485857142857
Elektra,1/13/2005,43000000,56681566,13681566,1.3181759534883721
Going the Distance,9/1/2010,32000000,42045846,10045846,1.3139326875
Ghosts of the Abyss,4/10/2003,13000000,17040871,4040871,1.3108362307692307
The BFG,6/1/2016,140000000,183345589,43345589,1.30961135
Magnolia,12/8/1999,37000000,48451803,11451803,1.309508189189189
Killers,6/4/2010,75000000,98159963,23159963,1.3087995066666667
The Thing,6/25/1982,15000000,19629760,4629760,1.3086506666666666
Shut In,11/11/2016,10000000,13082071,3082071,1.3082071
Starman,12/13/1984,22000000,28744356,6744356,1.3065616363636363
Wild Wild West,6/29/1999,170000000,222104681,52104681,1.3064981235294117
RoboCop 2,6/22/1990,35000000,45681173,10681173,1.3051763714285713
Priest,5/5/2011,60000000,78309131,18309131,1.3051521833333333
Zodiac,3/2/2007,65000000,84785914,19785914,1.3043986769230769
Jack,8/9/1996,45000000,58620973,13620973,1.3026882888888889
Crazy/Beautiful,6/29/2001,13000000,16929123,3929123,1.3022402307692307
Dracula: Prince of Darkness,1/9/1966,280379,364937,84558,1.3015846407897882
Nocturnal Animals,11/4/2016,22500000,29252978,6752978,1.3001323555555555
Kelly's Heroes,6/22/1970,4000000,5200000,1200000,1.3
A Rage in Harlem,5/3/1991,8000000,10400000,2400000,1.3
Queen of the Damned,2/10/2002,35000000,45479110,10479110,1.2994031428571429
The Sentinel,4/19/2006,60000000,77920346,17920346,1.2986724333333333
The Light Between Oceans,9/2/2016,20000000,25956113,5956113,1.29780565
Paper Heart,7/31/2009,1000000,1296971,296971,1.296971
The Wraith,11/21/1986,2700000,3500000,800000,1.2962962962962963
Seven Psychopaths,9/7/2012,15000000,19422261,4422261,1.2948174
The Island,7/20/2005,126000000,162949164,36949164,1.2932473333333334
Mio fratello è figlio unico,4/20/2007,5000000,6463286,1463286,1.2926572
La isla mínima,9/25/2014,4000000,5169755,1169755,1.29243875
New Nightmare,10/13/1994,14000000,18090181,4090181,1.2921557857142858
El Dorado,12/17/1966,4653000,6000000,1347000,1.2894906511927788
Boys and Girls,6/16/2000,16000000,20627372,4627372,1.28921075
54,8/28/1998,13000000,16757163,3757163,1.2890125384615385
Aliens in the Attic,7/31/2009,45000000,57881056,12881056,1.286245688888889
The Abyss,8/9/1989,70000000,90000098,20000098,1.2857156857142857
Phoenix Forgotten,4/21/2017,2800000,3600000,800000,1.2857142857142858
In the Valley of Elah,8/31/2007,23000000,29541790,6541790,1.284425652173913
Office Space,2/19/1999,10000000,12827813,2827813,1.2827813
Midnight Run,7/20/1988,30000000,38413606,8413606,1.2804535333333333
Der Himmel über Berlin,1/1/1987,2500000,3200000,700000,1.28
Point Blank,8/30/1967,2500000,3200000,700000,1.28
Cloud Atlas,10/26/2012,102000000,130482868,28482868,1.2792438039215686
Raging Bull,11/14/1980,18000000,23000000,5000000,1.2777777777777777
Tuck Everlasting,10/11/2002,15000000,19158074,4158074,1.2772049333333333
The Mechanic,1/13/2011,40000000,51070807,11070807,1.276770175
Choke,9/26/2008,3000000,3830137,830137,1.2767123333333332
The Bling Ring,6/12/2013,15000000,19145732,4145732,1.2763821333333334
Bolero,8/31/1984,7000000,8914881,1914881,1.2735544285714286
Point Break,12/3/2015,105000000,133718711,28718711,1.2735115333333333
3:10 to Yuma,9/6/2007,55000000,70016220,15016220,1.2730221818181817
I Don't Know How She Does It,9/16/2011,24000000,30551495,6551495,1.2729789583333333
From a Whisper to a Scream,9/25/1987,1100000,1400000,300000,1.2727272727272727
Stargate: The Ark of Truth,3/11/2008,7000000,8900000,1900000,1.2714285714285714
Brother,9/9/2000,12000000,15250000,3250000,1.2708333333333333
Rumor Has It...,12/23/2005,70000000,88933562,18933562,1.270479457142857
Incarnate,12/1/2016,5000000,6341855,1341855,1.268371
Prom,4/29/2011,8000000,10130000,2130000,1.26625
Reds,12/25/1981,32000000,40382659,8382659,1.26195809375
Judge Dredd,6/30/1995,90000000,113493481,23493481,1.2610386777777778
Torrente 5: Operación Eurovegas,10/3/2014,9272437,11672363,2399926,1.2588236512148856
Legend of the Lost,12/17/1957,1750000,2200000,450000,1.2571428571428571
Hardball,9/14/2001,32000000,40222729,8222729,1.25696028125
Hey Ram,2/18/2000,3900000,4900000,1000000,1.2564102564102564
The Nice Guys,5/15/2016,50000000,62788218,12788218,1.25576436
Arthur et les Minimoys,12/13/2006,86000000,107944236,21944236,1.255165534883721
Full Frontal,8/2/2002,2000000,2506446,506446,1.253223
Pumpkinhead,6/9/1988,3500000,4385516,885516,1.2530045714285714
Dinner for Schmucks,7/30/2010,69000000,86387857,17387857,1.2519979275362318
Forces of Nature,3/12/1999,75000000,93888180,18888180,1.2518424
Ruby in Paradise,10/8/1993,800000,1001437,201437,1.25179625
Machete Kills,9/12/2013,12000000,15008161,3008161,1.2506800833333334
The Rescuers Down Under,11/16/1990,37931000,47431461,9500461,1.2504669267881152
The Cowboys,1/13/1972,6000000,7500000,1500000,1.25
Anna Karenina,8/30/1935,1152000,1439000,287000,1.2491319444444444
Zwartboek,9/1/2006,21000000,26193068,5193068,1.2472889523809523
Welcome Home Roscoe Jenkins,2/8/2008,35000000,43650785,8650785,1.2471652857142856
The Last Godfather,12/29/2010,13400000,16700000,3300000,1.2462686567164178
Kicking & Screaming,5/13/2005,45000000,56070433,11070433,1.2460096222222221
Ladder 49,10/1/2004,60000000,74541707,14541707,1.2423617833333334
The Island of Dr. Moreau,8/23/1996,40000000,49627779,9627779,1.240694475
Shabd,2/4/2005,2500000,3100000,600000,1.24
Paris,1/19/2008,19000000,23550000,4550000,1.2394736842105263
The Railway Man,12/26/2013,18000000,22309223,4309223,1.2394012777777779
The Kingdom,8/22/2007,70000000,86658558,16658558,1.2379794
The Core,3/28/2003,60000000,74208267,14208267,1.23680445
RED,10/13/2010,58000000,71664962,13664962,1.2356027931034483
Keeping the Faith,4/14/2000,30000000,37036004,7036004,1.2345334666666667
Cinderella Man,6/2/2005,88000000,108539911,20539911,1.2334080795454545
A Man Apart,4/4/2003,36000000,44350926,8350926,1.2319701666666667
Left Behind,10/3/2014,16000000,19682924,3682924,1.23018275
The Air Up There,1/7/1994,17080000,21011500,3931500,1.2301814988290398
The Family,9/13/2013,30000000,36894225,6894225,1.2298075
Evolution,6/8/2001,80000000,98376292,18376292,1.22970365
Deep Blue Sea,7/28/1999,60000000,73648228,13648228,1.2274704666666667
Snitch,2/21/2013,35000000,42930462,7930462,1.2265846285714286
Tears of the Sun,3/7/2003,70000000,85632458,15632458,1.2233208285714285
The Shaggy Dog,3/9/2006,50000000,61112916,11112916,1.22225832
Peter Pan,12/25/2003,100000000,121975011,21975011,1.21975011
Righteous Kill,9/11/2008,60000000,73174566,13174566,1.2195761
Riding Giants,7/9/2004,2600000,3166000,566000,1.2176923076923076
Carlito's Way,11/10/1993,30000000,36516012,6516012,1.2172004
The Girl Next Door,4/9/2004,25000000,30411183,5411183,1.21644732
Kongens nei,9/29/2016,7500000,9100000,1600000,1.2133333333333334
Miami Vice,7/27/2006,135000000,163794509,28794509,1.2132926592592592
Trance,3/27/2013,20000000,24261569,4261569,1.21307845
Tarif Novogodniy,12/4/2008,3200000,3877492,677492,1.21171625
Mean Creek,1/15/2004,500000,603943,103943,1.207886
'N Beetje Verliefd,12/14/2006,800000,966214,166214,1.2077675
An American Werewolf in Paris,12/25/1997,22000000,26570463,4570463,1.2077483181818183
Let Me In,10/1/2010,20000000,24145613,4145613,1.20728065
Sugar & Spice,1/24/2001,11000000,13276953,2276953,1.2069957272727272
Crossover,9/1/2006,5800000,7000000,1200000,1.206896551724138
Red Heat,6/17/1988,29000000,34994648,5994648,1.206712
Larry Crowne,6/30/2011,30000000,36160375,6160375,1.2053458333333333
Godsend,4/30/2004,25000000,30114487,5114487,1.20457948
Chain Reaction,8/2/1996,50000000,60209334,10209334,1.20418668
Wolf Creek 2,8/30/2013,8000000,9630444,1630444,1.2038055
Madras Cafe,8/23/2013,5400000,6500000,1100000,1.2037037037037037
My Life in Ruins,2/6/2009,17000000,20455276,3455276,1.2032515294117647
The International,2/3/2009,50000000,60161391,10161391,1.20322782
The Preacher's Wife,12/13/1996,40000000,48093211,8093211,1.202330275
Perfect Stranger,4/12/2007,60795000,73090611,12295611,1.2022470762398223
Seventh Son,12/12/2014,95000000,114178613,19178613,1.2018801368421053
A Good Year,9/9/2006,35000000,42064105,7064105,1.2018315714285714
The Manchurian Candidate,7/30/2004,80000000,96105964,16105964,1.20132455
The Manchurian Candidate,10/24/1962,80000000,96105910,16105910,1.201323875
The Gift,12/22/2000,10000000,12008642,2008642,1.2008642
Fort Apache,3/26/1948,2500000,3000000,500000,1.2
Igor,9/19/2008,25000000,30000000,5000000,1.2
I Think I Love My Wife,3/16/2007,11000000,13196245,2196245,1.1996586363636363
Consenting Adults,10/16/1992,18000000,21591728,3591728,1.1995404444444444
Woodlawn,10/15/2015,12000000,14394097,2394097,1.1995080833333334
Donnie Brasco,2/27/1997,35000000,41954997,6954997,1.1987142
The Brothers Grimm,8/26/2005,88000000,105316267,17316267,1.1967757613636363
Tin Cup,8/16/1996,45000000,53854588,8854588,1.1967686222222222
Push,2/6/2009,38000000,45465299,7465299,1.1964552368421053
The Last Temptation of Christ,8/12/1988,7000000,8373585,1373585,1.1962264285714286
16 Blocks,3/1/2006,55000000,65664721,10664721,1.1939040181818181
American History X,10/30/1998,20000000,23875127,3875127,1.19375635
Smoke,6/9/1995,7000000,8349430,1349430,1.1927757142857143
Valentino,3/8/1951,1300000,1550000,250000,1.1923076923076923
Frailty,11/17/2001,11000000,13110448,2110448,1.191858909090909
Rough Cut,6/19/1980,14000000,16656125,2656125,1.1897232142857144
Trolljegeren,10/29/2010,3500000,4159678,659678,1.1884794285714286
xXx: State of the Union,4/27/2005,60000000,71073932,11073932,1.1845655333333334
Blade Runner,6/25/1982,28000000,33139618,5139618,1.1835577857142856
Rules of Engagement,4/7/2000,60000000,71000000,11000000,1.1833333333333333
The Dark Tower,8/3/2017,60000000,71000000,11000000,1.1833333333333333
A Mighty Heart,1/1/2007,16000000,18928871,2928871,1.1830544375
The Painted Veil,11/23/1934,947000,1120000,173000,1.1826821541710666
Dracula 2000,12/22/2000,28000000,33000337,5000337,1.1785834642857143
The Story of Us,10/13/1999,50000000,58900031,8900031,1.17800062
Assault on Precinct 13,1/19/2005,30000000,35294470,5294470,1.1764823333333334
La peggior settimana della mia vita,10/27/2011,11000000,12935800,1935800,1.1759818181818182
Captain Fantastic,7/2/2016,5000000,5879736,879736,1.1759472
The Opposite of Sex,5/22/1998,5000000,5879254,879254,1.1758508
W.,10/17/2008,25100000,29506464,4406464,1.1755563346613547
Mine vaganti,2/12/2010,7000000,8220215,1220215,1.1743164285714285
Self/less,7/10/2015,26000000,30523226,4523226,1.1739702307692308
The Train,9/21/1964,5800000,6800000,1000000,1.1724137931034482
The 6th Day,11/17/2000,82000000,96085477,14085477,1.1717741097560976
Grave,10/7/2016,3500000,4100000,600000,1.1714285714285715
Laitakaupungin valot,2/3/2006,1380000,1615018,235018,1.1703028985507247
Birdman of Alcatraz,7/3/1962,2650000,3100000,450000,1.169811320754717
Miss Potter,12/3/2006,30000000,35078241,5078241,1.1692747
Masterminds,9/29/2016,25000000,29200000,4200000,1.168
Kidnap,8/4/2017,21000000,24527158,3527158,1.1679599047619047
Disturbing Behavior,7/24/1998,15000000,17507368,2507368,1.1671578666666667
Random Hearts,10/8/1999,64000000,74608570,10608570,1.16575890625
Kubo and the Two Strings,8/18/2016,60000000,69929545,9929545,1.1654924166666667
Torque,1/16/2004,40000000,46546197,6546197,1.163654925
Fantastic Mr. Fox,10/23/2009,40000000,46471023,6471023,1.161775575
Get Rich or Die Tryin',11/9/2005,40000000,46442528,6442528,1.1610632
新少林寺,1/20/2011,29000000,33662874,4662874,1.1607887586206898
The Thirteenth Floor,4/16/1999,16000000,18564088,2564088,1.1602555
Tora! Tora! Tora!,1/26/1970,25485000,29548291,4063291,1.1594385324700804
Dazed and Confused,9/24/1993,6900000,7993039,1093039,1.1584114492753623
Take the Lead,3/17/2006,30000000,34742066,4742066,1.1580688666666668
Let's Go to Prison,11/17/2006,4000000,4630045,630045,1.15751125
Happy Feet Two,11/17/2011,130000000,150406466,20406466,1.1569728153846155
Starship Troopers,11/6/1997,105000000,121214377,16214377,1.154422638095238
Draft Day,4/11/2014,25000000,28831145,3831145,1.1532458
Tango & Cash,12/22/1989,55000000,63408614,8408614,1.1528838909090908
La battaglia di Algeri,9/8/1966,800000,921548,121548,1.151935
Thief of Hearts,10/19/1984,9000000,10364904,1364904,1.151656
Blast from the Past,2/12/1999,35000000,40263020,5263020,1.150372
Grease 2,6/11/1982,13200000,15171476,1971476,1.1493542424242424
Steve Jobs,10/9/2015,30000000,34441873,4441873,1.1480624333333334
Alive,1/15/1993,32000000,36733909,4733909,1.14793465625
The Rainmaker,11/18/1997,40000000,45916769,5916769,1.147919225
Armored,12/4/2009,20000000,22942221,2942221,1.14711105
Elegy,8/8/2008,13000000,14894347,1894347,1.145719
Arthur,4/8/2011,40000000,45735397,5735397,1.143384925
Suffragette,10/16/2015,14000000,16002420,2002420,1.14303
Mermaids,12/14/1990,31000000,35419397,4419397,1.142561193548387
200 Cigarettes,2/26/1999,6000000,6852450,852450,1.142075
Bad News Bears,7/22/2005,30000000,34252847,4252847,1.1417615666666667
Ender's Game,10/23/2013,110000000,125537191,15537191,1.1412471909090909
Annie,6/18/1982,50000000,57059003,7059003,1.14118006
The Powerpuff Girls Movie,7/3/2002,10000000,11411644,1411644,1.1411644
The Raven,3/9/2012,26000000,29657751,3657751,1.1406827307692309
The Haunting,7/23/1999,80000000,91188905,11188905,1.1398613125
The Circle,4/27/2017,18000000,20497844,2497844,1.1387691111111111
Firestarter,5/11/1984,15000000,17080167,2080167,1.1386778
Fantasia 2000,12/17/1999,80000000,90874570,10874570,1.135932125
Poseidon,5/12/2006,160000000,181674817,21674817,1.13546760625
Superman IV: The Quest for Peace,7/23/1987,17000000,19300000,2300000,1.1352941176470588
Murder by Numbers,4/19/2002,50000000,56714147,6714147,1.13428294
The Shawshank Redemption,9/23/1994,25000000,28341469,3341469,1.13365876
The Treasure of the Sierra Madre,1/24/1948,3800000,4307000,507000,1.1334210526315789
The Stepford Wives,6/10/2004,90000000,102000000,12000000,1.1333333333333333
Flaskepost fra P,3/3/2016,5210000,5900000,690000,1.1324376199616122
Unleashed,2/2/2005,45000000,50871113,5871113,1.1304691777777778
Leprechaun 2,4/7/1994,2000000,2260622,260622,1.130311
Demonic,2/12/2015,3000000,3387000,387000,1.129
Meet the Robinsons,3/23/2007,150000000,169332978,19332978,1.12888652
Rob Roy,4/13/1995,28000000,31596911,3596911,1.1284611071428572
Shopgirl,10/21/2005,10284523,11588205,1303682,1.1267615425625477
Labor Day,12/27/2013,18000000,20275812,2275812,1.126434
Furry Vengeance,4/2/2010,35000000,39340177,4340177,1.124005057142857
Xanadu,8/8/1980,20000000,22471595,2471595,1.12357975
Patriots Day,12/12/2016,45000000,50548152,5548152,1.1232922666666667
Grudge Match,12/25/2013,40000000,44907260,4907260,1.1226815
Star Trek: Nemesis,12/13/2002,60000000,67312826,7312826,1.1218804333333334
Стиляги,12/25/2008,15000000,16810383,1810383,1.1206922
Zoolander 2,2/6/2016,50000000,55969000,5969000,1.11938
In the Mouth of Madness,12/12/1994,8000000,8946600,946600,1.118325
Boys on the Side,2/3/1995,21000000,23450000,2450000,1.1166666666666667
Joan of Arc,10/18/1999,60000000,66976317,6976317,1.11627195
"\"花木�?\"\"When barbarian hordes threaten her homeland\"",11/26/2009,12000000,13380561,1380561,1.11504675
Dreamcatcher,3/21/2003,68000000,75715436,7715436,1.113462294117647
City Island,3/6/2009,6000000,6670712,670712,1.1117853333333334
The Box,9/17/2009,30000000,33333531,3333531,1.1111177
Reign Over Me,3/23/2007,20000000,22222308,2222308,1.1111154
Dead Silence,3/16/2007,20000000,22217407,2217407,1.11087035
Out of Time,10/3/2003,50000000,55495563,5495563,1.10991126
Whip It,9/13/2009,15000000,16633035,1633035,1.108869
Agent Cody Banks 2: Destination London,6/24/2004,26000000,28818995,2818995,1.1084228846153845
The Marine,10/13/2006,20000000,22165608,2165608,1.1082804
Dirty Dancing: Havana Nights,2/27/2004,25000000,27685016,2685016,1.10740064
Deepwater Horizon,9/29/2016,110000000,121790373,11790373,1.1071852090909091
Boiler Room,2/18/2000,26000000,28780255,2780255,1.1069328846153845
Ice Princess,3/17/2005,25000000,27645491,2645491,1.10581964
Carnage,9/16/2011,25000000,27603069,2603069,1.10412276
The Ant Bully,7/27/2006,50000000,55181129,5181129,1.10362258
Avalon,1/20/2001,8000000,8826094,826094,1.10326175
Graveyard Shift,10/26/1990,10500000,11582891,1082891,1.1031324761904762
The Chronicles of Riddick,6/11/2004,105000000,115772733,10772733,1.1025974571428572
Morgan,9/1/2016,8000000,8810591,810591,1.101323875
Tomorrowland,5/19/2015,190000000,209154322,19154322,1.1008122210526317
La doppia ora,10/9/2009,3906840,4300000,393160,1.100633760276848
Man on a Ledge,1/13/2012,42000000,46221189,4221189,1.1005045
Confessions of a Dangerous Mind,12/30/2002,30000000,33013805,3013805,1.1004601666666667
Confessions of a Dangerous Mind,12/30/2002,30000000,33013805,3013805,1.1004601666666667
Spacehunter: Adventures in the Forbidden Zone,5/20/1983,15000000,16500000,1500000,1.1
Hross í oss,8/30/2013,10,11,1,1.1
Fair Game,5/20/2010,22000000,24188922,2188922,1.0994964545454546
Green Lantern,6/16/2011,200000000,219851172,19851172,1.09925586
Wild Child,1/1/2008,20000000,21972336,1972336,1.0986168
FC Venus,12/30/2005,2196531,2411594,215063,1.097910295825554
Airborne,9/17/1993,2600000,2850263,250263,1.096255
Beerfest,8/25/2006,17500000,19179969,1679969,1.0959982285714285
The Castle,4/10/1997,786675,861789,75114,1.095482886833826
Tucker and Dale vs Evil,1/22/2010,5000000,5476793,476793,1.0953586
Charlie St. Cloud,5/1/2010,44000000,48190704,4190704,1.0952432727272727
Made,7/13/2001,5000000,5476060,476060,1.095212
Sucker Punch,3/24/2011,82000000,89792502,7792502,1.095030512195122
John Carter,3/7/2012,260000000,284139100,24139100,1.0928426923076924
Hugo,11/22/2011,170000000,185770160,15770160,1.0927656470588236
Last Night,5/11/2010,7000000,7644937,644937,1.0921338571428572
Cookie's Fortune,1/22/1999,10000000,10920544,920544,1.0920544
The Incredible Hulk,6/12/2008,150000000,163712074,13712074,1.0914138266666666
Metegol,7/18/2013,22000000,24000000,2000000,1.0909090909090908
Shootout at Lokhandwala,5/25/2007,11000000,12000000,1000000,1.0909090909090908
Captain Corelli's Mandolin,8/17/2001,57000000,62112895,5112895,1.0896999122807018
Next,4/24/2007,70000000,76066841,6066841,1.086669157142857
Outland,5/22/1981,16000000,17374595,1374595,1.0859121875
A Monster Calls,10/7/2016,43000000,46652768,3652768,1.0849480930232558
The Eagle,2/8/2011,25000000,27122040,2122040,1.0848816
Sleepless,1/12/2017,30000000,32540674,2540674,1.0846891333333333
Iron Sky,3/10/2012,7500000,8135031,635031,1.0846708
The Disappearance of Alice Creed,9/12/2009,800000,867714,67714,1.0846425
Danny Collins,3/19/2015,10000000,10835752,835752,1.0835752
Hidalgo,3/5/2004,100000000,108103450,8103450,1.0810345
Alexander,11/21/2004,155000000,167298192,12298192,1.0793431741935484
Batman: The Killing Joke,7/21/2016,3500000,3775000,275000,1.0785714285714285
Gods of Egypt,2/25/2016,140000000,150680864,10680864,1.0762918857142858
Living Out Loud,10/30/1998,12000000,12902790,902790,1.0752325
Mohenjo Daro,8/11/2016,15050000,16180000,1130000,1.0750830564784053
Four Rooms,12/9/1995,4000000,4300000,300000,1.075
Case 39,8/13/2009,27000000,29000000,2000000,1.0740740740740742
Barfly,9/2/1987,3000000,3221568,221568,1.073856
Cowboys & Aliens,7/29/2011,163000000,174822325,11822325,1.0725296012269938
The Kid,7/7/2000,65000000,69700000,4700000,1.0723076923076924
CHiPS,3/23/2017,25000000,26800152,1800152,1.07200608
Laws of Attraction,4/4/2004,28000000,30016165,2016165,1.0720058928571428
Best Defense,7/20/1984,18000000,19265302,1265302,1.0702945555555556
Eastern Promises,9/14/2007,51500000,55112356,3612356,1.0701428349514563
Traitor,8/23/2008,22000000,23530831,1530831,1.0695832272727273
The Thief of Bagdad,3/18/1924,1135654,1213880,78226,1.0688818953660182
C'era una volta il West,12/21/1968,5000000,5321508,321508,1.0643016
To Die For,5/20/1995,20000000,21284514,1284514,1.0642257
Miranda,4/6/1948,784170,834332,50162,1.063968272185878
Cloclo,3/14/2012,27563396,29193330,1629934,1.0591340051131581
ATL,3/31/2006,20000000,21170563,1170563,1.05852815
Na Igre,11/26/2009,3500000,3704408,204408,1.0584022857142856
Fifty Shades of Black,1/28/2016,20000000,21164799,1164799,1.05823995
Matchstick Men,9/1/2003,62000000,65565672,3565672,1.0575108387096774
Drop Dead Gorgeous,7/23/1999,10000000,10571408,571408,1.0571408
Affliction,8/28/1997,6000000,6330054,330054,1.055009
Kiss Kiss Bang Bang,9/5/2005,15000000,15785148,785148,1.0523432
Ong Bak 2,12/4/2008,8500000,8936663,436663,1.0513721176470587
Bounce,11/15/2000,35000000,36779296,1779296,1.0508370285714286
Lootera,4/4/2013,4100000,4300000,200000,1.048780487804878
K-PAX,10/22/2001,48000000,50315140,2315140,1.0482320833333334
The Guilt Trip,12/19/2012,40000000,41863726,1863726,1.04659315
The Score,7/13/2001,68000000,71069884,3069884,1.0451453529411765
Aliens vs Predator: Requiem,12/25/2007,40000000,41797066,1797066,1.04492665
Incendies,9/4/2010,6800000,7103838,303838,1.0446820588235295
Outside Providence,8/16/1999,7000000,7292175,292175,1.0417392857142858
The Rapture,10/4/1991,1227401,1277401,50000,1.0407364830238854
The Man with the Iron Fists,11/2/2012,15000000,15608545,608545,1.0405696666666666
The Ref,3/9/1994,11000000,11439193,439193,1.0399266363636364
Year One,6/18/2009,60000000,62357900,2357900,1.0392983333333334
Surviving the Game,4/15/1994,7400000,7690013,290013,1.0391909459459459
Stardust Memories,9/26/1980,10000000,10389003,389003,1.0389003
Dad,10/27/1989,19000000,19738015,738015,1.0388428947368422
Jacob's Ladder,11/2/1990,25000000,25965144,965144,1.03860576
Pride and Glory,9/9/2008,30000000,31148328,1148328,1.0382776
Ultraviolet,3/3/2006,30000000,31070211,1070211,1.0356737
Shanghai Noon,5/26/2000,55000000,56932305,1932305,1.0351328181818182
Shadow of the Vampire,5/15/2000,8000000,8279017,279017,1.034877125
Pinocchio,12/25/2002,40000000,41323171,1323171,1.033079275
Jersey Girl,3/25/2004,35000000,36098382,1098382,1.031382342857143
Transcendence,4/16/2014,100000000,103039258,3039258,1.03039258
Babylon A.D.,8/20/2008,70000000,72108608,2108608,1.0301229714285713
Project X,4/17/1987,18000000,18532286,532286,1.0295714444444444
Bleed for This,11/4/2016,6000000,6174491,174491,1.0290818333333334
Speed 2: Cruise Control,6/13/1997,160000000,164508066,4508066,1.0281754125
House of Sand and Fog,12/19/2003,16500000,16942795,442795,1.0268360606060607
Howard the Duck,8/1/1986,37000000,37962774,962774,1.026020918918919
Rabbit Hole,12/16/2010,5000000,5129058,129058,1.0258116
Jawbreaker,1/30/1999,3000000,3076820,76820,1.0256066666666668
S. Darko,4/28/2009,4000000,4100000,100000,1.025
After the Sunset,11/12/2004,60000000,61347797,1347797,1.0224632833333334
Walking Tall,4/2/2004,56000000,57223890,1223890,1.0218551785714285
Deuce Bigalow: European Gigolo,8/6/2005,22000000,22400154,400154,1.0181888181818182
The New World,12/25/2005,30000000,30536013,536013,1.0178671
Basquiat,8/9/1996,2962051,3011195,49144,1.016591206565991
From Paris with Love,2/5/2010,52000000,52826594,826594,1.0158960384615385
The Frisco Kid,7/6/1979,9200000,9346177,146177,1.015888804347826
"\"金陵十三�?\"\"A Westerner finds refuge with a group of women in a church during Japan's rape of Nanking in 1937. Posing as a priest\"",12/15/2011,94000000,95311434,1311434,1.0139514255319149
Jack the Giant Slayer,2/27/2013,195000000,197687603,2687603,1.0137825794871795
Angel Heart,3/6/1987,17000000,17185632,185632,1.0109195294117648
Appaloosa,9/12/2008,20000000,20211394,211394,1.0105697
The Bad News Bears,4/7/1976,35000000,35323292,323292,1.0092369142857143
The Dreamers,9/1/2003,15000000,15121165,121165,1.0080776666666666
West Is West,10/19/2010,3837625,3867000,29375,1.0076544737956419
Dark City,2/27/1998,27000000,27200316,200316,1.007419111111111
Stoker,2/28/2013,12000000,12077441,77441,1.0064534166666668
The Watch,7/26/2012,68000000,68267862,267862,1.0039391470588235
Death Proof,5/21/2007,25000000,25037897,37897,1.00151588
The Hunchback of Notre Dame,6/21/1996,100000000,100138851,138851,1.00138851
Absolute Power,2/14/1997,50000000,50068310,68310,1.0013662
Beautiful Creatures,2/13/2013,60000000,60052138,52138,1.0008689666666666
Where the Wild Things Are,10/16/2009,100000000,100086793,86793,1.00086793
Nick of Time,11/22/1995,8169363,8175346,5983,1.000732370443081
F.I.S.T.,4/26/1978,11,11,0,1.0
The War of the Worlds,8/13/1953,2000000,2000000,0,1.0
Narco,12/1/2004,823258,823258,0,1.0
Kandukondain Kandukondain,5/5/2000,500000,500000,0,1.0
Bran Nue Dae,8/9/2009,7,7,0,1.0
தீணா,1/14/2001,500000,500000,0,1.0
The Letters,12/4/2015,1,1,0,1.0
Villan,12/5/2002,500000,500000,0,1.0
Citizen,6/8/2001,500000,500000,0,1.0
Desmundo,11/8/2002,3,3,0,1.0
Bikini Spring Break,6/26/2012,500000,500000,0,1.0
Amarkalam,8/25/1999,500000,500000,0,1.0
Vaali,5/1/1999,500000,500000,0,1.0
Lost in the Sun,11/5/2015,25000,25000,0,1.0
காதல�?கோட்டை,7/12/1996,500000,500000,0,1.0
முகவரி,2/2/2000,500000,500000,0,1.0
Treehouse,10/20/2014,3250000,3250000,0,1.0
Varalaru,10/20/2006,500000,500000,0,1.0
Vibes,8/5/1988,1884000,1883811,-189,0.9998996815286624
Loving,11/4/2016,9000000,8996802,-3198,0.9996446666666666
Win a Date with Tad Hamilton!,1/23/2004,17000000,16980098,-19902,0.9988292941176471
Wish I Was Here,1/18/2014,5500000,5483299,-16701,0.9969634545454545
The Brave One,9/14/2007,70000000,69766619,-233381,0.9966659857142857
Serenity,8/25/2005,39000000,38869464,-130536,0.9966529230769231
The 33,8/6/2015,25000000,24902723,-97277,0.99610892
Raising Helen,5/27/2004,50000000,49718611,-281389,0.99437222
Fire in the Sky,3/12/1993,19885552,19724334,-161218,0.9918927068255384
Raise Your Voice,8/10/2004,15000000,14867514,-132486,0.9911676
Scouts Guide to the Zombie Apocalypse,10/23/2015,15000000,14860766,-139234,0.9907177333333334
Zathura: A Space Adventure,11/6/2005,65000000,64321501,-678499,0.9895615538461539
Evan Almighty,6/9/2007,175000000,173000000,-2000000,0.9885714285714285
Sex Drive,10/16/2008,19000000,18755936,-244064,0.9871545263157895
A United Kingdom,11/25/2016,14000000,13819139,-180861,0.9870813571428572
Win Win,3/18/2011,10831173,10654385,-176788,0.983677852805047
True Romance,9/9/1993,12500000,12281551,-218449,0.98252408
The Black Dahlia,9/15/2006,50000000,49111202,-888798,0.98222404
On Deadly Ground,2/18/1994,50000000,49000000,-1000000,0.98
Four Eyed Monsters,1/21/2005,250000,245000,-5000,0.98
Biker Boyz,1/31/2003,24000000,23510601,-489399,0.979608375
The Frighteners,7/18/1996,30000000,29359216,-640784,0.9786405333333333
Fred Claus,11/3/2007,100000000,97838349,-2161651,0.97838349
Star!,7/18/1968,14320000,14000000,-320000,0.9776536312849162
The Afflicted,10/22/2011,180000,175742,-4258,0.9763444444444445
Clue,12/13/1985,15000000,14643997,-356003,0.9762664666666667
Exorcist: The Beginning,8/20/2004,80000000,78000586,-1999414,0.975007325
The Transformers: The Movie,8/8/1986,6000000,5849647,-150353,0.9749411666666666
The Next Best Thing,3/3/2000,25000000,24362772,-637228,0.97451088
The Hitcher,2/21/1986,6000000,5844868,-155132,0.9741446666666667
Bulworth,5/15/1998,30000000,29202884,-797116,0.9734294666666666
Sur la Piste du Marsupilami,4/3/2012,50000000,48600000,-1400000,0.972
Alatriste,9/1/2006,24000000,23321954,-678046,0.9717480833333333
Intermission,8/29/2003,5000000,4856298,-143702,0.9712596
P2,11/9/2007,8000000,7766240,-233760,0.97078
American Ultra,8/19/2015,28000000,27139524,-860476,0.9692687142857143
The Wicker Man,9/1/2006,40000000,38755073,-1244927,0.968876825
90 Minutes in Heaven,9/11/2015,5000000,4842699,-157301,0.9685398
Il capitale umano,1/9/2014,6000000,5809330,-190670,0.9682216666666666
Red Lights,3/2/2012,14000000,13551174,-448826,0.967941
Le passé,5/17/2013,11000000,10631747,-368253,0.9665224545454545
Latter Days,7/10/2003,850000,819939,-30061,0.9646341176470589
Drowning Mona,3/3/2000,16000000,15427192,-572808,0.9641995
Wabash Avenue,3/31/1950,2115000,2039000,-76000,0.9640661938534278
Seeking a Friend for the End of the World,6/22/2012,10000000,9636289,-363711,0.9636289
G.I. Jane,8/22/1997,50000000,48169156,-1830844,0.96338312
Faster,11/23/2010,24000000,23081726,-918274,0.9617385833333333
Crimes and Misdemeanors,10/13/1989,19000000,18254702,-745298,0.9607737894736842
The Dilemma,1/13/2011,70000000,67112664,-2887336,0.9587523428571428
The Founder,11/24/2016,25000000,23964782,-1035218,0.95859128
Inkheart,12/11/2008,60000000,57490374,-2509626,0.9581729
Center Stage,5/12/2000,18000000,17200925,-799075,0.9556069444444445
Quest for Camelot,5/15/1998,40000000,38172500,-1827500,0.9543125
The Rundown,9/26/2003,85000000,80916492,-4083508,0.9519587294117647
Te3n,6/10/2016,5069632,4817642,-251990,0.9502942225392297
Stitches,5/19/2012,100000,95000,-5000,0.95
En kongelig affære,3/29/2012,8000000,7594693,-405307,0.949336625
Green Zone,3/11/2010,100000000,94882889,-5117111,0.94882889
The Age of Innocence,9/17/1993,34000000,32255440,-1744560,0.9486894117647059
Norm of the North,1/14/2016,18000000,17062499,-937501,0.9479166111111111
Beröringen,7/14/1971,6900000,6530000,-370000,0.946376811594203
Home on the Range,4/2/2004,110000000,103951461,-6048539,0.9450132818181818
Bangkok Dangerous,8/21/2008,45000000,42487390,-2512610,0.9441642222222222
The Losers,4/23/2010,25000000,23580000,-1420000,0.9432
El Abrazo de la Serpiente,5/25/2015,1400000,1320005,-79995,0.9428607142857143
Bad Company,6/7/2002,70000000,65977295,-4022705,0.9425327857142857
Your Friends & Neighbors,2/4/1998,5000000,4710749,-289251,0.9421498
Lars and the Real Girl,10/12/2007,12000000,11293663,-706337,0.9411385833333333
Ben-Hur,8/17/2016,100000000,94061311,-5938689,0.94061311
15 Minutes,3/1/2001,60000000,56359980,-3640020,0.939333
Captain Ron,9/18/1992,24000000,22518097,-1481903,0.9382540416666667
In the Heart of the Sea,11/20/2015,100000000,93820758,-6179242,0.93820758
Bicentennial Man,12/17/1999,100000000,93700000,-6300000,0.937
Edge of Darkness,1/29/2010,80000000,74901339,-5098661,0.9362667375
Batman: Mask of the Phantasm,12/25/1993,6000000,5617391,-382609,0.9362318333333334
Happiness,10/16/1998,3000000,2807390,-192610,0.9357966666666667
Утомлённые солнцем,5/1/1994,2800000,2616503,-183497,0.9344653571428572
Space Battleship Yamato,12/1/2010,12000000,11212294,-787706,0.9343578333333333
रावण,6/18/2010,4500000,4200000,-300000,0.9333333333333333
Doom,10/20/2005,60000000,55987321,-4012679,0.9331220166666667
Snowden,9/15/2016,40000000,37279439,-2720561,0.931985975
Big Fan,1/18/2009,250000,232732,-17268,0.930928
Fired Up!,2/20/2009,20000000,18599102,-1400898,0.9299551
The Concorde... Airport '79,8/17/1979,14000000,13015688,-984312,0.929692
Matilda,8/2/1996,36000000,33459416,-2540584,0.9294282222222222
Untraceable,1/22/2008,35000000,32483410,-2516590,0.9280974285714285
Catch That Kid,2/6/2004,18000000,16702864,-1297136,0.9279368888888889
Kingpin,7/4/1996,27000000,25023434,-1976566,0.9267938518518518
Soul Plane,5/28/2004,16000000,14822346,-1177654,0.926396625
Bel Ami,3/9/2012,9000000,8303261,-696739,0.9225845555555555
The Quiet American,11/22/2002,30000000,27674124,-2325876,0.9224708
One for the Money,1/26/2012,40000000,36893721,-3106279,0.922343025
Warrior,9/9/2011,25000000,23057115,-1942885,0.9222846
Collateral Damage,2/6/2002,85000000,78382433,-6617567,0.9221462705882353
Anjaana Anjaani,9/24/2010,6400000,5900000,-500000,0.921875
Ladyhawke,3/27/1985,20000000,18432000,-1568000,0.9216
Lock Up,8/4/1989,24000000,22099847,-1900153,0.9208269583333333
Children of Men,9/22/2006,76000000,69959751,-6040249,0.9205230394736842
Goal!: The Dream Begins,6/6/2005,30000000,27610873,-2389127,0.9203624333333333
Sahara,4/6/2005,130000000,119269486,-10730514,0.9174575846153846
Life,4/16/1999,80000000,73345029,-6654971,0.9168128625
Analyze That,12/6/2002,60000000,55003135,-4996865,0.9167189166666667
Showtime,3/14/2002,85000000,77741732,-7258268,0.9146086117647059
The Incredible Burt Wonderstone,3/14/2013,30000000,27437881,-2562119,0.9145960333333333
Elizabethtown,10/6/2005,57000000,52034889,-4965111,0.9128927894736842
Simon Birch,9/11/1998,20000000,18253415,-1746585,0.91267075
What's Eating Gilbert Grape,12/17/1993,11000000,10032765,-967235,0.9120695454545454
Miss Julie,9/7/2014,5500000,5000000,-500000,0.9090909090909091
1941,12/13/1979,35000000,31755742,-3244258,0.9073069142857143
Pompeii,2/18/2014,130000000,117831631,-12168369,0.9063971615384615
The Doors,3/1/1991,38000000,34416893,-3583107,0.9057077105263158
Frankenweenie,10/4/2012,39000000,35287788,-3712212,0.9048150769230769
Bulletproof,9/6/1996,25000000,22611954,-2388046,0.90447816
Tristan & Isolde,4/7/2006,31000000,28000000,-3000000,0.9032258064516129
For Richer or Poorer,12/11/1997,35000000,31611225,-3388775,0.9031778571428571
Unknown,11/3/2006,3700000,3338228,-361772,0.9022237837837838
Bandits,10/12/2001,75000000,67631903,-7368097,0.9017587066666667
Hanging Up,2/16/2000,40000000,36037909,-3962091,0.900947725
Rendition,9/7/2007,27500000,24748670,-2751330,0.8999516363636364
Chandni Chowk To China,1/16/2009,10500000,9400000,-1100000,0.8952380952380953
Bedknobs and Broomsticks,10/7/1971,20000000,17900000,-2100000,0.895
The Invisible,4/27/2007,30000000,26810113,-3189887,0.8936704333333333
The Negotiator,7/29/1998,50000000,44547681,-5452319,0.89095362
School for Scoundrels,9/29/2006,20000000,17807569,-2192431,0.89037845
College,8/28/2008,7000000,6230276,-769724,0.8900394285714286
Into the Blue,9/30/2005,50000000,44434439,-5565561,0.88868878
Premium Rush,8/24/2012,35000000,31083599,-3916401,0.8881028285714285
Don Juan DeMarco,10/1/1994,25000000,22200000,-2800000,0.888
南京!南京!,4/22/2009,12000000,10652498,-1347502,0.8877081666666666
The Pick-up Artist,9/18/1987,15000000,13290368,-1709632,0.8860245333333333
Galaxina,6/6/1980,5500000,4865000,-635000,0.8845454545454545
Ella Enchanted,4/9/2004,31000000,27388767,-3611233,0.8835086129032258
The Master,9/7/2012,32000000,28258060,-3741940,0.883064375
Big Game,9/5/2014,8500000,7500000,-1000000,0.8823529411764706
Frantic,2/16/1988,20000000,17637950,-2362050,0.8818975
Runaway Train,11/15/1985,9000000,7936012,-1063988,0.8817791111111111
A Scanner Darkly,5/25/2006,8700000,7659918,-1040082,0.8804503448275862
Mobsters,7/26/1991,23000000,20246790,-2753210,0.8802952173913043
Body Double,10/25/1984,10000000,8801940,-1198060,0.880194
Hot Tub Time Machine 2,2/20/2015,14000000,12314651,-1685349,0.8796179285714286
Saving Silverman,2/9/2001,22000000,19351569,-2648431,0.8796167727272727
The Aviator,12/17/2004,116000000,102000000,-14000000,0.8793103448275862
The Wiz,10/24/1978,24000000,21049053,-2950947,0.877043875
Away We Go,6/5/2009,17000000,14899417,-2100583,0.876436294117647
The Legend of Hercules,1/10/2014,70000000,61279452,-8720548,0.8754207428571429
Killer Elite,9/23/2011,66000000,57777106,-8222894,0.875410696969697
Two for the Money,10/7/2005,35000000,30526509,-4473491,0.8721859714285715
Dragonfly,2/22/2002,60000000,52322400,-7677600,0.87204
Capitalism: A Love Story,9/6/2009,20000000,17436509,-2563491,0.87182545
A Guy Thing,1/17/2003,20000000,17432163,-2567837,0.87160815
Monte Carlo,7/1/2011,20000000,17425000,-2575000,0.87125
25th Hour,12/16/2002,15000000,13060843,-1939157,0.8707228666666667
Red Tails,1/19/2012,58000000,50365377,-7634623,0.8683685689655173
Talk Radio,12/21/1988,4000000,3468572,-531428,0.867143
12 Rounds,3/19/2009,20000000,17280326,-2719674,0.8640163
The Road,11/25/2009,32000000,27635305,-4364695,0.86360328125
He Got Game,5/1/1998,25000000,21567853,-3432147,0.86271412
We Need to Talk About Kevin,9/28/2011,7000000,6038942,-961058,0.862706
Manny & Lo,1/22/1996,500000,431326,-68674,0.862652
47 Ronin,12/6/2013,175000000,150962475,-24037525,0.8626427142857143
Glengarry Glen Ross,9/15/1992,12500000,10725228,-1774772,0.85801824
Charly,9/23/1968,950000,814666,-135334,0.8575431578947369
Looney Tunes: Back in Action,11/14/2003,80000000,68514844,-11485156,0.85643555
Антикиллер Д.К.: Любовь без памяти,12/3/2009,2500000,2141028,-358972,0.8564112
The Astronaut Farmer,10/15/2006,13000000,11130889,-1869111,0.8562222307692308
Pan,9/24/2015,150000000,128388320,-21611680,0.8559221333333333
Basic,4/18/2003,50000000,42792561,-7207439,0.85585122
Victor Frankenstein,11/10/2015,40000000,34227298,-5772702,0.85568245
The Four Feathers,9/8/2002,35000000,29882645,-5117355,0.8537898571428572
Last Holiday,1/13/2006,45000000,38399961,-6600039,0.8533324666666666
Brigham City,3/30/2001,1000000,852206,-147794,0.852206
The Black Cauldron,7/24/1985,25000000,21288692,-3711308,0.85154768
Mimic,8/22/1997,30000000,25480490,-4519510,0.8493496666666667
Dark Water,6/27/2005,30000000,25473093,-4526907,0.8491031
Top Dog,4/28/1995,6000000,5093707,-906293,0.8489511666666667
Death Sentence,8/31/2007,20000000,16974459,-3025541,0.84872295
The Tale of Despereaux,12/19/2008,60000000,50877145,-9122855,0.8479524166666667
Critters 2,4/29/1988,4500000,3813293,-686707,0.8473984444444445
The Rage: Carrie 2,3/11/1999,21000000,17762705,-3237295,0.8458430952380952
The Producers,12/25/2005,45000000,38058335,-6941665,0.8457407777777778
Escape from L.A.,8/9/1996,50000000,42277365,-7722635,0.8455473
Meet Dave,7/8/2008,60000000,50650079,-9349921,0.8441679833333333
Æon Flux,11/30/2005,62000000,52304001,-9695999,0.8436129193548387
The Cold Light of Day,4/4/2012,20000000,16863583,-3136417,0.84317915
Original Sin,8/3/2001,42000000,35402320,-6597680,0.842912380952381
Jack Ryan: Shadow Recruit,1/15/2014,60000000,50549107,-9450893,0.8424851166666667
Fortress,9/30/1992,8000000,6739141,-1260859,0.842392625
Oliver Twist,9/23/2005,50000000,42093706,-7906294,0.84187412
What Dreams May Come,10/2/1998,85000000,71485043,-13514957,0.841000505882353
Macbeth,8/16/2015,15000000,12601706,-2398294,0.8401137333333333
The Pledge,1/9/2001,35000000,29400000,-5600000,0.84
Swing Vote,8/1/2008,21000000,17600000,-3400000,0.8380952380952381
Napola �?Elite für den Führer,7/4/2004,4500000,3764219,-735781,0.8364931111111111
Manhattan Murder Mystery,8/18/1993,13500000,11285588,-2214412,0.8359694814814815
Rambling Rose,9/10/1991,7500000,6266621,-1233379,0.8355494666666666
Ridicule,5/9/1996,3000000,2503829,-496171,0.8346096666666667
Deux frères,4/7/2004,74500000,62172050,-12327950,0.8345241610738255
Miami Rhapsody,1/27/1995,6,5,-1,0.8333333333333334
EuroTrip,2/20/2004,25000000,20796847,-4203153,0.83187388
20th Century Women,12/25/2016,7000000,5816211,-1183789,0.8308872857142857
Paparazzi,9/3/2004,20000000,16605763,-3394237,0.83028815
Casualties of War,8/18/1989,22500000,18671317,-3828683,0.8298363111111111
Gremlins 2: The New Batch,6/15/1990,50000000,41482207,-8517793,0.82964414
That's My Boy,6/14/2012,70000000,58058367,-11941633,0.8294052428571429
Mao's Last Dancer,10/1/2009,25000000,20719451,-4280549,0.82877804
Sky Captain and the World of Tomorrow,9/17/2004,70000000,57958696,-12041304,0.8279813714285714
Battle of the Year,9/21/2013,20000000,16549477,-3450523,0.82747385
Sydney White,9/21/2007,16500000,13620075,-2879925,0.8254590909090909
Bad Words,9/6/2013,9500000,7800000,-1700000,0.8210526315789474
Catwoman,7/22/2004,100000000,82102379,-17897621,0.82102379
Dredd,9/7/2012,50000000,41037742,-8962258,0.82075484
Club Paradise,7/11/1986,15000000,12308521,-2691479,0.8205680666666667
Ali,12/11/2001,107000000,87713825,-19286175,0.8197553738317757
Funny People,7/31/2009,75000000,61458982,-13541018,0.8194530933333334
I Love You Phillip Morris,1/18/2009,13000000,10652035,-2347965,0.8193873076923077
Gamer,9/3/2009,50000000,40828540,-9171460,0.8165708
Fun Size,10/25/2012,14000000,11417362,-2582638,0.8155258571428572
Zid,11/28/2014,1556288,1268395,-287893,0.8150130310071144
Hideaway,3/3/1995,15000000,12201255,-2798745,0.813417
I Married a Strange Person!,8/28/1998,250,203,-47,0.812
It's Kind of a Funny Story,7/6/2010,8000000,6491240,-1508760,0.811405
Anywhere But Here,11/12/1999,23000000,18653615,-4346385,0.8110267391304348
Happily N'Ever After,9/14/2006,47000000,38085778,-8914222,0.8103357021276596
2 Coelhos,1/20/2012,2000000,1620436,-379564,0.810218
A Civil Action,3/5/1998,70000000,56702901,-13297099,0.8100414428571429
The Avengers,8/13/1998,60000000,48585416,-11414584,0.8097569333333333
Bottle Shock,8/6/2008,5000000,4040588,-959412,0.8081176
Nightbreed,2/16/1990,11000000,8862354,-2137646,0.8056685454545455
Joyeux Noël,11/9/2005,22000000,17709155,-4290845,0.8049615909090909
The Road to El Dorado,3/31/2000,95000000,76432727,-18567273,0.8045550210526315
Bridget Jones: The Edge of Reason,11/10/2004,50000000,40203020,-9796980,0.8040604
The Thing,10/12/2011,35000000,28128670,-6871330,0.8036762857142857
The Three Burials of Melquiades Estrada,11/17/2005,15000000,12036149,-2963851,0.8024099333333333
For Greater Glory - The True Story of Cristiada,6/1/2012,12000000,9622846,-2377154,0.8019038333333334
I Know Who Killed Me,7/27/2007,12000000,9620399,-2379601,0.8016999166666666
Virtuosity,8/4/1995,30000000,24048000,-5952000,0.8016
After.Life,4/9/2010,4500000,3606395,-893605,0.8014211111111111
Knockaround Guys,9/7/2001,15000000,12000000,-3000000,0.8
Raja Natwarlal,8/29/2014,5,4,-1,0.8
The Return,11/10/2006,15000000,11992014,-3007986,0.7994676
The Pirate,6/11/1948,3700000,2956000,-744000,0.798918918918919
Banlieue 13,11/9/2004,12000000,9584131,-2415869,0.7986775833333334
The Right Stuff,10/20/1983,27000000,21500000,-5500000,0.7962962962962963
Scott Pilgrim vs. the World,7/27/2010,60000000,47664559,-12335441,0.7944093166666667
Blindness,5/14/2008,25000000,19844979,-5155021,0.79379916
My Soul to Take,10/8/2010,25000000,19829957,-5170043,0.79319828
Rock of Ages,6/13/2012,75000000,59418613,-15581387,0.7922481733333333
Rent,11/23/2005,40000000,31670620,-8329380,0.7917655
Almost Famous,9/15/2000,60000000,47383689,-12616311,0.78972815
RRRrrrr!!!,1/28/2004,17820000,14054361,-3765639,0.7886846801346802
Masters of the Universe,8/7/1987,22000000,17336370,-4663630,0.7880168181818182
The Glass House,9/14/2001,30000000,23619609,-6380391,0.7873203
Pulse,8/11/2006,38000000,29907685,-8092315,0.7870443421052632
Flipper,5/17/1996,25530000,20080020,-5449980,0.7865264394829612
Fish Tank,5/14/2009,3000000,2357852,-642148,0.7859506666666667
The Guardian,9/28/2006,70000000,55011732,-14988268,0.7858818857142857
A Bronx Tale,9/14/1993,22000000,17287898,-4712102,0.7858135454545454
Dear Zindagi,11/24/2016,4300000,3376375,-923625,0.785203488372093
Hamlet,5/12/2000,2000000,1568749,-431251,0.7843745
Mechenosets,10/12/2006,5000000,3919731,-1080269,0.7839462
Dragonslayer,6/26/1981,18000000,14110013,-3889987,0.7838896111111111
Mindhunters,5/7/2004,27000000,21148829,-5851171,0.7832899629629629
Speed Racer,5/9/2008,120000000,93945766,-26054234,0.7828813833333333
Treasure Planet,11/26/2002,140000000,109578115,-30421885,0.7827008214285714
Dead Calm,4/7/1989,10000000,7825000,-2175000,0.7825
Mandela: Long Walk to Freedom,12/6/2013,35000000,27330000,-7670000,0.7808571428571428
Hearts in Atlantis,9/7/2001,31000000,24185781,-6814219,0.7801864838709678
Year of the Dragon,8/16/1985,24000000,18707466,-5292534,0.77947775
Panic,12/1/2000,1000000,779137,-220863,0.779137
The Life of David Gale,2/21/2003,50000000,38955598,-11044402,0.77911196
만추,9/10/2010,6200000,4820000,-1380000,0.7774193548387097
The Lords of Salem,9/10/2012,1500000,1165882,-334118,0.7772546666666666
People Like Us,6/29/2012,16000000,12434778,-3565222,0.777173625
Flash Gordon,9/1/1980,35000000,27107960,-7892040,0.7745131428571429
The Greatest Story Ever Told,2/15/1965,20000000,15473333,-4526667,0.77366665
Billy Lynn's Long Halftime Walk,11/10/2016,40000000,30930984,-9069016,0.7732746
Dune,12/14/1984,40000000,30925690,-9074310,0.77314225
Добрыня Никитич и Змей Горыныч,3/16/2006,4500000,3468423,-1031577,0.7707606666666666
Dream House,9/30/2011,50000000,38502340,-11497660,0.7700468
Mr. Destiny,10/12/1990,20000000,15379253,-4620747,0.76896265
Babe: Pig in the City,11/25/1998,90000000,69131860,-20868140,0.7681317777777777
Duplicity,3/19/2009,78146652,60000000,-18146652,0.7677872111526928
No Escape,4/29/1994,20000000,15340000,-4660000,0.767
Trailer Park Boys: The Movie,10/6/2006,5000000,3833507,-1166493,0.7667014
Reindeer Games,2/25/2000,42000000,32168970,-9831030,0.7659278571428572
Rhinestone,6/22/1984,28000000,21435321,-6564679,0.7655471785714286
디워,2/8/2007,70000000,53587404,-16412596,0.7655343428571428
Шпион,4/5/2012,6000000,4588176,-1411824,0.764696
Monkey Shines,7/29/1988,7000000,5344577,-1655423,0.763511
Johnny Mnemonic,5/26/1995,25000000,19075720,-5924280,0.7630288
James and the Giant Peach,4/12/1996,38000000,28921264,-9078736,0.7610858947368421
While We're Young,4/3/2015,10000000,7587485,-2412515,0.7587485
The Internship,6/7/2013,58000000,44000000,-14000000,0.7586206896551724
Ronin,9/25/1998,55000000,41610884,-13389116,0.7565615272727273
The Art of War,8/23/2000,40000000,30199105,-9800895,0.754977625
Батальонъ,2/20/2015,10000000,7547762,-2452238,0.7547762
Prêt-à-Porter,12/23/1994,15000000,11300653,-3699347,0.7533768666666667
Smashed,9/12/2012,500000,376597,-123403,0.753194
Faithful,4/3/1996,13000000,9789900,-3210100,0.7530692307692308
Cry-Baby,4/5/1990,11000000,8266343,-2733657,0.7514857272727272
William & Kate,4/18/2011,20,15,-5,0.75
Keeping Up with the Joneses,10/20/2016,40000000,29918745,-10081255,0.747968625
The Neverending Story,4/5/1984,27000000,20158808,-6841192,0.7466225185185185
Riding in Cars with Boys,10/19/2001,48000000,35743308,-12256692,0.74465225
Head Over Heels,2/2/2001,14000000,10424470,-3575530,0.744605
Maximum Overdrive,7/25/1986,10000000,7433663,-2566337,0.7433663
Doomsday,3/14/2008,30000000,22211426,-7788574,0.7403808666666667
The Deep End of the Ocean,3/12/1999,38000000,28121100,-9878900,0.7400289473684211
Superhero Movie,3/27/2008,35000000,25871834,-9128166,0.7391952571428572
The Diary of a Teenage Girl,8/7/2015,2000000,1477002,-522998,0.738501
L'Auberge espagnole,5/17/2002,5300000,3897799,-1402201,0.7354337735849057
Simply Irresistible,2/5/1999,6000000,4398989,-1601011,0.7331648333333334
Flags of Our Fathers,10/18/2006,90000000,65900249,-24099751,0.7322249888888889
Bones,10/24/2001,10000000,7316658,-2683342,0.7316658
The Jacket,3/4/2005,29000000,21126225,-7873775,0.7284905172413794
The Boat That Rocked,4/1/2009,50000000,36348784,-13651216,0.72697568
Black Snake Moan,12/8/2006,15000000,10903846,-4096154,0.7269230666666666
Seeking Justice,9/2/2011,17000000,12355798,-4644202,0.7268116470588235
Mr. 3000,6/15/2004,30000000,21800302,-8199698,0.7266767333333334
Shorts,8/21/2009,40000000,28972508,-11027492,0.7243127
The Bachelor,11/5/1999,51000000,36911617,-14088383,0.7237571960784314
Domestic Disturbance,10/30/2001,75000000,54249294,-20750706,0.72332392
North Country,2/12/2005,35000000,25224242,-9775758,0.7206926285714286
Mutiny on the Bounty,11/8/1962,19000000,13680000,-5320000,0.72
Bastille Day,4/22/2016,20000000,14397593,-5602407,0.71987965
The Loft,10/14/2014,14000000,10076790,-3923210,0.7197707142857143
Grimsby,2/24/2016,35000000,25182929,-9817071,0.7195122571428572
Rescue Dawn,9/9/2006,10000000,7177143,-2822857,0.7177143
Reign of Fire,7/12/2002,60000000,43061982,-16938018,0.7176997
Midnight in the Garden of Good and Evil,11/21/1997,35000000,25105255,-9894745,0.717293
Sukiyaki Western Django,9/15/2007,3800000,2725258,-1074742,0.7171731578947368
One-Eyed Jacks,3/30/1961,6000000,4300000,-1700000,0.7166666666666667
The Flintstones in Viva Rock Vegas,4/28/2000,83000000,59468275,-23531725,0.7164852409638555
No End in Sight,7/27/2007,2000000,1431623,-568377,0.7158115
Tutta la vita davanti,3/28/2008,5940000,4250000,-1690000,0.7154882154882155
Hot to Trot,8/26/1988,9000000,6436211,-2563789,0.7151345555555556
Split Second,5/1/1992,7,5,-2,0.7142857142857143
The New Adventures of Pippi Longstocking,7/6/1988,5000000,3569939,-1430061,0.7139878
Ace in the Hole,6/29/1951,1821052,1300000,-521052,0.7138730799559815
What If,9/7/2013,11000000,7847000,-3153000,0.7133636363636363
Mommy,5/22/2014,4900000,3494070,-1405930,0.7130755102040817
Leatherheads,3/24/2008,58000000,41299492,-16700508,0.7120602068965517
The Silver Chalice,12/20/1954,4500000,3200000,-1300000,0.7111111111111111
Deception,4/24/2008,25000000,17741298,-7258702,0.70965192
Aloha,5/27/2015,37000000,26250020,-10749980,0.70946
The Purple Rose of Cairo,3/1/1985,15000000,10631333,-4368667,0.7087555333333333
Judy Moody and the Not Bummer Summer,6/10/2011,20000000,14166853,-5833147,0.70834265
Anomalisa,12/30/2015,8000000,5659286,-2340714,0.70741075
The Dark Half,4/23/1993,15000000,10611160,-4388840,0.7074106666666666
Sid & Nancy,11/7/1986,4000000,2826523,-1173477,0.70663075
해운대,6/6/2009,16000000,11301649,-4698351,0.7063530625
Last Man Standing,9/20/1996,67000000,47267001,-19732999,0.7054776268656716
The Good Shepherd,12/11/2006,85000000,59908565,-25091435,0.7048066470588236
Albert Nobbs,12/21/2011,8000000,5634828,-2365172,0.7043535
Cirque du Freak: The Vampire's Assistant,10/23/2009,40000000,28169671,-11830329,0.704241775
The Mission,9/29/1986,24500000,17218023,-7281977,0.7027764489795918
The Joneses,9/13/2009,10000000,7022728,-2977272,0.7022728
Before I Go to Sleep,9/3/2014,22000000,15447154,-6552846,0.7021433636363636
Vanity Fair,9/1/2004,23000000,16123851,-6876149,0.701037
Out of the Furnace,12/6/2013,22000000,15400000,-6600000,0.7
Home Fries,11/25/1998,15000000,10443316,-4556684,0.6962210666666667
The Life Aquatic with Steve Zissou,12/10/2004,50000000,34808403,-15191597,0.69616806
Mambo Italiano,6/6/2003,4361898,3031801,-1330097,0.6950646255368649
My Stepmother is an Alien,12/9/1988,20000000,13854000,-6146000,0.6927
Поводир,11/12/2014,722083,499168,-222915,0.6912889515471213
Queen of Katwe,9/23/2016,15000000,10367161,-4632839,0.6911440666666666
Wanderlust,2/23/2012,35000000,24159934,-10840066,0.6902838285714286
The Man Who Knew Too Little,11/14/1997,20000000,13801755,-6198245,0.69008775
The Water Diviner,12/25/2014,22500000,15520023,-6979977,0.6897788
Red Dawn,11/21/2012,65000000,44806783,-20193217,0.6893351230769231
The Amateur,12/11/1981,10000000,6892098,-3107902,0.6892098
Teaching Mrs. Tingle,8/11/1999,13000000,8946237,-4053763,0.6881720769230769
Spanglish,12/17/2004,80000000,55041367,-24958633,0.6880170875
Fled,7/19/1996,25000000,17193231,-7806769,0.68772924
Shoot 'Em Up,7/26/2007,39000000,26820641,-12179359,0.6877087435897435
Land of the Lost,6/5/2009,100000000,68688831,-31311169,0.68688831
Pathfinder,1/11/2007,45000000,30822861,-14177139,0.6849524666666666
Bad Santa 2,11/23/2016,26000000,17782178,-8217822,0.6839299230769231
Barton Fink,8/1/1991,9000000,6153939,-2846061,0.683771
Hollywood Homicide,6/9/2003,75000000,51142659,-23857341,0.68190212
Brainstorm,9/30/1983,15000000,10219460,-4780540,0.6812973333333333
Shaft in Africa,6/14/1973,2142000,1458000,-684000,0.680672268907563
Punch-Drunk Love,10/25/2002,25000000,17000000,-8000000,0.68
Perfect,6/7/1985,19000000,12918858,-6081142,0.6799398947368421
We Don't Live Here Anymore,1/20/2004,3000000,2037545,-962455,0.6791816666666667
Muppets from Space,7/14/1999,24000000,16290976,-7709024,0.6787906666666667
All Is Lost,10/18/2013,9000000,6108720,-2891280,0.6787466666666667
Astro Boy,10/15/2009,65000000,44091067,-20908933,0.6783241076923077
The Way Back,9/3/2010,30000000,20348249,-9651751,0.6782749666666666
Behind the Candelabra,5/26/2013,23000000,15600000,-7400000,0.6782608695652174
Mission to Mars,3/10/2000,90000000,60874615,-29125385,0.6763846111111111
The Musketeer,9/7/2001,40000000,27053815,-12946185,0.676345375
La grande bellezza,5/21/2013,12400000,8371085,-4028915,0.6750875
Windtalkers,6/14/2002,115000000,77628265,-37371735,0.6750283913043478
Alex Cross,10/18/2012,45000000,30353232,-14646768,0.6745162666666666
The Love Guru,6/20/2008,62000000,41819064,-20180936,0.6745010322580646
The Other Side of Heaven,4/12/2001,7000000,4720371,-2279629,0.6743387142857142
Gymkata,5/3/1985,8500000,5730596,-2769404,0.6741877647058824
Oscar,4/26/1991,35000000,23562716,-11437284,0.6732204571428572
Annapolis,1/27/2006,26000000,17496992,-8503008,0.6729612307692308
Nine,12/3/2009,80000000,53825515,-26174485,0.6728189375
Taras Bulba,4/2/2009,25000000,16815892,-8184108,0.67263568
Racing with the Moon,3/23/1984,9000000,6045657,-2954343,0.6717396666666666
We Are Marshall,12/12/2006,65000000,43545364,-21454636,0.6699286769230769
The Insider,10/28/1999,90000000,60289912,-29710088,0.6698879111111111
One Night with the King,10/13/2006,20000000,13391174,-6608826,0.6695587
Double Dragon,11/4/1994,3500000,2341309,-1158691,0.6689454285714286
Wilson,8/1/1944,2995000,2000000,-995000,0.667779632721202
Blow Out,7/24/1981,18000000,12000000,-6000000,0.6666666666666666
A Cure for Wellness,2/15/2017,40000000,26559557,-13440443,0.663988925
Table 19,1/20/2017,5000000,3305592,-1694408,0.6611184
Brideshead Revisited,7/25/2008,20000000,13204291,-6795709,0.66021455
Whatever It Takes,3/31/2000,15000000,9902115,-5097885,0.660141
Whiskey Tango Foxtrot,3/4/2016,35000000,23083334,-11916666,0.6595238285714285
The Alamo,10/23/1960,12000000,7900000,-4100000,0.6583333333333333
The Zookeeper's Wife,3/31/2017,20000000,13162475,-6837525,0.65812375
Around the World in 80 Days,6/16/2004,110000000,72178895,-37821105,0.6561717727272727
Na Igre 2. Novyy Uroven,4/15/2010,3500000,2294357,-1205643,0.6555305714285714
Белый тигр,5/3/2012,11000000,7200000,-3800000,0.6545454545454545
The Whole Ten Yards,4/7/2004,40000000,26155781,-13844219,0.653894525
The Sweet Hereafter,5/14/1997,5000000,3263585,-1736415,0.652717
Tusk,9/19/2014,2800000,1826705,-973295,0.6523946428571429
Na Kryuchke!,2/3/2011,3000000,1957000,-1043000,0.6523333333333333
Wise Guys,4/17/1986,13000000,8475466,-4524534,0.651958923076923
The Finest Hours,1/25/2016,80000000,52099090,-27900910,0.651238625
Native Son,12/24/1986,2000000,1301121,-698879,0.6505605
The Spirit,12/25/2008,60000000,39031337,-20968663,0.6505222833333333
La Folle histoire de Max et Léon,11/1/2016,12156348,7900000,-4256348,0.6498662262712452
Detroit Rock City,8/13/1999,6500000,4217115,-2282885,0.6487869230769231
Ernest et Célestine,12/12/2012,12516654,8109160,-4407494,0.6478696303341133
Rock-A-Doodle,8/2/1991,18000000,11657385,-6342615,0.6476325
Catch and Release,10/20/2006,25000000,16158487,-8841513,0.64633948
Gods and Monsters,1/21/1998,10000000,6451628,-3548372,0.6451628
Green Room,4/15/2016,5000000,3220371,-1779629,0.6440742
Over the Top,2/13/1987,25000000,16057580,-8942420,0.6423032
Sunshine,4/5/2007,50000000,32017803,-17982197,0.64035606
How to Lose Friends & Alienate People,10/2/2008,27000000,17286299,-9713701,0.6402332962962963
The Replacement Killers,2/6/1998,30000000,19204929,-10795071,0.6401643
Sunday,8/27/1997,450,288,-162,0.64
The River,12/1/1984,18000000,11500000,-6500000,0.6388888888888888
Solaris,11/27/2002,47000000,30002758,-16997242,0.6383565531914893
Blue in the Face,9/15/1995,2000000,1275000,-725000,0.6375
Empire of the Sun,12/9/1987,35000000,22238696,-12761304,0.6353913142857143
Fire and Ice,3/25/1983,1200000,760883,-439117,0.6340691666666667
Highlander: Endgame,9/1/2000,25000000,15843608,-9156392,0.63374432
Barfi!,9/14/2012,4437508,2804874,-1632634,0.6320831421599691
Triple 9,2/19/2016,20000000,12639297,-7360703,0.63196485
Never Let Me Go,9/15/2010,15000000,9455232,-5544768,0.6303488
Tanu Weds Manu,3/25/2011,400000,252000,-148000,0.63
Little Black Book,8/6/2004,35000000,22034832,-12965168,0.6295666285714285
Une Femme est une femme,9/6/1961,160000,100655,-59345,0.62909375
Pa Negre,10/10/2010,6000000,3770657,-2229343,0.6284428333333333
Flypaper,8/19/2011,5000000,3142154,-1857846,0.6284308
Leviathan,3/17/1989,25000000,15704614,-9295386,0.62818456
Original Gangstas,5/10/1996,4800000,3014000,-1786000,0.6279166666666667
Max Steel,10/14/2016,10000000,6272403,-3727597,0.6272403
Pandorum,9/8/2009,33000000,20645327,-12354673,0.6256159696969696
Wolfen,7/24/1981,17000000,10626725,-6373275,0.6251014705882353
The Weather Man,10/20/2005,20000000,12482775,-7517225,0.62413875
Fiza,9/8/2000,1000000,623791,-376209,0.623791
The Big Wedding,4/25/2013,35000000,21819348,-13180652,0.6234099428571429
Practical Magic,10/16/1998,75000000,46683377,-28316623,0.6224450266666667
The Hunted,3/11/2003,55000000,34234008,-20765992,0.6224365090909091
Zvezda,5/6/2002,1300000,809000,-491000,0.6223076923076923
Final Fantasy: The Spirits Within,7/2/2001,137000000,85131830,-51868170,0.6214002189781022
An Unfinished Life,9/9/2005,30000000,18618284,-11381716,0.6206094666666667
Legend,7/19/1985,25000000,15502112,-9497888,0.62008448
Undisputed,8/23/2002,20000000,12398628,-7601372,0.6199314
Take Shelter,11/25/2011,5000000,3099314,-1900686,0.6198628
The Conspirator,9/10/2010,25000000,15478800,-9521200,0.619152
Psycho,12/4/1998,60000000,37141130,-22858870,0.6190188333333333
Dead Ringers,9/23/1988,13000000,8038508,-4961492,0.6183467692307693
Big Miracle,2/2/2012,40000000,24719215,-15280785,0.617980375
The Infiltrator,7/13/2016,25000000,15436808,-9563192,0.61747232
Woo,5/8/1998,13000000,8026971,-4973029,0.6174593076923077
The Greatest Game Ever Played,9/30/2005,25000000,15431177,-9568823,0.61724708
Junior,11/22/1994,60000000,37000000,-23000000,0.6166666666666667
The Little Vampire,10/27/2000,22000000,13555988,-8444012,0.6161812727272727
Out Cold,11/21/2001,24000000,14782676,-9217324,0.6159448333333334
Dark Blue,12/14/2002,15000000,9237470,-5762530,0.6158313333333333
I Still Know What You Did Last Summer,11/13/1998,65000000,40002112,-24997888,0.6154171076923077
Stuck on You,12/10/2003,55000000,33828318,-21171682,0.6150603272727273
Krull,7/29/1983,27000000,16519460,-10480540,0.6118318518518518
MacGruber,5/21/2010,10000000,6110000,-3890000,0.611
The Keep,12/16/1983,6000000,3661757,-2338243,0.6102928333333333
Heavenly Creatures,9/2/1994,5000000,3049135,-1950865,0.609827
Voditel dlya Very,7/27/2004,3300000,2011837,-1288163,0.6096475757575758
Tenacious D in The Pick of Destiny,11/22/2006,22000000,13405595,-8594405,0.6093452272727272
Renaissance Man,6/3/1994,40000000,24332324,-15667676,0.6083081
Suite Française,11/5/2014,15000000,9104716,-5895284,0.6069810666666666
You Kill Me,2/9/2007,4000000,2426851,-1573149,0.60671275
Antitrust,1/12/2001,30000000,18195610,-11804390,0.6065203333333333
Sin City: A Dame to Kill For,8/20/2014,65000000,39407616,-25592384,0.6062710153846154
The Corruptor,3/12/1999,25000000,15156200,-9843800,0.606248
Assassins,10/6/1995,50000000,30303072,-19696928,0.60606144
Someone to Watch Over Me,10/9/1987,17000000,10278549,-6721451,0.6046205294117647
Michael Collins,10/25/1996,28000000,16900000,-11100000,0.6035714285714285
Off Limits,3/11/1988,12000000,7242035,-4757965,0.6035029166666667
Serial Mom,4/13/1994,13000000,7820688,-5179312,0.6015913846153846
A Most Violent Year,12/30/2014,20000000,12007070,-7992930,0.6003535
Myra Breckinridge,6/24/1970,5000000,3000000,-2000000,0.6
Stormbreaker,7/21/2006,40000000,23937870,-16062130,0.59844675
Obitaemyy Ostrov,12/18/2008,36500000,21834845,-14665155,0.5982149315068493
Devil in a Blue Dress,9/15/1995,27000000,16140822,-10859178,0.5978082222222222
Atrapa la bandera,8/28/2015,14000000,8306690,-5693310,0.593335
The Girlfriend Experience,1/20/2009,1700000,1007962,-692038,0.5929188235294117
Joe,4/11/2014,4000000,2365467,-1634533,0.59136675
Glukhar v kino,5/6/2010,2500000,1477030,-1022970,0.590812
Money Train,11/21/1995,60000000,35431113,-24568887,0.59051855
The Secret of Moonacre,9/6/2008,12000000,7070330,-4929670,0.5891941666666667
The Unbearable Lightness of Being,2/5/1988,17000000,10006806,-6993194,0.5886356470588235
Club Dread,2/27/2004,8500000,5001655,-3498345,0.58843
55 Days at Peking,5/6/1963,17000000,10000000,-7000000,0.5882352941176471
Into the Night,2/15/1985,11400000,6700000,-4700000,0.5877192982456141
Le Mépris,10/21/1963,900000,528428,-371572,0.5871422222222222
Banlieue 13 - Ultimatum,2/18/2009,15000000,8786375,-6213625,0.5857583333333334
Pride and Prejudice and Zombies,2/4/2016,28000000,16374328,-11625672,0.5847974285714286
The Rocker,8/20/2008,15000000,8762890,-6237110,0.5841926666666667
The Raid 2: Berandal,3/27/2014,4500000,2627209,-1872791,0.5838242222222222
Serving Sara,8/20/2002,29000000,16930185,-12069815,0.5837994827586207
Getaway,8/29/2013,18000000,10501938,-7498062,0.583441
Driven,4/27/2001,94000000,54744738,-39255262,0.582390829787234
Metro,1/16/1997,55000000,31987563,-23012437,0.5815920545454546
Veronica Mars,3/13/2014,6000000,3485127,-2514873,0.5808545
Edge of Seventeen,5/14/1998,1500000,870751,-629249,0.5805006666666667
For the Boys,11/22/1991,40000000,23202444,-16797556,0.5800611
Down with Love,5/8/2003,35000000,20298207,-14701793,0.5799487714285714
The Quick and the Dead,2/9/1995,32000000,18552460,-13447540,0.579764375
So I Married an Axe Murderer,7/30/1993,20000000,11585483,-8414517,0.57927415
Summer Catch,8/22/2001,34000000,19693891,-14306109,0.5792320882352942
The Man Who Loved Women,12/18/1983,19000000,11000000,-8000000,0.5789473684210527
Drive Angry,2/24/2011,50000000,28931401,-21068599,0.57862802
Man on the Moon,12/22/1999,82000000,47434430,-34565570,0.5784686585365854
Fear and Loathing in Las Vegas,5/22/1998,18500000,10680275,-7819725,0.5773121621621622
Dahmer,6/21/2002,250000,144008,-105992,0.576032
Night on Earth,10/3/1991,3500000,2015810,-1484190,0.5759457142857143
Repo Men,3/18/2010,32000000,18409891,-13590109,0.57530909375
Manhunter,8/14/1986,15000000,8620929,-6379071,0.5747286
Lord of War,9/16/2005,42000000,24127895,-17872105,0.5744736904761905
Strangeland,10/2/1998,1100000,631221,-468779,0.5738372727272727
Gåten Ragnarok,11/11/2013,6500000,3721345,-2778655,0.5725146153846153
A Countess from Hong Kong,1/5/1967,3500000,2000000,-1500000,0.5714285714285714
キャプテンハーロック,9/7/2013,30000000,17137302,-12862698,0.5712434
The Ladies Man,10/13/2000,24000000,13700000,-10300000,0.5708333333333333
Little Children,10/6/2006,26000000,14821658,-11178342,0.5700637692307692
Stealth,7/28/2005,135000000,76932943,-58067057,0.5698736518518519
Jennifer Eight,11/6/1992,20000000,11390479,-8609521,0.56952395
Il cartaio,1/2/2004,2600000,1479042,-1120958,0.5688623076923077
Centurion,2/15/2010,12000000,6814789,-5185211,0.5678990833333334
Connie and Carla,4/16/2004,20000000,11341016,-8658984,0.5670508
My Favorite Martian,2/11/1999,65000000,36850101,-28149899,0.5669246307692307
The Apparition,8/23/2012,17000000,9627492,-7372508,0.5663230588235294
Men with Brooms,9/20/2002,7500000,4245870,-3254130,0.566116
The Relic,1/10/1997,60000000,33956608,-26043392,0.5659434666666666
Disaster Movie,8/29/2008,25000000,14109284,-10890716,0.56437136
88 Minutes,2/14/2007,30000000,16930884,-13069116,0.5643628
Chloe,3/25/2009,15000000,8459458,-6540542,0.5639638666666666
The People vs. Larry Flynt,10/12/1996,36000000,20300385,-15699615,0.5638995833333333
Lady in the Water,7/21/2006,75000000,42285169,-32714831,0.5638022533333333
Le peuple migrateur,12/12/2001,35866397,20217080,-15649317,0.5636774722590618
Roommates,3/1/1995,22000000,12400000,-9600000,0.5636363636363636
Running with Scissors,10/27/2006,12000000,6754898,-5245102,0.5629081666666667
The Arrival,5/31/1996,25000000,14048372,-10951628,0.56193488
City By The Sea,9/6/2002,40000000,22433915,-17566085,0.560847875
Angel Eyes,5/15/2001,53000000,29700000,-23300000,0.560377358490566
Peeping Tom,4/6/1960,150000,83957,-66043,0.5597133333333333
Band of the Hand,4/11/1986,8700000,4865912,-3834088,0.5593002298850575
Running Scared,1/6/2006,17000000,9500000,-7500000,0.5588235294117647
Nothing Left to Fear,9/26/2013,3000000,1675381,-1324619,0.5584603333333333
Streets of Fire,6/1/1984,14500000,8089290,-6410710,0.5578820689655173
Agora,5/17/2009,70000000,39041505,-30958495,0.5577357857142857
Marvin's Room,12/18/1996,23000000,12803305,-10196695,0.5566654347826087
Valiant,3/25/2005,35000000,19478106,-15521894,0.5565173142857143
Inherent Vice,12/25/2014,20000000,11110975,-8889025,0.55554875
Basic Instinct 2,3/29/2006,70000000,38629478,-31370522,0.5518496857142857
Cursed,2/25/2005,35000000,19294901,-15705099,0.5512828857142857
A Thousand Words,3/7/2012,40000000,22044277,-17955723,0.551106925
Music of the Heart,10/29/1999,27000000,14859394,-12140606,0.550347925925926
Timeline,11/26/2003,80000000,43935763,-36064237,0.5491970375
Trumbo,10/27/2015,15000000,8235661,-6764339,0.5490440666666667
Paradise,9/18/1991,34000000,18634643,-15365357,0.5480777352941176
Species II,4/10/1998,35000000,19165560,-15834440,0.5475874285714286
Only the Strong,8/27/1993,6000000,3283371,-2716629,0.5472285
Sorcerer,6/24/1977,22000000,12000000,-10000000,0.5454545454545454
Predestination,8/28/2014,5500000,3000000,-2500000,0.5454545454545454
City of Joy,4/15/1992,27000000,14683921,-12316079,0.5438489259259259
Promised Land,9/23/2012,15000000,8138788,-6861212,0.5425858666666666
Conan the Barbarian,8/17/2011,90000000,48795021,-41204979,0.5421669
SpaceCamp,6/6/1986,18000000,9697739,-8302261,0.5387632777777778
Conviction,9/11/2010,12500000,6732980,-5767020,0.5386384
Lords of Dogtown,6/3/2005,25000000,13411957,-11588043,0.53647828
Deconstructing Harry,8/26/1997,20000000,10686841,-9313159,0.53434205
The Rum Diary,10/13/2011,45000000,24000000,-21000000,0.5333333333333333
Forever Fever,5/28/1998,1070000,570000,-500000,0.5327102803738317
The Big Kahuna,4/28/2000,7000000,3728888,-3271112,0.5326982857142857
Geronimo: An American Legend,12/10/1993,35000000,18635620,-16364380,0.5324462857142858
Igby Goes Down,9/13/2002,9000000,4777465,-4222535,0.5308294444444445
Funny Games,10/20/2007,15000000,7938872,-7061128,0.5292581333333334
The Soloist,4/24/2009,60000000,31720158,-28279842,0.5286693
The Red Violin,9/10/1998,18000000,9495408,-8504592,0.5275226666666667
The Two Jakes,8/10/1990,19000000,10000000,-9000000,0.5263157894736842
Black and White,9/4/1999,10000000,5241315,-4758685,0.5241315
Blood Work,8/4/2002,50000000,26199517,-23800483,0.52399034
Your Highness,4/8/2011,49900000,26121638,-23778362,0.5234797194388777
Walk Hard: The Dewey Cox Story,12/21/2007,35000000,18317151,-16682849,0.5233471714285715
Shattered,10/11/1991,22000000,11511031,-10488969,0.5232286818181818
Quills,11/22/2000,13500000,7060876,-6439124,0.5230278518518519
Everything Must Go,10/15/2010,5000000,2614773,-2385227,0.5229546
Clockers,9/15/1995,25000000,13071518,-11928482,0.52286072
Bright Star,11/5/2009,8500000,4440055,-4059945,0.5223594117647059
Alone in the Dark,1/28/2005,20000000,10442808,-9557192,0.5221404
The Cat's Meow,8/3/2001,7000000,3646994,-3353006,0.5209991428571429
Angela's Ashes,12/25/1999,25,13,-12,0.52
Brokedown Palace,8/13/1999,25000000,13000000,-12000000,0.52
31,9/15/2016,1500000,779820,-720180,0.51988
Highlander II: The Quickening,1/30/1991,30000000,15556340,-14443660,0.5185446666666667
La vida precoz y breve de Sabina Rivas,11/9/2012,4620000,2395000,-2225000,0.5183982683982684
The Majestic,12/21/2001,72000000,37317558,-34682442,0.5182994166666667
Code Name: The Cleaner,1/5/2007,20000000,10337477,-9662523,0.51687385
The House of Mirth,9/23/2000,10000000,5164404,-4835596,0.5164404
Silence,12/22/2016,46000000,23737523,-22262477,0.5160331086956522
Monster Trucks,12/21/2016,125000000,64493915,-60506085,0.51595132
Ready to Rumble,4/7/2000,24000000,12372410,-11627590,0.5155170833333333
Winter's Tale,2/13/2014,60000000,30800231,-29199769,0.5133371833333333
Anonymous,10/21/2011,30000000,15395087,-14604913,0.5131695666666667
Damnation Alley,9/10/1977,17000000,8720000,-8280000,0.5129411764705882
Alex & Emma,6/16/2003,30000000,15368897,-14631103,0.5122965666666667
Not of This Earth,5/20/1988,210000,107352,-102648,0.5112
Anthropoid,8/12/2016,9000000,4600000,-4400000,0.5111111111111111
Labyrinth,6/27/1986,25000000,12729917,-12270083,0.50919668
The Neverending Story II: The Next Chapter,10/24/1990,32000000,16283667,-15716333,0.50886459375
Mortdecai,1/21/2015,60000000,30418560,-29581440,0.506976
The Pagemaster,11/23/1994,27000000,13670688,-13329312,0.5063217777777778
Once Upon a Forest,6/18/1993,13000000,6582052,-6417948,0.5063116923076924
Foxcatcher,5/19/2014,24000000,12096300,-11903700,0.5040125
Twisted,2/27/2004,50000000,25195000,-24805000,0.5039
Blues Brothers 2000,2/5/1998,28000000,14051384,-13948616,0.5018351428571428
Free State of Jones,6/24/2016,50000000,25035950,-24964050,0.500719
Ghosts of Mars,8/24/2001,28000000,14010832,-13989168,0.5003868571428571
The Cave,8/25/2005,30000000,15007991,-14992009,0.5002663666666667
Sabotage,3/28/2014,35000000,17508518,-17491482,0.5002433714285714
The Super,10/4/1991,22000000,11000863,-10999137,0.5000392272727273
Doctor Dolittle,12/19/1967,18000000,9000000,-9000000,0.5
The 51st State,12/7/2001,28,14,-14,0.5
Mute Witness,9/28/1995,2,1,-1,0.5
Thunderbirds,7/23/2004,57000000,28283637,-28716363,0.4962041578947368
L'Empire des loups,4/20/2005,24000000,11875866,-12124134,0.49482775
Burn,11/1/2012,225000,111300,-113700,0.49466666666666664
Wonderland,10/23/2003,5000000,2466444,-2533556,0.4932888
The Legend of Bagger Vance,11/2/2000,80000000,39459427,-40540573,0.4932428375
Color of Night,8/19/1994,40000000,19726050,-20273950,0.49315125
The Space Between Us,1/26/2017,30000000,14793385,-15206615,0.49311283333333333
Punisher: War Zone,12/5/2008,20500000,10089373,-10410627,0.49216453658536585
Vượt Sóng,2/22/2006,1300000,639000,-661000,0.49153846153846154
Shattered Glass,11/14/2003,6000000,2944752,-3055248,0.490792
The Assassination of Jesse James by the Coward Robert Ford,9/2/2007,30000000,14711793,-15288207,0.4903931
Kill the Messenger,10/9/2014,5000000,2450846,-2549154,0.4901692
Titan A.E.,6/16/2000,75000000,36754634,-38245366,0.49006178666666667
Bee Season,9/3/2005,14000000,6856989,-7143011,0.4897849285714286
Extraordinary Measures,1/21/2010,31000000,15134293,-15865707,0.488203
Battlefield Earth,5/10/2000,44000000,21400000,-22600000,0.4863636363636364
RoboCop 3,4/17/1993,22000000,10696210,-11303790,0.4861913636363636
PCU,4/29/1994,9000000,4350774,-4649226,0.4834193333333333
The Wackness,7/3/2008,6000000,2899975,-3100025,0.48332916666666664
Night Of The Living Dead 3D,5/6/2007,3000000,1449945,-1550055,0.483315
Duplex,9/26/2003,40000000,19322135,-20677865,0.483053375
Winnie the Pooh,4/13/2011,30000000,14460000,-15540000,0.482
Suspect Zero,8/27/2004,27000000,13000000,-14000000,0.48148148148148145
Amelia,10/22/2009,40000000,19258519,-20741481,0.481462975
Femme Fatale,11/6/2002,35000000,16838910,-18161090,0.4811117142857143
The King and I,3/19/1999,25000000,12000000,-13000000,0.48
I Spy,10/31/2002,70000000,33561137,-36438863,0.4794448142857143
The Marrying Man,4/5/1991,26000000,12454768,-13545232,0.47902953846153845
El hombre de las mil caras,9/23/2016,5000000,2387127,-2612873,0.4774254
Moonlight Mile,9/9/2002,21000000,10011050,-10988950,0.4767166666666667
It's a Boy Girl Thing,12/26/2006,15500000,7385434,-8114566,0.4764796129032258
Дуэлянт,9/29/2016,12823507,6101904,-6721603,0.4758373820827641
The Lair of the White Worm,9/14/1988,2500000,1189315,-1310685,0.475726
The Ballad of Jack and Rose,3/25/2005,1500000,712294,-787706,0.47486266666666666
Intersection,1/21/1994,45000000,21355893,-23644107,0.4745754
Santa Claus: The Movie,10/29/1985,50000000,23717291,-26282709,0.47434582
R.I.P.D.,7/18/2013,130000000,61648500,-68351500,0.4742192307692308
Most Wanted,10/10/1997,25000000,11838218,-13161782,0.47352872
The Guest,9/17/2014,5000000,2367161,-2632839,0.4734322
Class of 1999,5/11/1990,5200000,2459895,-2740105,0.47305673076923077
FearDotCom,8/9/2002,40000000,18902015,-21097985,0.472550375
Nadine,8/7/1987,12000000,5669831,-6330169,0.47248591666666667
This Must Be the Place,10/1/2011,25000000,11790979,-13209021,0.47163916
King Kong Lives,11/21/1986,10000000,4711220,-5288780,0.471122
The Hoax,10/14/2006,25000000,11772461,-13227539,0.47089844
The End of the Affair,12/3/1999,23000000,10827816,-12172184,0.4707746086956522
Cool World,7/10/1992,30000000,14110589,-15889411,0.47035296666666665
The Wild,3/6/2006,80000000,37384046,-42615954,0.467300575
Criminal,4/14/2016,31500000,14708696,-16791304,0.46694273015873017
Flight of the Phoenix,12/17/2004,45000000,21009180,-23990820,0.46687066666666666
Jem and the Holograms,10/22/2015,5000000,2333684,-2666316,0.4667368
Welcome to Mooseport,2/24/2004,30000000,14000000,-16000000,0.4666666666666667
Blue Car,1/11/2002,1000000,464000,-536000,0.464
The Adventures of Rocky & Bullwinkle,6/30/2000,76000000,35134820,-40865180,0.46230026315789474
For Your Consideration,11/22/2006,12000000,5542025,-6457975,0.46183541666666666
Hart's War,2/15/2002,70000000,32287044,-37712956,0.4612434857142857
Heist,11/13/2015,8900000,4100000,-4800000,0.4606741573033708
A Cry in the Dark,11/11/1988,15000000,6908797,-8091203,0.4605864666666667
La Princesse de Montpensier,11/3/2010,14734000,6775121,-7958879,0.4598290348852993
Balada triste de trompeta,12/17/2010,7000000,3218666,-3781334,0.4598094285714286
Domino,9/22/2005,50000000,22944502,-27055498,0.45889004
Slackers,2/1/2002,14000000,6413915,-7586085,0.45813678571428573
Extreme Measures,9/27/1996,38000000,17380126,-20619874,0.45737173684210525
The Lost City,9/3/2005,9600000,4386236,-5213764,0.45689958333333336
Valerian and the City of a Thousand Planets,7/20/2017,197471676,90024292,-107447384,0.4558845796194083
Showgirls,9/22/1995,45000000,20350754,-24649246,0.4522389777777778
The Chamber,10/11/1996,50000000,22540359,-27459641,0.45080718
Hoodwinked Too! Hood VS. Evil,4/29/2011,30000000,13521829,-16478171,0.4507276333333333
Delicatessen,4/17/1991,4000000,1794187,-2205813,0.44854675
Stop-Loss,3/28/2008,25000000,11207130,-13792870,0.4482852
Losing Isaiah,3/17/1995,17000000,7603766,-9396234,0.44728035294117646
The Cotton Club,12/14/1984,58000000,25928721,-32071279,0.44704691379310346
Mighty Aphrodite,9/13/1995,15000000,6700000,-8300000,0.44666666666666666
The Ice Storm,9/27/1997,18000000,8038061,-9961939,0.44655894444444444
The Work and the Glory,11/24/2004,7500000,3347647,-4152353,0.4463529333333333
Return to Oz,6/21/1985,25000000,11137801,-13862199,0.44551204
Jagal,8/31/2012,1000000,444575,-555425,0.444575
Event Horizon,8/15/1997,60000000,26673242,-33326758,0.4445540333333333
La piel que habito,8/17/2011,13000000,5774854,-7225146,0.44421953846153844
Metallica: Through the Never,9/25/2013,18000000,7972967,-10027033,0.4429426111111111
On the Job,5/23/2013,1052753,466088,-586665,0.4427325308025719
Body of Evidence,1/15/1993,30000000,13273595,-16726405,0.4424531666666667
Ratchet & Clank,4/13/2016,20000000,8821329,-11178671,0.44106645
Austenland,8/15/2013,4900000,2159041,-2740959,0.44062061224489796
Whisper,11/27/2007,12000000,5285197,-6714803,0.4404330833333333
Boy Culture,1/31/2007,500000,220151,-279849,0.440302
Big Trouble in Little China,5/30/1986,25000000,11000000,-14000000,0.44
Sinbad: Legend of the Seven Seas,7/2/2003,60000000,26288320,-33711680,0.4381386666666667
Rosewood,2/21/1997,30000000,13130349,-16869651,0.4376783
Mystery Men,8/6/1999,68000000,29762011,-38237989,0.4376766323529412
Hard Contract,4/30/1969,4000000,1750000,-2250000,0.4375
The Fountain,9/6/2006,35000000,15304890,-19695110,0.4372825714285714
Super Mario Bros.,5/28/1993,48000000,20915465,-27084535,0.4357388541666667
Burke & Hare,10/29/2010,10000000,4349187,-5650813,0.4349187
The Blob,8/5/1988,19000000,8247943,-10752057,0.43410226315789474
Dungeons & Dragons,12/8/2000,35000000,15185241,-19814759,0.4338640285714286
Wicker Park,9/3/2004,30000000,13001257,-16998743,0.43337523333333333
Flushed Away,10/22/2006,149000000,64459316,-84540684,0.4326128590604027
Алеша Попович и Тугарин Змей,12/23/2004,4000000,1730000,-2270000,0.4325
Thirteen Days,12/24/2000,80000000,34566746,-45433254,0.432084325
Wild Target,6/17/2010,8000000,3453043,-4546957,0.431630375
Stone,10/7/2010,22000000,9479718,-12520282,0.4308962727272727
Paterson,11/17/2016,5000000,2152738,-2847262,0.4305476
American Dreamz,3/4/2006,17000000,7314027,-9685973,0.43023688235294116
Stay Tuned,8/14/1992,25000000,10736401,-14263599,0.42945604
Boat Trip,10/1/2002,20000000,8586376,-11413624,0.4293188
Les Invasions barbares,5/21/2003,8000000,3432342,-4567658,0.42904275
Abandon,10/14/2002,25000000,10719357,-14280643,0.42877428
Le Hussard sur le toit,9/20/1995,35000000,15000000,-20000000,0.42857142857142855
Post Grad,8/21/2009,15000000,6405245,-8594755,0.42701633333333333
Dans les forêts de Sibérie,6/15/2016,3500000,1492523,-2007477,0.42643514285714285
The Mother,1/1/2003,2500000,1062253,-1437747,0.4249012
Micmacs à tire-larigot,10/28/2009,33000000,14000000,-19000000,0.42424242424242425
The Quiet,9/12/2005,900000,381420,-518580,0.4238
The Bad Lieutenant: Port of Call - New Orleans,9/11/2009,25000000,10589102,-14410898,0.42356408
The Book of Henry,6/16/2017,10000000,4219536,-5780464,0.4219536
Life or Something Like It,4/26/2002,40000000,16872671,-23127329,0.421816775
Spartan,3/12/2004,19250000,8112712,-11137288,0.42143958441558443
Higher Ground,8/26/2011,2000000,841733,-1158267,0.4208665
Matewan,8/28/1987,4000000,1680358,-2319642,0.4200895
Death Defying Acts,9/13/2007,20000000,8380329,-11619671,0.41901645
Red Planet,11/10/2000,80000000,33463969,-46536031,0.4182996125
It Came from Hollywood,12/10/1982,5000000,2091037,-2908963,0.4182074
Hummingbird,5/7/2013,20000000,8352885,-11647115,0.41764425
The House of Yes,10/10/1997,1500000,626057,-873943,0.4173713333333333
Pennies from Heaven,12/11/1981,22000000,9171289,-12828711,0.41687677272727275
The Adventures of Ford Fairlane,7/11/1990,49000000,20423389,-28576611,0.41680385714285717
Twin Peaks: Fire Walk with Me,6/3/1992,10000000,4160851,-5839149,0.4160851
Straw Dogs,9/16/2011,25000000,10324441,-14675559,0.41297764
The Tie That Binds,9/8/1995,14000000,5780000,-8220000,0.41285714285714287
Unfinished Business,3/5/2015,35000000,14431253,-20568747,0.4123215142857143
Girl 6,3/22/1996,12000000,4939939,-7060061,0.41166158333333336
From Justin to Kelly,6/20/2003,12000000,4922166,-7077834,0.4101805
Alone in the Dark,11/12/1982,20000000,8178569,-11821431,0.40892845
Supergirl,11/19/1984,35000000,14296438,-20703562,0.40846965714285716
Curse of the Pink Panther,8/12/1983,11000000,4491986,-6508014,0.40836236363636363
Pinocchio and the Emperor of the Night,8/6/1987,8000000,3261638,-4738362,0.40770475
Denial,9/30/2016,10000000,4073489,-5926511,0.4073489
Chéri,2/10/2009,23000000,9366227,-13633773,0.40722726086956523
Invaders from Mars,1/1/1986,12000000,4884663,-7115337,0.40705525
The Visual Bible: The Gospel of John,9/11/2003,10000000,4069090,-5930910,0.406909
Thumbelina,3/30/1994,28000000,11373501,-16626499,0.40619646428571426
This Is Elvis,4/4/1981,5000000,2028612,-2971388,0.4057224
How Do You Know,12/17/2010,120000000,48668907,-71331093,0.405574225
Я остаюсь,4/19/2007,1000000,404785,-595215,0.404785
Possession,10/2/2002,25000000,10113733,-14886267,0.40454932
Under the Skin,3/14/2014,13300000,5380251,-7919749,0.40453015037593987
Mrs. Winterbourne,4/19/1996,25000000,10070000,-14930000,0.4028
Black Nativity,11/27/2013,17500000,7018189,-10481811,0.40103937142857143
Bride Flight,10/15/2008,6400000,2556911,-3843089,0.39951734375
I Could Never Be Your Woman,5/11/2007,24000000,9576495,-14423505,0.399020625
Wyatt Earp,6/24/1994,63000000,25052000,-37948000,0.39765079365079364
Nine 1/2 Weeks,2/14/1986,17000000,6735922,-10264078,0.39623070588235293
Zero Effect,1/30/1998,5000000,1980338,-3019662,0.3960676
Transsiberian,1/18/2008,15000000,5926410,-9073590,0.395094
A Girl Walks Home Alone at Night,1/19/2014,1000000,395000,-605000,0.395
Explorers,7/12/1985,25000000,9873044,-15126956,0.39492176
Paranoia,8/14/2013,35000000,13785015,-21214985,0.3938575714285714
Toni Erdmann,7/14/2016,3537415,1390172,-2147243,0.39299092699047183
Earth Girls Are Easy,9/8/1988,10000000,3916303,-6083697,0.3916303
American Outlaws,8/17/2001,35000000,13678913,-21321087,0.39082608571428573
Young Adam,9/26/2003,6400000,2500000,-3900000,0.390625
Clifford,4/1/1994,19000000,7411659,-11588341,0.3900873157894737
Freedomland,2/17/2006,37665000,14655628,-23009372,0.3891046860480552
Red Sonja,4/9/1985,17900000,6948633,-10951367,0.3881917877094972
The Out-of-Towners,4/2/1999,75000000,29000000,-46000000,0.38666666666666666
羅生門,12/26/1950,250000,96568,-153432,0.386272
The 13th Warrior,8/27/1999,160000000,61698899,-98301101,0.38561811875
Everything is Illuminated,9/16/2005,7000000,2697930,-4302070,0.38541857142857144
The Phantom,6/6/1996,45000000,17300889,-27699111,0.3844642
The Last Castle,10/19/2001,72000000,27642707,-44357293,0.38392648611111113
Vivre sa vie: film en douze tableaux,9/20/1962,64000,24517,-39483,0.383078125
Miracle Mile,5/19/1989,3000000,1145404,-1854596,0.3818013333333333
Australia,11/18/2008,130000000,49554002,-80445998,0.38118463076923076
Afflicted,4/4/2014,318000,121179,-196821,0.3810660377358491
Pushing Hands,2/1/1992,400000,152322,-247678,0.380805
Hackers,9/14/1995,20000000,7563728,-12436272,0.3781864
The Last Legion,4/19/2007,67000000,25303038,-41696962,0.37765728358208955
Proof,9/5/2005,20000000,7535331,-12464669,0.37676655
Aquarius,9/1/2016,762241,285930,-476311,0.3751175809225691
Rebound,7/1/2005,45000000,16809014,-28190986,0.3735336444444444
Bordello of Blood,8/16/1996,15000000,5600000,-9400000,0.37333333333333335
Boris - Il film,4/1/2011,3347850,1248748,-2099102,0.37299998506504173
By the Sea,11/12/2015,10000000,3727746,-6272254,0.3727746
Bitter Moon,9/2/1992,5000000,1862805,-3137195,0.372561
Their Finest,4/6/2017,32745300,12173470,-20571830,0.37176235978903843
For Love or Money,10/1/1993,30000000,11146270,-18853730,0.3715423333333333
The East,5/31/2013,6500000,2401510,-4098490,0.36946307692307695
Highlander,3/7/1986,16000000,5900000,-10100000,0.36875
The Immigrant,7/3/2013,16000000,5867686,-10132314,0.366730375
Killer Joe,9/10/2011,10000000,3665069,-6334931,0.3665069
Gossip,4/21/2000,14000000,5108820,-8891180,0.3649157142857143
Take Me Home Tonight,3/4/2011,19000000,6928068,-12071932,0.3646351578947368
Foolish Wives,1/11/1922,1100000,400200,-699800,0.3638181818181818
Miller's Crossing,9/21/1990,14000000,5080409,-8919591,0.36288635714285716
Vampire's Kiss,9/17/1988,2000000,725131,-1274869,0.3625655
Johnny Handsome,9/12/1989,20000000,7237794,-12762206,0.3618897
Shark Night,9/2/2011,28000000,10126458,-17873542,0.3616592142857143
Gold,12/22/2016,20000000,7227038,-12772962,0.3613519
At Close Range,4/18/1986,6500000,2347000,-4153000,0.3610769230769231
Nieve negra,1/19/2017,4000000,1440000,-2560000,0.36
Memoirs of an Invisible Man,2/28/1992,40000000,14358033,-25641967,0.358950825
Zoom,8/11/2006,35000000,12506188,-22493812,0.35731965714285713
Free Fire,3/31/2017,10000000,3565109,-6434891,0.3565109
Videodrome,2/4/1983,5952000,2120439,-3831561,0.35625655241935483
Joe's Apartment,7/26/1996,13000000,4619014,-8380986,0.3553087692307692
Article 99,3/13/1992,18000000,6375979,-11624021,0.35422105555555555
Mallrats,10/20/1995,6000000,2122561,-3877439,0.35376016666666665
Nasty Old People,10/10/2009,15000,5300,-9700,0.35333333333333333
Broken City,1/18/2013,56000000,19701164,-36298836,0.3518065
K-19: The Widowmaker,7/19/2002,100000000,35168966,-64831034,0.35168966
U Turn,10/3/1997,19000000,6682098,-12317902,0.35168936842105264
Play It to the Bone,12/25/1999,24000000,8434146,-15565854,0.35142275
On the Road,5/22/2012,25000000,8784318,-16215682,0.35137272
The Young Messiah,3/10/2016,18500000,6490401,-12009599,0.35083248648648646
The Lone Ranger,7/3/2013,255000000,89289910,-165710090,0.35015650980392155
An American Carol,10/3/2008,20000000,7000000,-13000000,0.35
Космос как предчувствие,6/23/2005,2000000,696681,-1303319,0.3483405
Gattaca,9/7/1997,36000000,12532777,-23467223,0.34813269444444445
The In Crowd,7/19/2000,15000000,5217498,-9782502,0.3478332
Midnight Special,2/18/2016,18000000,6212282,-11787718,0.3451267777777778
The Bounty,5/4/1984,25000000,8613462,-16386538,0.34453848
Ken Park,8/31/2002,1300000,447741,-852259,0.34441615384615387
Гороскоп на удачу,7/16/2015,2800000,964206,-1835794,0.3443592857142857
Kill List,9/2/2011,500000,171760,-328240,0.34352
Disconnect,9/11/2012,10000000,3428048,-6571952,0.3428048
The Gunman,2/16/2015,40000000,13644292,-26355708,0.3411073
Flawless,9/1/2007,20000000,6819587,-13180413,0.34097935
Death Wish 5: The Face of Death,1/14/1994,5000000,1702394,-3297606,0.3404788
Everybody Wants Some!!,3/30/2016,10000000,3400278,-6599722,0.3400278
The Fan,8/15/1996,55000000,18626419,-36373581,0.33866216363636364
Novocaine,11/23/2001,6000000,2025238,-3974762,0.3375396666666667
Cake,9/7/2014,7000000,2360281,-4639719,0.337183
The Lookout,3/9/2007,16000000,5367030,-10632970,0.335439375
Solitary Man,9/7/2009,15000000,5024782,-9975218,0.3349854666666667
The Bonfire of the Vanities,12/21/1990,47000000,15691192,-31308808,0.3338551489361702
Baby's Day Out,7/1/1994,50000000,16671505,-33328495,0.3334301
Playing God,10/17/1997,12000000,4000000,-8000000,0.3333333333333333
Empire State,9/3/2013,11000000,3639345,-7360655,0.3308495454545455
The Iron Giant,8/6/1999,70000000,23159305,-46840695,0.3308472142857143
The Order,9/5/2003,35000000,11560806,-23439194,0.33030874285714285
Very Bad Things,9/11/1998,30000000,9898412,-20101588,0.3299470666666667
Terminal Velocity,9/23/1994,50000000,16478900,-33521100,0.329578
Surviving Christmas,9/21/2004,45000000,14793624,-30206376,0.3287472
Gracie,6/1/2007,9000000,2955039,-6044961,0.3283376666666667
Ed Wood,9/27/1994,18000000,5887457,-12112543,0.32708094444444447
Inside Deep Throat,2/11/2005,2000000,653621,-1346379,0.3268105
The Company Men,10/21/2010,15000000,4882577,-10117423,0.3255051333333333
City of Ember,10/7/2008,55000000,17869048,-37130952,0.3248917818181818
Little Boy,4/23/2015,20000000,6485961,-13514039,0.32429805
Harley Davidson and the Marlboro Man,8/23/1991,23000000,7434726,-15565274,0.32324895652173913
Down Terrace,9/1/2009,31192,10000,-21192,0.32059502436522186
Mio min Mio,7/1/1987,7200000,2300000,-4900000,0.3194444444444444
The Limey,5/15/1999,10000000,3193102,-6806898,0.3193102
Surveillance,2/8/2008,3500000,1115493,-2384507,0.3187122857142857
The Monster Squad,8/14/1987,12000000,3769990,-8230010,0.3141658333333333
Thank You,4/8/2011,13100000,4100000,-9000000,0.31297709923664124
The Work and the Glory II: American Zion,10/21/2005,6500000,2025032,-4474968,0.3115433846153846
Sherrybaby,9/8/2006,2000000,622806,-1377194,0.311403
L'illusionniste,2/16/2010,18000000,5602431,-12397569,0.31124616666666666
Nixon,12/22/1995,44000000,13681765,-30318235,0.31094920454545455
Lieksa!,9/14/2007,1400000,435000,-965000,0.3107142857142857
The Perfect Game,4/1/2010,12500000,3878993,-8621007,0.31031944
Texas Chainsaw Massacre: The Next Generation,1/1/1994,600000,185898,-414102,0.30983
Mr. Saturday Night,9/23/1992,43000000,13300000,-29700000,0.30930232558139537
Atlas Shrugged Part I,4/14/2011,15000000,4627375,-10372625,0.30849166666666666
Delirious,8/9/1991,18000000,5546827,-12453173,0.30815705555555556
The Chase,3/4/1994,26000000,8009329,-17990671,0.3080511153846154
Enemy Mine,12/12/1985,40000000,12303411,-27696589,0.307585275
The Fifth Estate,10/11/2013,28000000,8555008,-19444992,0.305536
Get Carter,10/6/2000,63600000,19412993,-44187007,0.3052357389937107
Whiteout,9/9/2009,40000000,12206028,-27793972,0.3051507
Table For Five,2/18/1983,8000000,2439705,-5560295,0.304963125
3000 Miles to Graceland,2/23/2001,62000000,18720175,-43279825,0.3019383064516129
May,1/13/2002,500000,150277,-349723,0.300554
The Devil's Double,2/11/2011,19100000,5728213,-13371787,0.2999064397905759
Bandidas,1/18/2006,35000000,10496317,-24503683,0.2998947714285714
The Runaways,3/19/2010,10000000,2995811,-7004189,0.2995811
Rock Star,9/4/2001,57000000,16991902,-40008098,0.2981035438596491
A Simple Wish,7/11/1997,28000000,8345056,-19654944,0.2980377142857143
Something Wicked This Way Comes,4/29/1983,19000000,5656087,-13343913,0.2976887894736842
Flyboys,9/22/2006,60000000,17800000,-42200000,0.2966666666666667
Cosmopolis,5/25/2012,20500000,6063556,-14436444,0.2957832195121951
Kaappari,1/17/2013,1800000,532269,-1267731,0.295705
Auto Focus,10/18/2002,7000000,2062066,-4937934,0.29458085714285714
Pawn Sacrifice,9/16/2015,19000000,5578519,-13421481,0.29360626315789473
Screamers,9/8/1995,20000000,5781885,-14218115,0.28909425
Mannequin Two: On the Move,1/7/1991,13000000,3752426,-9247574,0.28864815384615383
The Young and Prodigious T.S. Spivet,10/16/2013,33000000,9494789,-23505211,0.2877208787878788
Sunset,4/29/1988,16000000,4594452,-11405548,0.28715325
I Spit on Your Grave,6/17/2010,2000000,572809,-1427191,0.2864045
The Gun in Betty Lou's Handbag,8/21/1992,13000000,3721911,-9278089,0.28630084615384616
White Girl,9/2/2016,700000,200242,-499758,0.28606
The Lost City of Z,10/15/2016,30000000,8574339,-21425661,0.2858113
One Eight Seven,7/29/1997,20000000,5716080,-14283920,0.285804
Romeo Is Bleeding,9/13/1993,11500000,3275585,-8224415,0.2848334782608696
Ballistic: Ecks vs. Sever,9/20/2002,70000000,19924033,-50075967,0.28462904285714286
Diggstown,8/14/1992,17000000,4836637,-12163363,0.2845080588235294
Showdown in Little Tokyo,8/23/1991,8000000,2275557,-5724443,0.284444625
Hard Rain,1/16/1998,70000000,19870567,-50129433,0.2838652428571429
Антидурь,9/6/2007,5000000,1413000,-3587000,0.2826
The Virginity Hit,9/10/2010,2000000,563706,-1436294,0.281853
Barney's Version,10/26/2010,30000000,8454301,-21545699,0.2818100333333333
Clouds of Sils Maria,8/20/2014,6600000,1851517,-4748483,0.2805328787878788
The Interview,12/25/2014,44000000,12342632,-31657368,0.2805143636363636
From Beyond,6/5/1986,4500000,1261000,-3239000,0.2802222222222222
Killing Zoe,10/1/1993,1500000,418961,-1081039,0.27930733333333335
The Swan Princess,11/18/1994,35000000,9771658,-25228342,0.27919022857142856
The Believer,1/19/2001,1500000,416925,-1083075,0.27795
"\"नीरज�?\"\"Neerja is a portrayal on the life of the courageous Neerja Bhanot\"",2/19/2016,10721568,2978994,-7742574,0.2778505905106417
Barbarella,10/10/1968,9000000,2500000,-6500000,0.2777777777777778
The Brothers Bloom,9/9/2008,20000000,5530764,-14469236,0.2765382
Attack the Block,5/12/2011,14350531,3964682,-10385849,0.2762742368209232
Red State,8/19/2011,4000000,1104682,-2895318,0.2761705
Run,2/1/1991,16000000,4409328,-11590672,0.275583
Mindscape,10/13/2013,4357373,1200000,-3157373,0.2753952897766613
Taxi to the Dark Side,4/30/2007,1000000,274661,-725339,0.274661
Extreme Ops,11/27/2002,40000000,10959475,-29040525,0.273986875
Prison,3/4/1988,1300000,354704,-945296,0.2728492307692308
White Squall,2/2/1996,38000000,10300000,-27700000,0.2710526315789474
Dutch,7/19/1991,17000000,4603929,-12396071,0.2708193529411765
The Grand Seduction,5/30/2014,12700000,3430018,-9269982,0.27008015748031494
Miss Sloane,11/25/2016,13000000,3500605,-9499395,0.2692773076923077
Запрещeнная реальность,10/8/2009,7000000,1877122,-5122878,0.26816028571428574
Equilibrium,12/6/2002,20000000,5359645,-14640355,0.26798225
The Hollars,8/25/2016,3800000,1016985,-2783015,0.26762763157894737
Trespass,10/13/2011,36000000,9612469,-26387531,0.2670130277777778
What Just Happened,10/17/2008,25000000,6673422,-18326578,0.26693688
Fire Down Below,9/5/1997,60000000,16000000,-44000000,0.26666666666666666
Legends of Oz: Dorothy's Return,6/13/2013,70000000,18662027,-51337973,0.26660038571428574
Kalifornia,9/1/1993,9000000,2395231,-6604769,0.2661367777777778
The Mod Squad,3/26/1999,50000000,13260050,-36739950,0.265201
Hudson Hawk,5/23/1991,65000000,17218080,-47781920,0.26489353846153846
Truth,9/12/2015,9600000,2541554,-7058446,0.2647452083333333
The Warrior's Way,12/2/2010,42000000,11087569,-30912431,0.26398973809523807
Mary Reilly,2/23/1996,47000000,12379402,-34620598,0.2633915319148936
Two Lovers,11/19/2008,12000000,3148182,-8851818,0.2623485
Red Scorpion,12/24/1988,16000000,4192440,-11807560,0.2620275
Ishtar,5/15/1987,55000000,14375181,-40624819,0.26136692727272726
The Astronaut's Wife,8/26/1999,75000000,19598588,-55401412,0.26131450666666667
Bandslam,8/6/2009,20000000,5210988,-14789012,0.2605494
Белка и Стрелка. Звёздные собаки,3/18/2010,25000000,6500000,-18500000,0.26
Mars Needs Moms,3/9/2011,150000000,38992758,-111007242,0.25995172
Colonia,2/18/2016,14000000,3621046,-10378954,0.2586461428571429
The Perez Family,5/12/1995,11000000,2832826,-8167174,0.25752963636363635
A Place Called Chiapas,2/20/1998,891000,229000,-662000,0.2570145903479237
Street Fighter: The Legend of Chun-Li,2/27/2009,50000000,12764201,-37235799,0.25528402
Return to the Blue Lagoon,8/2/1991,11000000,2807854,-8192146,0.25525945454545457
キャシャーン,4/24/2004,6000000,1530216,-4469784,0.255036
Mutant Chronicles,8/7/2008,8000000,2033165,-5966835,0.254145625
十月圍城,12/18/2009,23000000,5837674,-17162326,0.2538119130434783
Blackhat,1/13/2015,70000000,17752940,-52247060,0.25361342857142855
Stanley & Iris,2/9/1990,23000000,5820015,-17179985,0.25304413043478263
4.3.2.1,6/2/2010,4600000,1163967,-3436033,0.2530363043478261
Maurice Richard,10/25/2005,8000000,2019009,-5980991,0.252376125
Steal Big Steal Little,9/29/1995,25000000,6278139,-18721861,0.25112556
Our Brand Is Crisis,9/11/2015,28000000,7002261,-20997739,0.25008075
Red Rock West,7/8/1993,8000000,2000000,-6000000,0.25
The Fall of the Roman Empire,3/24/1964,19000000,4750000,-14250000,0.25
At Long Last Love,3/1/1975,6000000,1500000,-4500000,0.25
Love Story 2050,7/4/2008,20000000,5000000,-15000000,0.25
Limbo,6/4/1999,8000000,1997807,-6002193,0.249725875
Hobo with a Shotgun,5/6/2011,3000000,748453,-2251547,0.24948433333333334
Rumble Fish,10/20/1983,10000000,2494480,-7505520,0.249448
Session 9,8/10/2001,1500000,373967,-1126033,0.24931133333333333
Deep Rising,1/30/1998,45000000,11203026,-33796974,0.24895613333333333
Robinson Crusoe,2/4/2016,13500000,3342697,-10157303,0.24760718518518518
Lost Highway,1/15/1997,15000000,3675201,-11324799,0.2450134
The Express,10/10/2008,40000000,9793496,-30206504,0.2448374
Beyond the Mat,10/22/1999,2053648,500000,-1553648,0.24346918264473755
Unfriend,1/7/2016,9900000,2400000,-7500000,0.24242424242424243
Glitter,9/21/2001,22000000,5271666,-16728334,0.23962118181818182
Twelve and Holding,9/11/2005,400000,95687,-304313,0.2392175
Elle,5/25/2016,9804690,2341534,-7463156,0.23881774946479695
A Prayer for the Dying,9/11/1987,6000000,1432687,-4567313,0.23878116666666666
A Home at the End of the World,7/23/2004,6500000,1548955,-4951045,0.23830076923076923
Repentance,2/28/2014,5000000,1189612,-3810388,0.2379224
Universal Soldier: The Return,8/5/1999,45000000,10667893,-34332107,0.2370642888888889
Permanent Record,4/22/1988,8000000,1893139,-6106861,0.236642375
Guinevere,9/4/1999,2600000,614202,-1985798,0.23623153846153847
Powaqqatsi,4/29/1988,2500000,589244,-1910756,0.2356976
The Midnight Meat Train,8/7/2008,15000000,3533227,-11466773,0.23554846666666668
The Messenger,11/13/2009,6500000,1521261,-4978739,0.23404015384615384
הסיפור של יוסי,5/16/2012,500000,116207,-383793,0.232414
Fire with Fire,8/31/2012,20000000,4636169,-15363831,0.23180845
Dylan Dog: Dead of Night,3/16/2011,20000000,4634062,-15365938,0.2317031
Sheena,8/17/1984,25000000,5778353,-19221647,0.23113412
Havana,12/11/1990,40000000,9243140,-30756860,0.2310785
Gods and Generals,2/21/2003,56000000,12923936,-43076064,0.23078457142857142
Fair Game,11/3/1995,50000000,11534477,-38465523,0.23068954
Trapped,9/20/2002,30000000,6916869,-23083131,0.2305623
The Myth Of Fingerprints,9/17/1997,2000000,458815,-1541185,0.2294075
A Quiet Passion,10/7/2016,8138338,1864266,-6274072,0.22907207835309862
Elles,9/9/2011,4000000,911466,-3088534,0.2278665
The Canyons,7/29/2013,250000,56825,-193175,0.2273
Go Go Tales,5/23/2007,4000000,907456,-3092544,0.226864
Jonah Hex,6/18/2010,47000000,10539000,-36461000,0.2242340425531915
Starchaser: The Legend of Orin,1/1/1985,15000000,3360800,-11639200,0.22405333333333333
Collide,8/4/2016,21500000,4811525,-16688475,0.2237918604651163
Alfie,10/22/2004,60000000,13395939,-46604061,0.22326565
The Contract,4/5/2006,25000000,5549200,-19450800,0.221968
Escobar: Paradise Lost,10/11/2014,17000000,3758328,-13241672,0.2210781176470588
The Postman,12/25/1997,80000000,17626234,-62373766,0.220327925
Sunshine Superman,5/22/2015,400000,88097,-311903,0.2202425
The Year of Living Dangerously,12/17/1982,6000000,1317657,-4682343,0.2196095
Chalet Girl,2/2/2011,8000000,1749457,-6250543,0.218682125
Eegah,6/8/1962,15000,3274,-11726,0.21826666666666666
Felix The Cat: The Movie,10/1/1988,9000000,1964253,-7035747,0.21825033333333332
Personal Shopper,10/19/2016,6000000,1305195,-4694805,0.2175325
The Double,10/27/2011,17000000,3696232,-13303768,0.2174254117647059
Mirrormask,1/25/2005,4000000,866999,-3133001,0.21674975
The Manhattan Project,6/13/1986,18000000,3900000,-14100000,0.21666666666666667
Drona,10/2/2008,15000000,3250000,-11750000,0.21666666666666667
Julia,2/9/2008,6000000,1300000,-4700000,0.21666666666666667
Heartbeeps,12/18/1981,10000000,2154696,-7845304,0.2154696
The Homesman,5/18/2014,16000000,3442853,-12557147,0.2151783125
Infinitely Polar Bear,1/18/2014,6700000,1430655,-5269345,0.21353059701492538
An Awfully Big Adventure,7/21/1995,4000000,851545,-3148455,0.21288625
Морфий,11/27/2008,3600000,766075,-2833925,0.21279861111111112
Los cronocrímenes,9/20/2007,2600000,553198,-2046802,0.21276846153846155
Big Trouble,4/5/2002,40000000,8493890,-31506110,0.21234725
Nothing but Trouble,2/14/1991,40000000,8479793,-31520207,0.211994825
Donnie Darko,1/18/2001,6000000,1270522,-4729478,0.21175366666666667
Mad City,11/7/1997,50000000,10541523,-39458477,0.21083046
Live by Night,12/25/2016,108000000,22678555,-85321445,0.20998662037037036
Turbulence,1/9/1997,55000000,11466088,-43533912,0.20847432727272727
The Scarlet Letter,10/13/1995,50000000,10382407,-39617593,0.20764814
Miracle at St. Anna,9/15/2008,45000000,9323833,-35676167,0.20719628888888889
2 Days in New York,3/28/2012,8000000,1653792,-6346208,0.206724
Christopher Columbus: The Discovery,8/21/1992,40000000,8251071,-31748929,0.206276775
I Hope They Serve Beer in Hell,9/25/2009,7000000,1429299,-5570701,0.20418557142857144
The Work and the Glory III: A House Divided,11/22/2006,6500000,1325092,-5174908,0.2038603076923077
Kundun,12/25/1997,28000000,5684789,-22315211,0.20302817857142857
Find Me Guilty,3/16/2006,13000000,2636637,-10363363,0.20281823076923078
The Frozen Ground,7/18/2013,27220000,5496951,-21723049,0.20194529757531227
Rock the Kasbah,10/22/2015,15000000,3020664,-11979336,0.2013776
I'm Not There.,10/1/2007,20000000,4001121,-15998879,0.20005605
Animal Kingdom,6/3/2010,5000000,1000000,-4000000,0.2
The Molly Maguires,1/27/1970,11000000,2200000,-8800000,0.2
Cool as Ice,10/18/1991,6000000,1193062,-4806938,0.19884366666666667
Playing by Heart,12/30/1998,20000000,3970078,-16029922,0.1985039
Demolition,4/6/2016,10000000,1978592,-8021408,0.1978592
Calendar Girl,9/3/1993,13000000,2570145,-10429855,0.19770346153846155
Jade,10/13/1995,50000000,9851610,-40148390,0.1970322
Шапито-шоу,12/12/2011,2000000,393816,-1606184,0.196908
Rubber,7/9/2010,500000,98017,-401983,0.196034
Shadows and Fog,12/5/1991,14000000,2735731,-11264269,0.19540935714285715
Subway,4/10/1985,2000000,390659,-1609341,0.1953295
Bliss,10/4/1985,3400000,660537,-2739463,0.19427558823529412
Soldier,10/23/1998,75000000,14567883,-60432117,0.19423844
Mustang,6/17/2015,1300000,250000,-1050000,0.19230769230769232
eXistenZ,4/14/1999,15000000,2856712,-12143288,0.19044746666666668
The Neon Demon,6/8/2016,7000000,1333124,-5666876,0.1904462857142857
Wind,9/11/1992,29000000,5519569,-23480431,0.19032996551724138
Meet the Deedles,3/27/1998,24000000,4562146,-19437854,0.19008941666666668
Noises Off...,3/20/1992,12000000,2280148,-9719852,0.19001233333333334
Strange Days,10/13/1995,42000000,7959291,-34040709,0.18950692857142856
Goya's Ghosts,11/8/2006,50000000,9448082,-40551918,0.18896164
The Invasion,8/17/2007,80000000,15071514,-64928486,0.188393925
When Time Ran Out...,3/28/1980,20000000,3763988,-16236012,0.1881994
The Rover,5/18/2014,12250000,2295423,-9954577,0.1873814693877551
Трудно быть богом,2/27/2013,7000000,1310673,-5689327,0.187239
Virus,1/14/1999,75000000,14010690,-60989310,0.1868092
London Boulevard,11/10/2010,25000000,4644108,-20355892,0.18576432
The Good German,12/8/2006,32000000,5914908,-26085092,0.184840875
Les triplettes de Belleville,6/11/2003,8000000,1477676,-6522324,0.1847095
The Big Year,10/13/2011,41000000,7448385,-33551615,0.1816679268292683
Gimme Shelter,10/17/2013,7500000,1359910,-6140090,0.18132133333333333
Osmosis Jones,8/7/2001,75000000,13596911,-61403089,0.18129214666666665
The Nutcracker: The Untold Story,11/24/2010,90000000,16178959,-73821041,0.1797662111111111
Things We Lost in the Fire,9/26/2007,16000000,2849142,-13150858,0.178071375
The Alamo,4/7/2004,145000000,25819961,-119180039,0.17806869655172414
Losin' It,4/8/1983,7000000,1246141,-5753859,0.17802014285714285
What Maisie Knew,5/2/2013,6000000,1066471,-4933529,0.17774516666666668
Jefferson in Paris,3/31/1995,14000000,2474000,-11526000,0.1767142857142857
99 Homes,10/9/2014,8000000,1411927,-6588073,0.176490875
The Bronze,1/22/2016,3500000,615816,-2884184,0.17594742857142856
A Better Life,6/24/2011,10000000,1759252,-8240748,0.1759252
ബാംഗ്ലൂർ ഡെയ്സ്,5/30/2014,7400000,1300000,-6100000,0.17567567567567569
Beyond a Reasonable Doubt,2/5/2009,25000000,4388563,-20611437,0.17554252
Switchback,10/31/1997,37000000,6482195,-30517805,0.17519445945945947
Sphere,2/13/1998,75000000,13100000,-61900000,0.17466666666666666
Solomon Kane,9/16/2009,45000000,7810000,-37190000,0.17355555555555555
The Adventures of Baron Munchausen,12/7/1988,46630000,8083123,-38546877,0.17334597898348703
Bullet to the Head,1/31/2013,55000000,9489829,-45510171,0.17254234545454544
All the King's Men,9/10/2006,55000000,9450897,-45549103,0.17183449090909092
Bacalaureat,5/20/2016,2000000,343617,-1656383,0.1718085
Tough Guys Don't Dance,9/18/1987,5000000,858250,-4141750,0.17165
5 Flights Up,9/5/2014,6000000,1020921,-4979079,0.1701535
Against the Ropes,2/20/2004,39000000,6614280,-32385720,0.1695969230769231
Atlas Shrugged Part III: Who is John Galt?,9/12/2014,5000000,846704,-4153296,0.1693408
Apartment Zero,9/30/1988,4000000,670774,-3329226,0.1676935
Awake,11/28/2007,86000000,14373825,-71626175,0.1671375
Stay,9/24/2005,50000000,8342132,-41657868,0.16684264
Idle Hands,4/30/1999,25000000,4152230,-20847770,0.1660892
Kidulthood,3/3/2006,994000,165000,-829000,0.1659959758551308
Life During Wartime,10/10/2009,4500000,744816,-3755184,0.16551466666666667
Supernova,1/14/2000,90000000,14828081,-75171919,0.16475645555555554
The Legend of the Lone Ranger,8/20/1981,18000000,2945600,-15054400,0.16364444444444445
Gun Shy,2/4/2000,10000000,1631839,-8368161,0.1631839
Tank Girl,3/31/1995,25000000,4064495,-20935505,0.1625798
Oldboy,11/14/2013,30000000,4861022,-25138978,0.16203406666666667
Bulletproof,4/20/1988,5000000,807947,-4192053,0.1615894
Chill Factor,9/1/1999,70000000,11263966,-58736034,0.1609138
Lovelace,8/8/2013,10000000,1585582,-8414418,0.1585582
Batalla en el cielo,5/15/2005,1601792,253527,-1348265,0.15827710464280006
Bad Moon,11/1/1996,7000000,1100000,-5900000,0.15714285714285714
Rock Dog,7/8/2016,60000000,9420546,-50579454,0.1570091
Redacted,1/1/2007,5000000,782102,-4217898,0.1564204
Rules Don't Apply,11/23/2016,25000000,3885342,-21114658,0.15541368
Captivity,3/9/2007,17000000,2626800,-14373200,0.15451764705882354
1492: Conquest of Paradise,10/9/1992,47000000,7191399,-39808601,0.15300848936170214
The Company,9/10/2003,15000000,2281585,-12718415,0.15210566666666667
Farewell to the King,3/3/1989,16000000,2420917,-13579083,0.1513073125
Out on a Limb,9/4/1992,11000000,1659542,-9340458,0.15086745454545455
The Signal,3/15/2014,4000000,600896,-3399104,0.150224
Ten Canoes,6/29/2006,2000000,300000,-1700000,0.15
The Private Life of Sherlock Holmes,10/29/1970,10000000,1500000,-8500000,0.15
特務迷城,1/18/2001,25697387,3849941,-21847446,0.14981838425829055
Youth,5/20/2015,13360000,2000000,-11360000,0.1497005988023952
Party Monster,9/5/2003,5000000,742898,-4257102,0.1485796
Le dernier souffle,3/25/1999,3800000,559298,-3240702,0.14718368421052633
"\"アップルシー�?\"\"In a utopian society created at the end of the third world war\"",4/17/2004,10000000,1461989,-8538011,0.1461989
Razorback,4/19/1984,5500000,801000,-4699000,0.14563636363636365
Beastmaster 2: Through the Portal of Time,6/8/1991,6000000,869325,-5130675,0.1448875
Zabriskie Point,2/9/1970,7000000,1000000,-6000000,0.14285714285714285
Virgin Territory,12/17/2007,38000000,5410749,-32589251,0.14238813157894736
The Pebble and the Penguin,4/11/1995,28000000,3983912,-24016088,0.14228257142857142
A Home of Our Own,11/5/1993,12000000,1703282,-10296718,0.14194016666666667
Like Dandelion Dust,2/5/2009,2500000,352810,-2147190,0.141124
Crooked Arrows,5/18/2012,13000000,1832541,-11167459,0.14096469230769232
Outlander,4/24/2008,50000000,7033683,-42966317,0.14067366
A Hologram for the King,4/22/2016,30000000,4212494,-25787506,0.14041646666666666
Coriolanus,2/14/2011,7700000,1072602,-6627398,0.13929896103896103
Little Buddha,12/1/1993,35000000,4858139,-30141861,0.13880397142857143
The Vatican Tapes,7/24/2015,13000000,1784763,-11215237,0.13728946153846153
Ondine,9/14/2009,12000000,1644755,-10355245,0.13706291666666667
Нирвана,7/3/2008,2000000,273137,-1726863,0.1365685
The Big Bounce,1/30/2004,50000000,6808550,-43191450,0.136171
Big Bully,1/26/1996,15000000,2042530,-12957470,0.13616866666666666
Black Gold,12/21/2011,40000000,5446000,-34554000,0.13615
Black Gold,12/21/2011,40000000,5446000,-34554000,0.13615
七人の侍,4/26/1954,2000000,271841,-1728159,0.1359205
Fur: An Imaginary Portrait of Diane Arbus,8/30/2006,16800000,2281089,-14518911,0.13577910714285715
Upside Down,9/27/2012,60000000,8106475,-51893525,0.13510791666666666
Gigli,8/1/2003,54000000,7266209,-46733791,0.13455942592592593
L'avenir,3/16/2016,2100000,282382,-1817618,0.13446761904761906
Man Trouble,7/17/1992,30,4,-26,0.13333333333333333
Radio Flyer,2/21/1992,35000000,4651977,-30348023,0.13291362857142858
The TV Set,4/28/2006,2000000,265198,-1734802,0.132599
Oorlogswinter,11/17/2008,4000000,530048,-3469952,0.132512
Equals,7/15/2015,16000000,2084628,-13915372,0.13028925
Super,9/9/2010,2500000,324138,-2175862,0.1296552
Fehér Isten,6/12/2014,2200000,282358,-1917642,0.12834454545454546
A Dirty Shame,9/12/2004,15000000,1914166,-13085834,0.12761106666666666
The Great Raid,8/12/2005,80000000,10166502,-69833498,0.127081275
Abre los ojos,12/19/1997,2900000,368234,-2531766,0.12697724137931035
I Saw the Light,2/5/2016,13000000,1646788,-11353212,0.126676
幸福时光,12/31/2000,1900000,240093,-1659907,0.12636473684210525
Flipped,8/6/2010,14000000,1755212,-12244788,0.12537228571428571
Waste Land,1/24/2010,1500000,187716,-1312284,0.125144
Vulgar,9/13/2000,120000,14904,-105096,0.1242
Surviving Picasso,9/4/1996,16000000,1985001,-14014999,0.1240625625
Black Rose,4/17/2014,7000000,855450,-6144550,0.12220714285714286
Waterloo,10/26/1970,25000000,3052000,-21948000,0.12208
Universal Soldier: Day of Reckoning,10/4/2012,11500000,1402307,-10097693,0.12193973913043478
Орлеан,9/17/2015,2500000,302000,-2198000,0.1208
Poulet aux Prunes,10/25/2011,12000000,1428291,-10571709,0.11902425
Roar,11/12/1981,17000000,2000000,-15000000,0.11764705882352941
Human Nature,5/18/2001,6000000,705308,-5294692,0.11755133333333333
Birdy,12/14/1984,12000000,1400000,-10600000,0.11666666666666667
D-Tox,1/4/2002,55000000,6416302,-48583698,0.11666003636363637
Undiscovered,8/26/2005,9000000,1046166,-7953834,0.11624066666666667
The Time That Remains,8/12/2009,6500000,753808,-5746192,0.11597046153846154
My Name Is Bruce,10/1/2007,1500000,173066,-1326934,0.11537733333333333
Town & Country,4/27/2001,90000000,10372291,-79627709,0.11524767777777778
Snow Cake,2/9/2006,12000000,1381665,-10618335,0.11513875
Under the Rainbow,7/31/1981,20000000,2297493,-17702507,0.11487465
Battle in Seattle,9/7/2007,8000000,908847,-7091153,0.113605875
Little Monsters,8/25/1989,7000000,793775,-6206225,0.11339642857142856
The Nutcracker,11/24/1993,19000000,2119994,-16880006,0.11157863157894737
Cats Don't Dance,3/26/1997,32000000,3566637,-28433363,0.11145740625
One Night Stand,11/14/1997,24000000,2642983,-21357017,0.11012429166666667
Leaves of Grass,9/13/2009,9000000,985117,-8014883,0.10945744444444444
Jackpot,7/26/2001,400000,43719,-356281,0.1092975
The Paperboy,9/14/2012,12500000,1353868,-11146132,0.10830944
Vanishing on 7th Street,9/11/2010,10000000,1068682,-8931318,0.1068682
Down in the Valley,5/13/2005,8000000,852872,-7147128,0.106609
50 to 1,3/21/2014,10000000,1064454,-8935546,0.1064454
Setup,11/4/2011,20000000,2128186,-17871814,0.1064093
Silent Fall,10/28/1994,30000000,3180674,-26819326,0.10602246666666666
Steel,8/15/1997,16000000,1686429,-14313571,0.1054018125
The Innkeepers,12/1/2011,750000,78396,-671604,0.104528
Phantom,1/3/2013,10000000,1034589,-8965411,0.1034589
Love in the Time of Cholera,10/4/2007,45000000,4607608,-40392392,0.10239128888888889
The Wild Bunch,6/17/1969,6244087,638641,-5605446,0.10227932442325034
Black Dynamite,10/16/2009,2900000,296557,-2603443,0.10226103448275863
Cutthroat Island,12/22/1995,98000000,10017322,-87982678,0.10221757142857144
Renaissance,3/16/2006,18000000,1831348,-16168652,0.10174155555555556
Shooting Fish,8/22/1997,3000000,302204,-2697796,0.10073466666666667
Mishima: A Life in Four Chapters,5/15/1985,5000000,502758,-4497242,0.1005516
"\"검사외�?\"\"After a prosecution lawyer is framed and convicted for murder\"",2/3/2016,500,50,-450,0.1
Он - дракон,12/4/2015,18000000,1776333,-16223667,0.09868516666666667
The Iceman,9/1/2012,20000000,1969193,-18030807,0.09845965
The Funeral,1/26/1996,12500000,1227324,-11272676,0.09818592
The Boost,12/23/1988,8000000,784990,-7215010,0.09812375
Son of the Pink Panther,1/1/1993,25000000,2438031,-22561969,0.09752124
Search and Destroy,1/1/1995,4000000,389503,-3610497,0.09737575
Meet the Applegates,2/1/1991,5000000,485772,-4514228,0.0971544
La Cité des Enfants Perdus,5/16/1995,18000000,1738611,-16261389,0.0965895
BloodRayne,10/22/2005,25000000,2405420,-22594580,0.0962168
Behind the Burly Q,4/23/2010,250000,23859,-226141,0.095436
Money for Nothing,9/10/1993,11000000,1044824,-9955176,0.094984
Blood Ties,8/22/2013,25500000,2415472,-23084528,0.09472439215686275
Me and Orson Welles,11/25/2009,25000000,2336172,-22663828,0.09344688
Simpatico,9/15/1999,10000000,929606,-9070394,0.0929606
Veronica Guerin,7/11/2003,17000000,1569918,-15430082,0.09234811764705882
Jimmy Vestvood: Amerikan Hero,3/13/2016,2500000,230069,-2269931,0.0920276
The Treatment,4/8/2006,900000,82701,-817299,0.09189
The Night Flier,4/30/1997,1000000,91549,-908451,0.091549
The Zero Theorem,1/2/2014,8500000,770706,-7729294,0.09067129411764706
Another Happy Day,11/18/2011,4000000,355688,-3644312,0.088922
3 Generations,2/11/2016,5000000,443962,-4556038,0.0887924
Infamous,11/16/2006,13000000,1151330,-11848670,0.08856384615384616
The Face of Love,10/25/2013,4000000,350006,-3649994,0.0875015
The Hand,4/24/1981,6500000,566736,-5933264,0.08719015384615385
Casino Jack,9/16/2010,12500000,1083683,-11416317,0.08669464
Princess Kaiulani,5/14/2010,9000000,771499,-8228501,0.08572211111111111
Josh and S.A.M.,11/24/1993,18000000,1528163,-16471837,0.08489794444444444
Machine Gun Preacher,9/23/2011,30000000,2527904,-27472096,0.08426346666666666
Marci X,8/22/2003,20000000,1675706,-18324294,0.0837853
Death of a President,10/27/2006,2000000,167000,-1833000,0.0835
Nobel Son,4/28/2007,4000000,333912,-3666088,0.083478
Isn't She Great,1/28/2000,36000000,3003296,-32996704,0.0834248888888889
The Wind in the Willows,10/16/1996,12,1,-11,0.08333333333333333
बॉम्बे वेलवेट,5/15/2015,18000000,1500000,-16500000,0.08333333333333333
Love,7/6/2015,3000000,249083,-2750917,0.08302766666666667
The Sheltering Sky,10/24/1990,25000000,2075084,-22924916,0.08300336
Man of Tai Chi,7/4/2013,25000000,2054941,-22945059,0.08219764
Frankenhooker,6/1/1990,2500000,205068,-2294932,0.0820272
Assisted Living,2/2/2005,500,41,-459,0.082
Freeheld,10/2/2015,7000000,573335,-6426665,0.081905
Rampart,11/23/2011,12000000,972512,-11027488,0.08104266666666667
Braindead,8/13/1992,3000000,242623,-2757377,0.08087433333333334
Bottle Rocket,2/21/1996,7000000,560069,-6439931,0.08000985714285715
Passengers,9/26/2008,25000000,2000000,-23000000,0.08
Slow Burn,9/12/2005,15500000,1237615,-14262385,0.07984612903225806
Heaven's Gate,11/19/1980,44000000,3484331,-40515669,0.07918934090909091
The Mudge Boy,1/17/2003,800000,62852,-737148,0.078565
How About You...,11/16/2007,9000000,706000,-8294000,0.07844444444444444
Ballerina,12/14/2016,30000000,2351359,-27648641,0.07837863333333334
Córki dancingu,12/25/2015,1300000,101657,-1198343,0.0781976923076923
Logan,9/10/2010,135000,10474,-124526,0.07758518518518519
Beowulf,4/1/1999,20000000,1531251,-18468749,0.07656255
The Other Man,12/25/2008,15000000,1143856,-13856144,0.07625706666666666
Aferim!,1/22/2015,1379375,105097,-1274278,0.07619175351155415
Mr. Nobody,9/11/2009,47000000,3547209,-43452791,0.07547253191489361
A Sound of Thunder,5/15/2005,80000000,5989640,-74010360,0.0748705
Hard Eight,2/28/1996,3000000,222559,-2777441,0.07418633333333334
Prefontaine,1/24/1997,8000000,589304,-7410696,0.073663
Le Moine,7/12/2011,11000000,807535,-10192465,0.07341227272727273
Monkeybone,2/23/2001,75000000,5409517,-69590483,0.07212689333333333
Dead & Buried,5/29/1981,3000000,216166,-2783834,0.07205533333333333
Antichrist,5/18/2009,11000000,791867,-10208133,0.07198790909090909
The Adventures of Pluto Nash,8/15/2002,100000000,7103973,-92896027,0.07103973
The Messengers,2/2/2007,16000000,1109660,-14890340,0.06935375
Meet Bill,9/7/2007,5000000,346592,-4653408,0.0693184
"\"アキ�?\"\"Childhood friends Tetsuo and Kaneda are pulled into the post-apocalyptic underworld of Neo-Tokyo and forced to fight for their very survival. Kaneda is a bike gang leader\"",7/16/1988,8000000,553171,-7446829,0.069146375
Антикиллер,8/1/2002,5000000,340312,-4659688,0.0680624
Shadow Dancer,2/12/2012,6300000,419953,-5880047,0.06665920634920634
Child 44,3/15/2015,50000000,3324330,-46675670,0.0664866
Seraphim Falls,9/13/2006,18000000,1196307,-16803693,0.0664615
Parkland,10/2/2013,10000000,653651,-9346349,0.0653651
While She Was Out,10/27/2008,6000000,391410,-5608590,0.065235
Closet Land,3/6/1991,4000000,259012,-3740988,0.064753
The Extra Man,8/1/2010,7000000,453079,-6546921,0.06472557142857142
Space Truckers,3/1/1996,25000000,1614266,-23385734,0.06457064
The Music Never Stopped,3/18/2011,4000000,253899,-3746101,0.06347475
Solarbabies,11/26/1986,25000000,1579260,-23420740,0.0631704
Universal Soldier: Regeneration,10/1/2009,14000000,875386,-13124614,0.06252757142857143
Third Person,9/9/2013,28000000,1749201,-26250799,0.06247146428571428
Six-String Samurai,9/18/1998,2000000,124494,-1875506,0.062247
Bodyguard,8/31/2011,130,8,-122,0.06153846153846154
The Ledge,5/6/2011,10000000,610986,-9389014,0.0610986
It's All Gone Pete Tong,9/12/2004,2000000,120620,-1879380,0.06031
Stolen,5/17/2012,35000000,2106557,-32893443,0.060187342857142855
Swept Away,10/11/2002,10000000,598645,-9401355,0.0598645
Lay the Favorite,6/22/2012,26350000,1576687,-24773313,0.05983631878557875
Camp X-Ray,10/17/2014,1000000,59744,-940256,0.059744
La mariée était en noir,3/22/1968,747000,44566,-702434,0.05965997322623828
Wet Hot American Summer,7/27/2001,5000000,295206,-4704794,0.0590412
Enter the Void,5/5/2009,13000000,754249,-12245751,0.058019153846153845
W.E.,9/1/2011,15000000,868439,-14131561,0.05789593333333334
Jude,2/6/1996,7000000,405000,-6595000,0.05785714285714286
Brooklyn Rules,4/30/2007,8000000,458232,-7541768,0.057279
The Lazarus Project,10/21/2008,9750000,558000,-9192000,0.05723076923076923
Roadgames,6/26/1981,1750000,100000,-1650000,0.05714285714285714
Jane Got a Gun,1/1/2016,25000000,1397284,-23602716,0.05589136
Foolproof,10/3/2003,8256269,460978,-7795291,0.05583369437211893
Lookin' to Get Out,10/8/1982,17000000,946461,-16053539,0.055674176470588234
Bamako,6/21/2006,2000000,111000,-1889000,0.0555
Hesher,1/22/2010,7000000,382946,-6617054,0.05470657142857143
Tracers,1/15/2015,11000000,593683,-10406317,0.05397118181818182
Der Räuber,2/14/2010,3900000,208475,-3691525,0.053455128205128204
Fido,9/7/2006,8000000,426224,-7573776,0.053278
Stake Land,9/30/2010,650000,33245,-616755,0.05114615384615385
Кавказская пленница!,8/21/2014,3500000,179000,-3321000,0.05114285714285714
Citizen Ruth,12/13/1996,3000000,153155,-2846845,0.05105166666666667
Horsemen,2/6/2009,20000000,1017401,-18982599,0.05087005
The Ward,9/13/2010,10000000,498974,-9501026,0.0498974
Mickey,5/2/2004,6000000,293793,-5706207,0.0489655
17 filles,6/13/2011,4141459,201607,-3939852,0.048680187344604886
Carlos,5/19/2010,18000000,871279,-17128721,0.048404388888888886
Shadow Conspiracy,1/31/1997,45000000,2154540,-42845460,0.04787866666666667
Manderlay,5/16/2005,14200000,674918,-13525082,0.04752943661971831
Tideland,9/9/2005,12000000,566611,-11433389,0.047217583333333334
Blitz,5/20/2011,15774948,741875,-15033073,0.04702868117219784
Maggie,5/8/2015,4000000,187112,-3812888,0.046778
The Beaver,2/11/2011,21000000,970816,-20029184,0.04622933333333333
JCVD,6/4/2008,6000000,276891,-5723109,0.0461485
She Hate Me,7/30/2004,8000000,365134,-7634866,0.04564175
All About Eve,11/9/1950,1400000,63463,-1336537,0.04533071428571429
The Tracey Fragments,2/8/2007,700000,31576,-668424,0.04510857142857143
Song to Song,3/17/2017,10000000,443684,-9556316,0.0443684
Walker,12/4/1987,5800000,257043,-5542957,0.04431775862068966
The Awakening,8/17/2011,4798235,209696,-4588539,0.043702736527077145
Tamara,5/12/2005,4750000,206871,-4543129,0.04355178947368421
Sleep Dealer,12/10/2008,2500000,107559,-2392441,0.0430236
Crossing Over,2/27/2009,25000000,1037335,-23962665,0.0414934
Pirates,5/8/1986,40000000,1641825,-38358175,0.041045625
Honky Tonk Freeway,8/21/1981,24000000,939423,-23060577,0.039142625
Shelter,3/27/2010,22000000,851517,-21148483,0.03870531818181818
Waking the Dead,3/23/2000,8500000,327418,-8172582,0.03851976470588235
Salton Sea,1/1/2002,18000000,676698,-17323302,0.037594333333333334
At Play in the Fields of the Lord,12/6/1991,36000000,1345903,-34654097,0.037386194444444444
Beautiful,4/27/2009,1500000,56000,-1444000,0.037333333333333336
Life After Beth,8/15/2014,2400000,88273,-2311727,0.03678041666666667
Los lunes al sol,9/27/2002,4000000,146402,-3853598,0.0366005
Ma vie de courgette,10/12/2016,8000000,292279,-7707721,0.036534875
Manglehorn,6/3/2015,4000000,143101,-3856899,0.03577525
Freakonomics,10/1/2010,3000000,103735,-2896265,0.034578333333333336
Valmont,11/17/1989,33000000,1132112,-31867888,0.03430642424242424
L!fe Happens,6/18/2011,930000,30905,-899095,0.03323118279569892
Body Snatchers,6/9/1993,13000000,428868,-12571132,0.032989846153846154
Camille Claudel 1915,3/13/2013,3512454,115860,-3396594,0.03298548536151648
Camille Claudel 1915,3/13/2013,3512454,115860,-3396594,0.03298548536151648
Winter Passing,2/7/2006,3500000,113783,-3386217,0.03250942857142857
TEKKEN,3/20/2010,30000000,967000,-29033000,0.032233333333333336
Sphinx,2/11/1981,14000000,439564,-13560436,0.03139742857142857
Without Limits,9/11/1998,25000000,777423,-24222577,0.03109692
Not Fade Away,12/21/2012,20000000,610792,-19389208,0.0305396
In the Land of Blood and Honey,12/23/2011,10000000,303877,-9696123,0.0303877
World's Greatest Dad,8/20/2009,10000000,295750,-9704250,0.029575
Camilla,11/25/1994,8500000,250993,-8249007,0.02952858823529412
Saint John of Las Vegas,6/10/2009,3800000,111731,-3688269,0.029402894736842104
Aftershock,9/12/2012,2000000,58510,-1941490,0.029255
Eye of the Dolphin,8/24/2007,2500000,71904,-2428096,0.0287616
Levity,3/16/2003,7500000,209151,-7290849,0.0278868
Bitter Harvest,2/23/2017,20000000,557241,-19442759,0.02786205
The Romantics,9/10/2010,4500000,123820,-4376180,0.027515555555555557
The Indian Runner,5/19/1991,7000000,191125,-6808875,0.027303571428571427
Return of the Living Dead 3,10/1/1993,2000000,54207,-1945793,0.0271035
No One Lives,3/9/2013,2900000,74918,-2825082,0.025833793103448275
Gaby: A True Story,10/30/1987,5000000,125400,-4874600,0.02508
Decoding Annie Parker,5/2/2014,2000000,48390,-1951610,0.024195
The Big Picture,9/15/1989,5000000,117463,-4882537,0.0234926
Dom durakov,12/6/2002,2500000,57862,-2442138,0.0231448
Love's Labour's Lost,3/31/2000,13000000,299792,-12700208,0.023060923076923076
DOA: Dead or Alive,9/7/2006,21000000,480314,-20519686,0.022872095238095237
Lost River,4/8/2015,2000000,45431,-1954569,0.0227155
Anna Karenina,4/4/1997,35000000,791830,-34208170,0.022623714285714285
Peter and Vandy,1/1/2009,500000,11276,-488724,0.022552
Life of Crime,9/14/2013,12000000,265452,-11734548,0.022121
Southland Tales,5/15/2006,17000000,374743,-16625257,0.02204370588235294
Curdled,9/6/1996,2300000,49620,-2250380,0.02157391304347826
Pontypool,3/6/2009,1500000,32000,-1468000,0.021333333333333333
The Informers,11/5/2008,18000000,382174,-17617826,0.02123188888888889
The Yellow Handkerchief,12/17/2008,15000000,317000,-14683000,0.021133333333333334
Hatchet II,8/26/2010,2500000,52604,-2447396,0.0210416
Squeeze,6/6/1997,500000,10300,-489700,0.0206
Restless,9/16/2011,8000000,163265,-7836735,0.020408125
Adore,4/3/2013,16000000,318982,-15681018,0.019936375
Cameron's Closet,12/2/1988,7000000,136203,-6863797,0.019457571428571428
Man-Thing,4/21/2005,7500000,143000,-7357000,0.019066666666666666
King Solomon's Mines,3/20/1985,12500000,238227,-12261773,0.01905816
The Death and Life of Bobby Z,7/23/2007,22000000,413454,-21586546,0.018793363636363636
Itty Bitty Titty Committee,2/9/2007,1000000,18479,-981521,0.018479
10th & Wolf,2/19/2006,8000000,143451,-7856549,0.017931375
Bopha!,9/16/1993,12000000,212483,-11787517,0.017706916666666666
Dark Tide,3/28/2012,25000000,432274,-24567726,0.01729096
Lolita,9/27/1997,62000000,1060056,-60939944,0.017097677419354838
Henry's Crime,1/14/2010,12000000,204940,-11795060,0.017078333333333334
Cowboys & Angels,5/14/2003,2000000,33700,-1966300,0.01685
Ride with the Devil,11/24/1999,38000000,635096,-37364904,0.016713052631578948
Idiocracy,9/1/2006,30000000,495303,-29504697,0.0165101
Nothing But the Truth,12/19/2008,11500000,186702,-11313298,0.01623495652173913
Canadian Bacon,6/8/1995,11000000,178104,-10821896,0.016191272727272728
Gemma Bovery,9/10/2014,9700000,154701,-9545299,0.015948556701030927
La terza madre,9/6/2007,3500000,54947,-3445053,0.015699142857142856
Rapa Nui,9/9/1994,20000000,305070,-19694930,0.0152535
Better Living Through Chemistry,3/14/2014,5000000,75143,-4924857,0.0150286
Naturally Native,10/8/1999,700000,10508,-689492,0.015011428571428571
Onegin,12/22/1999,14000000,206128,-13793872,0.014723428571428571
Louder Than Bombs,5/18/2015,11000000,161789,-10838211,0.014708090909090909
Stonewall,9/18/2015,13500000,187674,-13312326,0.013901777777777779
Dirty Girl,9/12/2010,4000000,55125,-3944875,0.01378125
Opposite Sex,11/8/2014,3300000,45000,-3255000,0.013636363636363636
Country of My Skull,5/4/2004,12000000,163536,-11836464,0.013628
The Amazing Truth About Queen Raquela,3/7/2008,400000,5255,-394745,0.0131375
The House of Usher,9/11/2007,130000,1677,-128323,0.0129
Revolution,12/25/1985,28000000,358574,-27641426,0.012806214285714285
City Lights,1/30/1931,1500000,19181,-1480819,0.012787333333333333
Defendor,9/12/2009,3500000,44462,-3455538,0.012703428571428572
Trust,9/10/2010,9500000,120000,-9380000,0.01263157894736842
Wuthering Heights,9/5/2011,8000000,100915,-7899085,0.012614375
Running Time,12/18/1997,130000,1596,-128404,0.012276923076923078
There Goes My Baby,9/2/1994,10500000,123509,-10376491,0.011762761904761904
American Adobo,9/29/2001,344,4,-340,0.011627906976744186
December Boys,9/20/2007,4000000,46474,-3953526,0.0116185
Waltzing Anna,8/11/2006,1000000,11455,-988545,0.011455
Stateside,5/23/2004,16000000,174318,-15825682,0.010894875
Down,5/11/2001,15000000,163169,-14836831,0.010877933333333333
Dark Places,3/31/2015,20000000,208588,-19791412,0.0104294
Under Suspicion,9/24/2000,25000000,260562,-24739438,0.01042248
A Street Cat Named Bob,11/4/2016,8000000,82703,-7917297,0.010337875
Local Color,9/19/2006,3250000,32788,-3217212,0.010088615384615385
Alone With Her,4/28/2006,1000000,10018,-989982,0.010018
Viva la libertà,2/13/2013,5000000,48125,-4951875,0.009625
Precious Cargo,7/15/2016,10500000,100659,-10399341,0.009586571428571429
Honeymoon,9/12/2014,1000000,9318,-990682,0.009318
Byzantium,9/9/2012,10000000,89237,-9910763,0.0089237
Dominion: Prequel to the Exorcist,5/20/2005,30000000,251495,-29748505,0.008383166666666667
Cruel World,9/1/2005,2000000,16344,-1983656,0.008172
CBGB,10/11/2013,5000000,40400,-4959600,0.00808
Hallam Foe,2/16/2007,8000000,60641,-7939359,0.007580125
Samba,10/15/2014,20000000,151530,-19848470,0.0075765
Tetro,6/11/2009,15000000,113221,-14886779,0.007548066666666666
Standing Still,1/2/2005,1700000,12762,-1687238,0.007507058823529412
The Divide,3/13/2011,3000000,22000,-2978000,0.007333333333333333
Special,1/30/2006,1000000,7202,-992798,0.007202
Mozart and the Whale,9/10/2005,12000000,84967,-11915033,0.007080583333333334
Metropolis,1/10/1927,92620000,650422,-91969578,0.007022478946231915
The Weight of Water,9/25/2000,16000000,109130,-15890870,0.006820625
Paradies: Liebe,4/27/2012,3600000,24267,-3575733,0.006740833333333333
Momentum,8/1/2015,20000000,133332,-19866668,0.0066666
Ca$h,1/1/2010,7000000,46488,-6953512,0.006641142857142857
Aloft,2/12/2014,8000000,53086,-7946914,0.00663575
Meet Monica Velour,6/4/2010,5000000,31649,-4968351,0.0063298
Assassination of a High School President,1/17/2008,11500000,69564,-11430436,0.00604904347826087
Women in Trouble,11/13/2009,3000000,18097,-2981903,0.006032333333333333
The Ottoman Lieutenant,3/10/2017,40000000,240978,-39759022,0.00602445
Deadfall,11/8/2012,12000000,66351,-11933649,0.00552925
Inhale,8/27/2010,10000000,55089,-9944911,0.0055089
Valhalla Rising,9/4/2009,5641880,30638,-5611242,0.005430459350429289
Road to Nowhere,4/13/2011,5000000,27046,-4972954,0.0054092
Song One,1/20/2014,6000000,32251,-5967749,0.005375166666666667
Zaytoun,10/14/2012,8000000,42330,-7957670,0.00529125
La Tête haute,5/13/2015,5000000,26144,-4973856,0.0052288
Maniac,12/26/2012,6000000,31081,-5968919,0.005180166666666666
Hood of Horror,6/27/2006,5000000,25900,-4974100,0.00518
"\"一個人的武�?\"\"A martial arts instructor working at a police academy gets imprisoned after killing a man by accident. But when a vicious killer starts targeting martial arts masters\"",10/31/2014,25000000,129115,-24870885,0.0051646
Silent Trigger,6/26/1996,15000000,76382,-14923618,0.005092133333333334
The Boondock Saints,1/22/1999,6000000,30471,-5969529,0.0050785
Mal de pierres,10/19/2016,10300000,47748,-10252252,0.004635728155339806
Naqoyqatsi,9/2/2002,3000000,13308,-2986692,0.004436
Mr. Right,2/29/2016,8000000,34694,-7965306,0.00433675
Walk of Shame,5/2/2014,15000000,59209,-14940791,0.003947266666666667
Major Dundee,4/7/1965,3800000,14873,-3785127,0.003913947368421052
Stolen Lives,10/10/2009,2000000,7306,-1992694,0.003653
辛亥革命,7/3/2011,30000000,108348,-29891652,0.0036116
Margaret,9/30/2011,14000000,46495,-13953505,0.0033210714285714284
A Troll in Central Park,10/7/1994,23000000,71368,-22928632,0.0031029565217391302
Jimmy P.,9/11/2013,10000000,30283,-9969717,0.0030283
Highway to Hell,11/21/1991,9000000,26055,-8973945,0.002895
Idioterne,4/28/1998,2500000,7235,-2492765,0.002894
13 Sins,4/18/2014,5000000,13809,-4986191,0.0027618
Barefoot,2/2/2014,6000000,15071,-5984929,0.0025118333333333334
The Sacrament,9/2/2013,4000000,9221,-3990779,0.00230525
Der rote Baron,3/29/2008,18000000,40239,-17959761,0.0022355
Strangerland,7/1/2015,10000000,17472,-9982528,0.0017472
The Merry Widow,8/26/1925,592,1,-591,0.0016891891891891893
All The Queen's Men,10/14/2001,15000000,23000,-14977000,0.0015333333333333334
Venuto al mondo,9/13/2012,13000000,18295,-12981705,0.0014073076923076923
Cherry 2000,11/12/1987,10000000,14000,-9986000,0.0014
The Good Night,1/25/2007,15000000,20380,-14979620,0.0013586666666666667
Nuit Blanche,11/14/2011,2500000,3358,-2496642,0.0013432
Best Man Down,10/20/2012,1500000,1938,-1498062,0.001292
Laurence Anyways,5/18/2012,9500000,12250,-9487750,0.0012894736842105263
Term Life,4/29/2016,16500000,21256,-16478744,0.0012882424242424242
About Cherry,2/14/2012,2500000,3003,-2496997,0.0012012
Poor White Trash,6/16/2000,1200000,1404,-1198596,0.00117
Welcome to the Punch,3/15/2013,8500000,9747,-8490253,0.0011467058823529412
Foodfight!,6/15/2012,65000000,73706,-64926294,0.0011339384615384614
Forces spéciales,11/2/2011,10000000,10759,-9989241,0.0010759
ATM,2/17/2012,3000000,3010,-2996990,0.0010033333333333333
Janky Promoters,10/16/2009,10000000,9069,-9990931,9.069E-4
Sweetwater,1/24/2013,7000000,6147,-6993853,8.781428571428572E-4
5 Days of War,4/14/2011,20000000,17479,-19982521,8.7395E-4
The Good Doctor,1/1/2011,6000000,5206,-5994794,8.676666666666667E-4
Fishtales,8/24/2007,14000000,9216,-13990784,6.582857142857143E-4
Philadelphia Experiment II,11/12/1993,5000000,2970,-4997030,5.94E-4
Chaos,1/17/2005,20000000,10289,-19989711,5.1445E-4
The Duel,6/24/2016,10000000,4500,-9995500,4.5E-4
Šišanje,10/6/2010,500000,198,-499802,3.96E-4
Xue di zi,12/20/2012,15000000,5290,-14994710,3.5266666666666666E-4
Aftermath,4/6/2017,10500000,3451,-10496549,3.2866666666666667E-4
The Adventurer: The Curse of the Midas Box,12/5/2013,25000000,6399,-24993601,2.5596E-4
Die Angst des Tormanns beim Elfmeter,2/19/1972,410000,100,-409900,2.4390243902439024E-4
The Samaritan,3/2/2012,12000000,2521,-11997479,2.1008333333333334E-4
A Perfect Man,11/1/2013,5000000,388,-4999612,7.76E-5
The End of Poverty?,5/19/2008,1000000,57,-999943,5.7E-5
Dr. Horrible's Sing-Along Blog,7/15/2008,200000,3,-199997,1.5E-5
Zyzzyx Road,2/25/2006,2000000,30,-1999970,1.5E-5
Duniyadari,7/19/2014,390000,3,-389997,7.692307692307692E-6
Death at a Funeral,2/9/2007,9000000,46,-8999954,5.1111111111111115E-6
Все и сразу,6/5/2014,750000,3,-749997,4.0E-6
Dreaming of Joseph Lees,10/29/1999,2000000,7,-1999993,3.5E-6
In the Cut,9/9/2003,12000000,23,-11999977,1.916666666666667E-6
Deadfall,10/8/1993,10000000,18,-9999982,1.8E-6
Ladrón que roba a ladrón,8/31/2007,4002313,6,-4002307,1.4991331262697345E-6
Never Talk to Strangers,10/20/1995,6400000,6,-6399994,9.375E-7
The Cookout,9/3/2004,16000000,12,-15999988,7.5E-7
Chasing Liberty,1/9/2004,23000000,12,-22999988,5.217391304347826E-7
Avatar,12/10/2009,237000000,"","",""
